year,name,gender,ratio,females,males,total
2014,Emma,F,100,20799,12,20811
2014,Olivia,F,100,19674,22,19696
2014,Noah,M,99,106,19144,19250
2014,Sophia,F,100,18490,17,18507
2014,Liam,M,100,32,18342,18374
2014,Mason,M,100,78,17092,17170
2014,Isabella,F,100,16950,19,16969
2014,Jacob,M,100,13,16712,16725
2014,William,M,100,23,16687,16710
2014,Ethan,M,100,18,15619,15637
2014,Ava,F,100,15586,14,15600
2014,Michael,M,100,35,15323,15358
2014,Alexander,M,100,33,15293,15326
2014,Logan,M,94,828,13579,14407
2014,James,M,100,42,14301,14343
2014,Daniel,M,100,25,13829,13854
2014,Elijah,M,100,34,13694,13728
2014,Benjamin,M,100,17,13687,13704
2014,Mia,F,100,13442,13,13455
2014,Jayden,M,96,569,12878,13447
2014,Aiden,M,100,57,13296,13353
2014,Matthew,M,100,14,12809,12823
2014,Emily,F,100,12562,11,12573
2014,Jackson,M,100,25,12121,12146
2014,David,M,100,13,12078,12091
2014,Lucas,M,100,7,12078,12085
2014,Joseph,M,100,6,11995,12001
2014,Abigail,F,100,11985,12,11997
2014,Avery,F,81,9517,2269,11786
2014,Anthony,M,100,17,11490,11507
2014,Dylan,M,93,822,10350,11172
2014,Andrew,M,100,11,11069,11080
2014,Carter,M,97,355,10599,10954
2014,Gabriel,M,99,59,10826,10885
2014,Samuel,M,100,13,10859,10872
2014,Joshua,M,100,15,10764,10779
2014,John,M,100,14,10600,10614
2014,Luke,M,100,13,10431,10444
2014,Christopher,M,100,15,10278,10293
2014,Madison,F,100,10247,40,10287
2014,Charlotte,F,100,10048,7,10055
2014,Harper,F,97,9564,327,9891
2014,Isaac,M,100,13,9868,9881
2014,Ryan,M,94,603,9026,9629
2014,Sofia,F,100,9542,9,9551
2014,Elizabeth,F,100,9492,6,9498
2014,Oliver,M,100,13,9365,9378
2014,Henry,M,100,9,9350,9359
2014,Sebastian,M,100,9,9237,9246
2014,Caleb,M,100,14,9143,9157
2014,Owen,M,100,23,9100,9123
2014,Hunter,M,96,362,8759,9121
2014,Nathan,M,100,8,8902,8910
2014,Wyatt,M,100,18,8812,8830
2014,Amelia,F,100,8727,8,8735
2014,Evelyn,F,100,8692,5,8697
2014,Jack,M,100,9,8685,8694
2014,Christian,M,98,132,8388,8520
2014,Ella,F,100,8489,7,8496
2014,Chloe,F,100,8469,6,8475
2014,Landon,M,100,12,8180,8192
2014,Jordan,M,84,1300,6810,8110
2014,Jonathan,M,100,10,8035,8045
2014,Levi,M,99,45,7958,8003
2014,Victoria,F,100,7955,9,7964
2014,Aubrey,F,98,7589,133,7722
2014,Jaxon,M,100,20,7635,7655
2014,Julian,M,100,29,7611,7640
2014,Grace,F,100,7554,12,7566
2014,Isaiah,M,100,11,7530,7541
2014,Cameron,M,93,524,7013,7537
2014,Eli,M,100,21,7428,7449
2014,Angel,M,84,1179,6255,7434
2014,Zoey,F,100,7358,11,7369
2014,Aaron,M,100,23,7334,7357
2014,Charles,M,100,15,7269,7284
2014,Connor,M,100,27,7195,7222
2014,Riley,F,66,4761,2429,7190
2014,Addison,F,98,6950,129,7079
2014,Natalie,F,100,7061,7,7068
2014,Parker,M,80,1386,5677,7063
2014,Thomas,M,100,5,6972,6977
2014,Lillian,F,100,6869,0,6869
2014,Brooklyn,F,99,6767,68,6835
2014,Jeremiah,M,100,11,6780,6791
2014,Adrian,M,98,105,6659,6764
2014,Evan,M,99,75,6667,6742
2014,Lily,F,100,6727,6,6733
2014,Nicholas,M,100,11,6713,6724
2014,Grayson,M,98,163,6532,6695
2014,Gavin,M,100,10,6582,6592
2014,Robert,M,100,6,6572,6578
2014,Brayden,M,100,24,6539,6563
2014,Hannah,F,100,6512,0,6512
2014,Layla,F,100,6428,6,6434
2014,Josiah,M,100,10,6376,6386
2014,Austin,M,98,121,6263,6384
2014,Colton,M,100,9,6339,6348
2014,Jace,M,99,42,6254,6296
2014,Peyton,F,71,4426,1828,6254
2014,Dominic,M,100,14,6205,6219
2014,Scarlett,F,100,5965,0,5965
2014,Tyler,M,97,168,5785,5953
2014,Aria,F,100,5893,14,5907
2014,Kevin,M,100,14,5859,5873
2014,Zoe,F,100,5828,21,5849
2014,Brandon,M,100,0,5804,5804
2014,Samantha,F,100,5680,12,5692
2014,Ayden,M,99,79,5586,5665
2014,Anna,F,100,5639,0,5639
2014,Leah,F,100,5563,8,5571
2014,Audrey,F,100,5531,5,5536
2014,Jason,M,100,6,5510,5516
2014,Ariana,F,100,5461,10,5471
2014,Jose,M,100,10,5442,5452
2014,Allison,F,100,5440,9,5449
2014,Savannah,F,100,5433,0,5433
2014,Ian,M,100,6,5422,5428
2014,Blake,M,91,499,4913,5412
2014,Chase,M,99,72,5322,5394
2014,Alexis,F,78,4188,1172,5360
2014,Hudson,M,98,111,5199,5310
2014,Adam,M,100,7,5293,5300
2014,Arianna,F,100,5240,5,5245
2014,Camila,F,100,5194,7,5201
2014,Nolan,M,100,20,5181,5201
2014,Zachary,M,100,6,5137,5143
2014,Skylar,F,92,4732,409,5141
2014,Kayden,M,92,391,4691,5082
2014,Penelope,F,100,5062,0,5062
2014,Gabriella,F,100,5051,0,5051
2014,Easton,M,99,65,4961,5026
2014,Claire,F,100,4991,0,4991
2014,Cooper,M,98,122,4803,4925
2014,Lincoln,M,97,127,4785,4912
2014,Jaxson,M,100,7,4900,4907
2014,Bentley,M,96,173,4722,4895
2014,Aaliyah,F,100,4850,5,4855
2014,Sadie,F,100,4823,0,4823
2014,Carson,M,96,173,4580,4753
2014,Xavier,M,100,12,4726,4738
2014,Nora,F,100,4708,5,4713
2014,Sarah,F,100,4647,0,4647
2014,Kennedy,F,97,4459,156,4615
2014,Hailey,F,100,4595,0,4595
2014,Sawyer,M,79,955,3571,4526
2014,Kaylee,F,100,4513,5,4518
2014,Hayden,M,63,1656,2851,4507
2014,Paisley,F,100,4473,6,4479
2014,Taylor,F,85,3782,691,4473
2014,Ellie,F,100,4442,12,4454
2014,Asher,M,98,74,4279,4353
2014,Annabelle,F,100,4324,0,4324
2014,Caroline,F,100,4307,6,4313
2014,Brody,M,100,12,4297,4309
2014,Serenity,F,100,4284,7,4291
2014,Madelyn,F,100,4289,0,4289
2014,Lucy,F,100,4257,6,4263
2014,Aubree,F,100,4258,0,4258
2014,Nathaniel,M,100,0,4257,4257
2014,Alexa,F,100,4227,7,4234
2014,Genesis,F,99,4144,63,4207
2014,Ryder,M,97,129,4073,4202
2014,Nevaeh,F,100,4188,6,4194
2014,Stella,F,100,4165,6,4171
2014,Violet,F,100,4156,9,4165
2014,Mackenzie,F,99,4122,30,4152
2014,Bella,F,100,4050,7,4057
2014,Autumn,F,100,4034,6,4040
2014,Mila,F,100,4033,6,4039
2014,Justin,M,100,5,3991,3996
2014,Camden,M,97,115,3872,3987
2014,Leo,M,100,15,3936,3951
2014,Kylie,F,100,3928,5,3933
2014,Tristan,M,98,61,3872,3933
2014,Maya,F,100,3904,0,3904
2014,Juan,M,100,8,3887,3895
2014,Luis,M,100,6,3879,3885
2014,Micah,M,93,264,3612,3876
2014,Damian,M,100,6,3866,3872
2014,Piper,F,100,3840,11,3851
2014,Alyssa,F,100,3798,8,3806
2014,Elias,M,100,5,3751,3756
2014,Vincent,M,100,0,3744,3744
2014,Maxwell,M,99,34,3703,3737
2014,Jase,M,100,15,3719,3734
2014,Mateo,M,100,5,3704,3709
2014,Eleanor,F,100,3704,0,3704
2014,London,F,88,3264,433,3697
2014,Melanie,F,100,3681,6,3687
2014,Naomi,F,100,3677,0,3677
2014,Faith,F,100,3664,10,3674
2014,Katherine,F,100,3651,7,3658
2014,Miles,M,99,19,3639,3658
2014,Eva,F,100,3651,6,3657
2014,Lydia,F,100,3609,0,3609
2014,Brianna,F,100,3582,0,3582
2014,Ashley,F,99,3539,40,3579
2014,Julia,F,100,3578,0,3578
2014,Ezra,M,96,155,3372,3527
2014,Khloe,F,100,3518,0,3518
2014,Jesus,M,100,9,3504,3513
2014,Max,M,100,14,3468,3482
2014,Roman,M,100,16,3435,3451
2014,Leonardo,M,100,5,3431,3436
2014,Santiago,M,100,0,3417,3417
2014,Cole,M,100,9,3404,3413
2014,Madeline,F,100,3409,0,3409
2014,Bryson,M,100,11,3397,3408
2014,Quinn,F,75,2539,868,3407
2014,Carlos,M,100,0,3402,3402
2014,Morgan,F,88,2984,402,3386
2014,Ruby,F,100,3383,0,3383
2014,Brantley,M,99,45,3322,3367
2014,Sophie,F,100,3364,0,3364
2014,Braxton,M,99,29,3320,3349
2014,Kaiden,M,98,81,3247,3328
2014,Alex,M,95,157,3159,3316
2014,Declan,M,100,16,3299,3315
2014,Eric,M,100,5,3294,3299
2014,Alexandra,F,100,3288,0,3288
2014,Giovanni,M,100,10,3230,3240
2014,Harrison,M,100,11,3184,3195
2014,Theodore,M,100,0,3191,3191
2014,Bryce,M,98,67,3099,3166
2014,Wesley,M,99,43,3112,3155
2014,Diego,M,100,0,3154,3154
2014,Charlie,M,54,1432,1670,3102
2014,Reagan,F,93,2882,205,3087
2014,Lauren,F,100,3072,7,3079
2014,Greyson,M,98,55,3022,3077
2014,Bailey,F,96,2929,133,3062
2014,Gianna,F,100,3061,0,3061
2014,Ivan,M,100,0,3059,3059
2014,Vivian,F,100,3040,5,3045
2014,Isabelle,F,100,3044,0,3044
2014,Alice,F,100,3042,0,3042
2014,Hadley,F,99,2992,45,3037
2014,Rylee,F,92,2753,247,3000
2014,George,M,100,0,2988,2988
2014,Jasmine,F,100,2988,0,2988
2014,Kayla,F,100,2982,0,2982
2014,Timothy,M,100,0,2981,2981
2014,Ashton,M,94,165,2797,2962
2014,Weston,M,100,7,2944,2951
2014,Cora,F,100,2945,5,2950
2014,Silas,M,100,5,2900,2905
2014,Jonah,M,99,26,2878,2904
2014,Hazel,F,100,2877,8,2885
2014,Kimberly,F,100,2883,0,2883
2014,Sydney,F,98,2831,49,2880
2014,Colin,M,100,5,2869,2874
2014,Antonio,M,100,0,2871,2871
2014,Richard,M,100,0,2857,2857
2014,Clara,F,100,2833,0,2833
2014,Payton,F,86,2397,406,2803
2014,Trinity,F,99,2781,16,2797
2014,Axel,M,100,9,2777,2786
2014,Natalia,F,100,2778,0,2778
2014,Steven,M,100,0,2778,2778
2014,Jordyn,F,91,2533,239,2772
2014,Valentina,F,100,2769,0,2769
2014,Jayce,M,98,68,2696,2764
2014,Maria,F,100,2740,6,2746
2014,Jocelyn,F,100,2744,0,2744
2014,Kendall,F,89,2432,310,2742
2014,Kaleb,M,100,6,2734,2740
2014,Ariel,F,88,2419,319,2738
2014,Miguel,M,100,0,2737,2737
2014,Preston,M,99,19,2705,2724
2014,Bryan,M,100,9,2713,2722
2014,Aurora,F,100,2718,0,2718
2014,Emerson,F,61,1670,1048,2718
2014,Ryker,M,98,48,2666,2714
2014,Eliana,F,100,2708,0,2708
2014,Jude,M,96,113,2564,2677
2014,Victor,M,100,5,2664,2669
2014,Patrick,M,100,0,2658,2658
2014,Joel,M,100,11,2641,2652
2014,Kai,M,90,262,2387,2649
2014,Maddox,M,96,93,2554,2647
2014,Brielle,F,100,2638,0,2638
2014,Bennett,M,96,112,2525,2637
2014,Emmett,M,100,12,2623,2635
2014,Grant,M,100,8,2624,2632
2014,Liliana,F,100,2624,0,2624
2014,Jameson,M,98,48,2575,2623
2014,Mary,F,100,2611,5,2616
2014,Alejandro,M,100,6,2593,2599
2014,Elena,F,100,2598,0,2598
2014,Marcus,M,100,0,2592,2592
2014,Molly,F,100,2578,5,2583
2014,Kingston,M,100,10,2566,2576
2014,Edward,M,100,5,2567,2572
2014,Eden,F,83,2117,447,2564
2014,Andrea,F,99,2543,19,2562
2014,Makayla,F,100,2559,0,2559
2014,Emmanuel,M,100,8,2548,2556
2014,Everett,M,99,34,2520,2554
2014,Abel,M,100,0,2551,2551
2014,Lilly,F,100,2550,0,2550
2014,Jaden,M,97,85,2433,2518
2014,Adalynn,F,100,2512,0,2512
2014,Jeremy,M,100,5,2506,2511
2014,Nicole,F,100,2511,0,2511
2014,Brian,M,100,0,2510,2510
2014,Alan,M,100,9,2490,2499
2014,Delilah,F,100,2496,0,2496
2014,Jesse,M,97,69,2424,2493
2014,Kaden,M,99,20,2440,2460
2014,Kinsley,F,100,2429,8,2437
2014,Kyle,M,97,65,2370,2435
2014,Jade,F,98,2369,59,2428
2014,Tucker,M,99,17,2406,2423
2014,King,M,100,0,2418,2418
2014,Paige,F,100,2395,5,2400
2014,Mariah,F,100,2383,7,2390
2014,Emery,F,85,2026,361,2387
2014,Willow,F,99,2373,14,2387
2014,Brooke,F,100,2375,6,2381
2014,Karter,M,89,273,2103,2376
2014,Lyla,F,100,2368,0,2368
2014,Mya,F,100,2367,0,2367
2014,Reese,F,83,1960,403,2363
2014,Malachi,M,100,9,2352,2361
2014,Abraham,M,100,9,2351,2360
2014,Luca,M,97,67,2291,2358
2014,Bradley,M,98,43,2308,2351
2014,Ezekiel,M,100,0,2347,2347
2014,Mckenzie,F,99,2303,26,2329
2014,Ximena,F,100,2323,6,2329
2014,Finley,F,64,1498,829,2327
2014,Calvin,M,100,5,2319,2324
2014,Isabel,F,100,2313,5,2318
2014,Luna,F,100,2314,0,2314
2014,Oscar,M,100,0,2309,2309
2014,Rowan,M,67,770,1531,2301
2014,Aidan,M,99,20,2265,2285
2014,Ivy,F,99,2269,16,2285
2014,Josephine,F,100,2255,0,2255
2014,Zayden,M,99,14,2209,2223
2014,Amy,F,100,2178,5,2183
2014,Mark,M,100,8,2161,2169
2014,Jake,M,100,0,2154,2154
2014,Laila,F,100,2133,0,2133
2014,Kenneth,M,100,0,2128,2128
2014,Isla,F,100,2122,0,2122
2014,Brady,M,98,36,2083,2119
2014,Maximus,M,100,0,2118,2118
2014,Elliot,M,83,367,1750,2117
2014,Londyn,F,99,2081,28,2109
2014,Sean,M,100,0,2107,2107
2014,Adalyn,F,100,2105,0,2105
2014,Angelina,F,100,2105,0,2105
2014,Cayden,M,97,68,2037,2105
2014,Rylan,M,84,339,1726,2065
2014,Nicolas,M,100,0,2060,2060
2014,Rachel,F,100,2051,0,2051
2014,Destiny,F,100,2043,7,2050
2014,Melody,F,100,2048,0,2048
2014,Juliana,F,100,2045,0,2045
2014,Kaitlyn,F,100,2044,0,2044
2014,Brooklynn,F,100,2043,0,2043
2014,Caden,M,99,14,2027,2041
2014,Graham,M,100,9,2026,2035
2014,Gracie,F,100,2021,0,2021
2014,Dakota,F,56,1136,876,2012
2014,Jayceon,M,100,6,2006,2012
2014,Norah,F,100,1994,0,1994
2014,Emilia,F,100,1989,0,1989
2014,Paul,M,100,0,1987,1987
2014,Skyler,F,54,1070,911,1981
2014,Elise,F,100,1959,5,1964
2014,Sara,F,100,1949,7,1956
2014,Aliyah,F,100,1947,0,1947
2014,Margaret,F,100,1933,0,1933
2014,Gage,M,100,6,1923,1929
2014,River,M,63,703,1223,1926
2014,Catherine,F,100,1923,0,1923
2014,Corbin,M,99,13,1910,1923
2014,Vanessa,F,100,1913,5,1918
2014,Marley,F,86,1643,273,1916
2014,Katelyn,F,100,1910,0,1910
2014,Gabrielle,F,100,1902,7,1909
2014,Elliott,M,83,329,1574,1903
2014,Peter,M,100,0,1899,1899
2014,Tanner,M,97,57,1840,1897
2014,Arabella,F,100,1894,0,1894
2014,Maverick,M,99,20,1862,1882
2014,Valeria,F,100,1882,0,1882
2014,Dallas,M,72,522,1359,1881
2014,Derek,M,100,0,1874,1874
2014,Presley,F,92,1733,141,1874
2014,Valerie,F,100,1871,0,1871
2014,Adriana,F,100,1861,8,1869
2014,Everly,F,100,1854,5,1859
2014,Jax,M,99,11,1836,1847
2014,Jorge,M,100,0,1841,1841
2014,Amir,M,99,17,1809,1826
2014,Xander,M,100,0,1824,1824
2014,Gael,M,100,6,1802,1808
2014,Omar,M,100,0,1795,1795
2014,Iker,M,100,0,1787,1787
2014,Jessica,F,100,1779,0,1779
2014,Summer,F,99,1759,16,1775
2014,Makenzie,F,100,1766,7,1773
2014,Daisy,F,100,1769,0,1769
2014,Jasper,M,98,36,1731,1767
2014,Zion,M,83,295,1471,1766
2014,Javier,M,100,0,1761,1761
2014,Lila,F,100,1758,0,1758
2014,Rebecca,F,100,1758,0,1758
2014,Julianna,F,100,1756,0,1756
2014,Callie,F,100,1751,0,1751
2014,August,M,87,230,1520,1750
2014,Cody,M,99,26,1722,1748
2014,Ryleigh,F,99,1735,13,1748
2014,Michelle,F,100,1737,0,1737
2014,Alaina,F,100,1729,0,1729
2014,Angela,F,100,1722,0,1722
2014,Spencer,M,88,203,1506,1709
2014,Alina,F,100,1706,0,1706
2014,Dean,M,100,6,1700,1706
2014,Harmony,F,100,1704,0,1704
2014,Jaiden,M,91,148,1552,1700
2014,Collin,M,99,9,1688,1697
2014,Andres,M,100,0,1696,1696
2014,Zane,M,100,7,1674,1681
2014,Rose,F,100,1678,0,1678
2014,Athena,F,100,1677,0,1677
2014,Cali,F,99,1652,24,1676
2014,Adelyn,F,100,1666,6,1672
2014,Beau,M,97,45,1622,1667
2014,Alana,F,100,1664,0,1664
2014,Keegan,M,93,117,1547,1664
2014,Myles,M,99,9,1655,1664
2014,Izabella,F,100,1653,0,1653
2014,Esther,F,100,1638,0,1638
2014,Fiona,F,100,1636,0,1636
2014,Stephanie,F,100,1630,0,1630
2014,Conner,M,100,8,1620,1628
2014,Lorenzo,M,100,0,1628,1628
2014,Arya,F,95,1544,82,1626
2014,Cecilia,F,100,1623,0,1623
2014,Kinley,F,99,1610,13,1623
2014,Lukas,M,100,0,1619,1619
2014,Kate,F,100,1611,0,1611
2014,Jayla,F,100,1609,0,1609
2014,Simon,M,100,0,1602,1602
2014,Genevieve,F,100,1595,0,1595
2014,Francisco,M,100,0,1591,1591
2014,Beckett,M,95,79,1511,1590
2014,Kylee,F,99,1580,10,1590
2014,Alexandria,F,100,1589,0,1589
2014,Eliza,F,100,1585,0,1585
2014,Finn,M,99,18,1567,1585
2014,Alivia,F,100,1579,0,1579
2014,Devin,M,93,103,1476,1579
2014,Israel,M,96,56,1523,1579
2014,Giselle,F,100,1573,0,1573
2014,Gunner,M,100,0,1564,1564
2014,Garrett,M,100,5,1552,1557
2014,Amari,M,62,585,970,1555
2014,Judah,M,98,34,1514,1548
2014,Griffin,M,99,22,1522,1544
2014,Chance,M,98,34,1501,1535
2014,Brooks,M,98,27,1507,1534
2014,Alayna,F,100,1533,0,1533
2014,Leilani,F,100,1532,0,1532
2014,Phoenix,M,59,629,901,1530
2014,Adeline,F,100,1522,0,1522
2014,Jennifer,F,100,1514,6,1520
2014,Remington,M,73,410,1101,1511
2014,Tessa,F,100,1510,0,1510
2014,Ana,F,100,1508,0,1508
2014,Zander,M,100,0,1507,1507
2014,Damien,M,100,0,1496,1496
2014,Melissa,F,100,1496,0,1496
2014,Waylon,M,99,8,1486,1494
2014,Seth,M,100,0,1490,1490
2014,Daniela,F,100,1486,0,1486
2014,Teagan,F,86,1272,212,1484
2014,Paxton,M,96,60,1422,1482
2014,Travis,M,100,0,1480,1480
2014,Aniyah,F,100,1479,0,1479
2014,Emiliano,M,100,0,1471,1471
2014,Lyric,F,83,1210,255,1465
2014,Daleyza,F,100,1461,0,1461
2014,Keira,F,100,1459,0,1459
2014,Reid,M,98,32,1425,1457
2014,Ricardo,M,100,0,1457,1457
2014,Erick,M,100,0,1437,1437
2014,Stephen,M,100,0,1433,1433
2014,Martin,M,100,5,1421,1426
2014,Eduardo,M,100,0,1421,1421
2014,Lucia,F,100,1421,0,1421
2014,Hope,F,100,1412,0,1412
2014,Gabriela,F,100,1403,0,1403
2014,Fernando,M,100,0,1393,1393
2014,Brynlee,F,100,1387,5,1392
2014,Mckenna,F,100,1388,0,1388
2014,Raymond,M,100,0,1386,1386
2014,Lola,F,100,1370,0,1370
2014,Manuel,M,100,0,1370,1370
2014,Felix,M,100,5,1363,1368
2014,Jeffrey,M,100,0,1368,1368
2014,Caiden,M,99,19,1346,1365
2014,Josue,M,100,0,1359,1359
2014,Kameron,M,94,75,1280,1355
2014,Mario,M,100,0,1355,1355
2014,Amaya,F,100,1349,0,1349
2014,Clayton,M,100,0,1349,1349
2014,Miranda,F,100,1348,0,1348
2014,Harley,F,70,940,407,1347
2014,Maggie,F,100,1344,0,1344
2014,Cassidy,F,97,1294,44,1338
2014,Cristian,M,100,0,1337,1337
2014,Anastasia,F,100,1328,0,1328
2014,Troy,M,99,7,1318,1325
2014,Leila,F,100,1324,0,1324
2014,Cash,M,99,7,1316,1323
2014,Lexi,F,100,1320,0,1320
2014,Georgia,F,100,1319,0,1319
2014,Kenzie,F,100,1317,0,1317
2014,Trevor,M,100,5,1312,1317
2014,Paris,F,93,1218,96,1314
2014,Kyler,M,93,95,1218,1313
2014,Iris,F,100,1312,0,1312
2014,Jacqueline,F,100,1301,0,1301
2014,Shane,M,99,16,1282,1298
2014,Tatum,F,64,828,462,1290
2014,Vivienne,F,100,1289,0,1289
2014,Noelle,F,99,1280,8,1288
2014,Camille,F,100,1280,0,1280
2014,Andy,M,99,16,1263,1279
2014,Cesar,M,100,0,1279,1279
2014,Justice,F,59,756,518,1274
2014,Adrianna,F,100,1272,0,1272
2014,Emilio,M,100,0,1270,1270
2014,Kali,F,98,1247,23,1270
2014,Josie,F,100,1269,0,1269
2014,Juliette,F,100,1268,0,1268
2014,Tyson,M,100,5,1262,1267
2014,Annabella,F,100,1265,0,1265
2014,Allie,F,100,1263,0,1263
2014,Donovan,M,100,5,1258,1263
2014,Juliet,F,100,1263,0,1263
2014,Kendra,F,100,1262,0,1262
2014,Drew,M,84,208,1053,1261
2014,Andre,M,100,0,1260,1260
2014,Brynn,F,99,1253,7,1260
2014,Sienna,F,100,1255,0,1255
2014,Lane,M,95,62,1189,1251
2014,Knox,M,99,11,1238,1249
2014,Titus,M,100,0,1246,1246
2014,Ali,M,81,235,1005,1240
2014,Cruz,M,98,29,1211,1240
2014,Jaylen,M,87,156,1082,1238
2014,Maci,F,100,1235,0,1235
2014,Danielle,F,100,1233,0,1233
2014,Sage,F,68,834,399,1233
2014,Delaney,F,99,1220,8,1228
2014,Haley,F,100,1223,0,1223
2014,Jenna,F,100,1223,0,1223
2014,Nova,F,92,1121,102,1223
2014,Holden,M,99,14,1208,1222
2014,Raelynn,F,100,1222,0,1222
2014,Messiah,M,97,39,1178,1217
2014,Alexia,F,100,1213,0,1213
2014,Louis,M,100,0,1212,1212
2014,Hector,M,100,0,1209,1209
2014,Gemma,F,100,1205,0,1205
2014,Anderson,M,96,49,1155,1204
2014,Lilliana,F,100,1203,0,1203
2014,Landen,M,99,7,1192,1199
2014,Rafael,M,100,0,1195,1195
2014,Chelsea,F,100,1191,0,1191
2014,Archer,M,98,18,1171,1189
2014,Jared,M,99,7,1180,1187
2014,Johnny,M,99,9,1176,1185
2014,Journey,F,94,1110,75,1185
2014,Edwin,M,100,0,1179,1179
2014,Evangeline,F,100,1177,0,1177
2014,Edgar,M,100,0,1175,1175
2014,Johnathan,M,100,0,1173,1173
2014,Milan,M,64,424,748,1172
2014,Ayla,F,100,1169,0,1169
2014,Kaydence,F,96,1111,52,1163
2014,Kayleigh,F,100,1160,0,1160
2014,Haven,F,87,1002,154,1156
2014,Lena,F,100,1156,0,1156
2014,Katie,F,100,1149,0,1149
2014,Elaina,F,100,1145,0,1145
2014,Olive,F,100,1144,0,1144
2014,Madeleine,F,100,1138,5,1143
2014,Trenton,M,100,0,1143,1143
2014,Arthur,M,100,0,1138,1138
2014,Makenna,F,100,1138,0,1138
2014,Sergio,M,100,0,1138,1138
2014,Shelby,F,97,1101,34,1135
2014,Elsa,F,100,1131,0,1131
2014,Marco,M,100,0,1121,1121
2014,Julius,M,100,0,1119,1119
2014,Milo,M,99,10,1109,1119
2014,Nadia,F,100,1119,0,1119
2014,Dominick,M,100,0,1118,1118
2014,Dawson,M,96,44,1073,1117
2014,Alison,F,100,1115,0,1115
2014,Reed,M,98,26,1087,1113
2014,Dalton,M,99,7,1103,1110
2014,Jada,F,100,1107,0,1107
2014,Kathryn,F,100,1107,0,1107
2014,Dante,M,100,0,1100,1100
2014,Angelo,M,100,0,1098,1098
2014,Gregory,M,100,0,1096,1096
2014,Noel,M,81,203,892,1095
2014,Nina,F,100,1091,0,1091
2014,Elliana,F,100,1089,0,1089
2014,Diana,F,100,1088,0,1088
2014,Phoebe,F,100,1086,0,1086
2014,Marshall,M,100,5,1079,1084
2014,Karson,M,95,53,1028,1081
2014,Alessandra,F,100,1078,0,1078
2014,Cadence,F,93,998,77,1075
2014,Eloise,F,100,1074,0,1074
2014,Nyla,F,100,1074,0,1074
2014,Leon,M,100,0,1070,1070
2014,Madilyn,F,100,1067,0,1067
2014,Rory,M,69,326,741,1067
2014,Kamryn,F,80,850,216,1066
2014,Charlee,F,98,1043,21,1064
2014,Erin,F,95,1013,51,1064
2014,Shawn,M,99,13,1050,1063
2014,Adelynn,F,100,1058,0,1058
2014,Megan,F,99,1051,6,1057
2014,Miriam,F,100,1057,0,1057
2014,Ashlyn,F,100,1055,0,1055
2014,Leslie,F,94,994,61,1055
2014,Walker,M,98,19,1034,1053
2014,Amiyah,F,100,1051,0,1051
2014,June,F,99,1039,11,1050
2014,Amber,F,100,1049,0,1049
2014,Rosalie,F,100,1047,0,1047
2014,Annie,F,100,1046,0,1046
2014,Fabian,M,100,0,1046,1046
2014,Lilah,F,100,1044,0,1044
2014,Jett,M,97,29,1014,1043
2014,Amanda,F,100,1042,0,1042
2014,Ruth,F,100,1042,0,1042
2014,Adelaide,F,100,1040,0,1040
2014,Joaquin,M,100,0,1038,1038
2014,Laura,F,100,1038,0,1038
2014,Kelsey,F,98,1014,20,1034
2014,Daniella,F,100,1032,0,1032
2014,Erik,M,100,0,1030,1030
2014,Desmond,M,100,0,1029,1029
2014,Mikayla,F,100,1026,0,1026
2014,Raegan,F,99,1019,7,1026
2014,Emanuel,M,99,6,1015,1021
2014,Jane,F,100,1018,0,1018
2014,Ashlynn,F,100,1015,0,1015
2014,Joanna,F,100,1010,5,1015
2014,Kendrick,M,99,10,1005,1015
2014,Aden,M,98,23,991,1014
2014,Christina,F,100,1012,0,1012
2014,Ainsley,F,99,998,12,1010
2014,Fatima,F,100,1009,0,1009
2014,Allyson,F,100,1008,0,1008
2014,Talia,F,100,1006,0,1006
2014,Mariana,F,100,1004,0,1004
2014,Sabrina,F,100,1003,0,1003
2014,Elsie,F,100,998,0,998
2014,Heaven,F,99,984,12,996
2014,Armani,M,57,422,570,992
2014,Camryn,F,82,810,182,992
2014,Frank,M,100,0,984,984
2014,Rhett,M,99,9,975,984
2014,Arielle,F,100,978,0,978
2014,Cohen,M,98,16,961,977
2014,Maddison,F,100,977,0,977
2014,Walter,M,100,0,977,977
2014,Colt,M,100,0,973,973
2014,Barrett,M,98,21,950,971
2014,Alicia,F,100,967,0,967
2014,Briella,F,100,967,0,967
2014,Lucille,F,100,966,0,966
2014,Romeo,M,100,0,962,962
2014,Grady,M,99,7,953,960
2014,Roberto,M,100,0,959,959
2014,Maximiliano,M,100,0,956,956
2014,Zaiden,M,99,5,948,953
2014,Malia,F,100,948,0,948
2014,Selena,F,100,947,0,947
2014,Chandler,M,77,221,724,945
2014,Heidi,F,100,944,0,944
2014,Kyleigh,F,100,941,0,941
2014,Kira,F,100,939,0,939
2014,Skye,F,94,880,59,939
2014,Drake,M,100,0,937,937
2014,Lana,F,100,934,0,934
2014,Sierra,F,100,932,0,932
2014,Major,M,99,6,924,930
2014,Gideon,M,100,0,928,928
2014,Jamie,F,68,633,292,925
2014,Mckinley,F,92,850,71,921
2014,Kiara,F,100,920,0,920
2014,Alondra,F,99,913,6,919
2014,Paislee,F,100,915,0,915
2014,Daphne,F,100,913,0,913
2014,Brendan,M,100,0,911,911
2014,Nehemiah,M,96,32,878,910
2014,Carly,F,100,909,0,909
2014,Jaylah,F,100,909,0,909
2014,Kyla,F,100,909,0,909
2014,Baylee,F,99,896,11,907
2014,Ellis,M,74,234,673,907
2014,Derrick,M,100,0,904,904
2014,Aspen,F,90,812,91,903
2014,Cheyenne,F,99,896,7,903
2014,Ari,M,75,225,677,902
2014,Pedro,M,100,0,902,902
2014,Bianca,F,100,901,0,901
2014,Kamden,M,97,23,869,892
2014,Porter,M,96,40,849,889
2014,Ruben,M,100,0,889,889
2014,Macy,F,100,887,0,887
2014,Braden,M,100,0,886,886
2014,Cade,M,99,8,875,883
2014,Camilla,F,100,883,0,883
2014,Catalina,F,100,883,0,883
2014,Gia,F,100,881,0,881
2014,Vera,F,100,881,0,881
2014,Rylie,F,95,835,45,880
2014,Sloane,F,99,874,6,880
2014,Aylin,F,100,878,0,878
2014,Nash,M,99,7,867,874
2014,Myla,F,100,873,0,873
2014,Casey,M,60,352,519,871
2014,Yaretzi,F,100,871,0,871
2014,Carmen,F,97,846,23,869
2014,Giuliana,F,100,868,0,868
2014,Macie,F,100,868,0,868
2014,Ronan,M,99,9,858,867
2014,Averie,F,98,852,13,865
2014,Kason,M,100,0,864,864
2014,Veronica,F,100,864,0,864
2014,Esmeralda,F,100,862,0,862
2014,Brennan,M,93,57,802,859
2014,Atticus,M,99,9,846,855
2014,Lia,F,100,855,0,855
2014,Allen,M,99,5,849,854
2014,Addyson,F,100,851,0,851
2014,Jay,M,98,17,831,848
2014,Jensen,M,92,65,783,848
2014,Ada,F,100,847,0,847
2014,Enzo,M,100,0,847,847
2014,Mallory,F,100,845,0,845
2014,Jillian,F,100,844,0,844
2014,Kash,M,99,11,832,843
2014,Ariella,F,100,839,0,839
2014,Adan,M,99,9,829,838
2014,Kelly,F,88,734,104,838
2014,Malik,M,99,6,828,834
2014,Matteo,M,99,5,829,834
2014,Braylon,M,99,9,822,831
2014,Abby,F,100,830,0,830
2014,Orion,M,97,24,806,830
2014,Scarlet,F,100,829,0,829
2014,Bethany,F,100,824,0,824
2014,Abram,M,100,0,823,823
2014,Ace,M,99,5,818,823
2014,Tate,M,97,27,796,823
2014,Corey,M,98,17,801,818
2014,Elle,F,100,818,0,818
2014,Kellan,M,98,15,803,818
2014,Jazmin,F,100,817,0,817
2014,Clark,M,99,7,806,813
2014,Dillon,M,96,35,778,813
2014,Solomon,M,100,0,813,813
2014,Malaysia,F,100,810,0,810
2014,Gunnar,M,100,0,808,808
2014,Leighton,F,70,568,240,808
2014,Haylee,F,100,807,0,807
2014,Ismael,M,100,0,805,805
2014,Nayeli,F,100,805,0,805
2014,Gracelyn,F,100,799,0,799
2014,Blakely,F,97,771,24,795
2014,Kamila,F,100,792,0,792
2014,Braylen,M,95,39,752,791
2014,Helen,F,100,791,0,791
2014,Marilyn,F,100,791,0,791
2014,Philip,M,100,0,791,791
2014,Thiago,M,100,0,791,791
2014,April,F,100,790,0,790
2014,Phillip,M,100,0,790,790
2014,Esteban,M,100,0,788,788
2014,Jayson,M,100,0,786,786
2014,Jessie,F,64,504,280,784
2014,Miracle,F,98,768,16,784
2014,Dexter,M,100,0,783,783
2014,Raelyn,F,99,776,6,782
2014,Braelyn,F,90,705,75,780
2014,Pablo,M,100,0,780,780
2014,Ronald,M,100,0,780,780
2014,Carolina,F,100,779,0,779
2014,Amina,F,100,776,0,776
2014,Julie,F,100,776,0,776
2014,Muhammad,M,100,0,773,773
2014,Landyn,M,92,59,712,771
2014,Armando,M,100,0,770,770
2014,Bruce,M,100,0,770,770
2014,Gerardo,M,100,0,770,770
2014,Angelique,F,100,768,0,768
2014,Bristol,F,98,749,19,768
2014,Kade,M,99,7,758,765
2014,Brycen,M,100,0,764,764
2014,Emely,F,100,764,0,764
2014,Jayleen,F,100,764,0,764
2014,Kennedi,F,100,764,0,764
2014,Marcos,M,100,0,763,763
2014,Amira,F,100,762,0,762
2014,Emersyn,F,97,742,20,762
2014,Briana,F,100,761,0,761
2014,Colby,M,93,52,706,758
2014,Leland,M,99,10,748,758
2014,Lennon,F,53,399,358,757
2014,Gwendolyn,F,100,756,0,756
2014,Kolton,M,100,0,756,756
2014,Oakley,M,52,362,394,756
2014,Damon,M,100,0,755,755
2014,Zara,F,100,754,0,754
2014,Aleah,F,100,752,0,752
2014,Itzel,F,100,752,0,752
2014,Russell,M,100,0,752,752
2014,Francesca,F,100,748,0,748
2014,Prince,M,100,0,748,748
2014,Gannon,M,100,0,747,747
2014,Enrique,M,100,0,744,744
2014,Keith,M,100,0,744,744
2014,Adriel,M,93,50,691,741
2014,Brock,M,100,0,739,739
2014,Ember,F,99,729,10,739
2014,Aubrie,F,100,738,0,738
2014,Karina,F,100,736,0,736
2014,Kassidy,F,98,724,12,736
2014,Nylah,F,100,735,0,735
2014,Royal,M,66,253,482,735
2014,Ryland,M,94,44,690,734
2014,Anaya,F,100,733,0,733
2014,Jamison,M,93,48,685,733
2014,Maliyah,F,100,733,0,733
2014,Evelynn,F,100,731,0,731
2014,Guadalupe,F,89,650,81,731
2014,Donald,M,100,0,730,730
2014,Cason,M,99,6,723,729
2014,Melany,F,100,729,0,729
2014,Reece,M,70,217,511,728
2014,Tobias,M,100,0,728,728
2014,Angelica,F,100,727,0,727
2014,Jimena,F,100,725,0,725
2014,Keaton,M,95,37,688,725
2014,Madelynn,F,100,725,0,725
2014,Deacon,M,100,0,724,724
2014,Tiffany,F,100,724,0,724
2014,Kara,F,100,723,0,723
2014,Alejandra,F,99,715,7,722
2014,Jazmine,F,100,722,0,722
2014,Jayda,F,100,721,0,721
2014,Kyrie,M,77,167,554,721
2014,Ty,M,99,5,716,721
2014,Raul,M,100,0,720,720
2014,Dahlia,F,100,719,0,719
2014,Kayson,M,97,18,699,717
2014,Scott,M,100,0,714,714
2014,Charley,F,89,634,77,711
2014,Danny,M,99,7,704,711
2014,Mohamed,M,100,0,711,711
2014,Joy,F,97,687,23,710
2014,Sarai,F,100,710,0,710
2014,Annabel,F,100,709,0,709
2014,Holly,F,100,708,0,708
2014,Janelle,F,100,707,0,707
2014,Gracelynn,F,100,705,0,705
2014,Leonel,M,100,0,704,704
2014,Brylee,F,95,670,33,703
2014,Viviana,F,100,703,0,703
2014,Remy,M,60,278,424,702
2014,Brinley,F,99,692,8,700
2014,Warren,M,99,5,693,698
2014,Serena,F,100,696,0,696
2014,Brittany,F,100,694,0,694
2014,Annalise,F,100,693,0,693
2014,Dustin,M,100,0,691,691
2014,Jaime,M,89,73,618,691
2014,Kadence,F,87,600,91,691
2014,Albert,M,100,0,690,690
2014,Madisyn,F,100,690,0,690
2014,Hugo,M,100,0,689,689
2014,Eve,F,100,688,0,688
2014,Cataleya,F,100,687,0,687
2014,Marlee,F,97,668,19,687
2014,Caitlyn,F,100,686,0,686
2014,Journee,F,99,675,10,685
2014,Davis,M,97,22,660,682
2014,Lennox,M,69,213,469,682
2014,Anabelle,F,100,681,0,681
2014,Emmalyn,F,100,681,0,681
2014,Nico,M,95,36,644,680
2014,Kellen,M,98,12,666,678
2014,Sullivan,M,93,49,628,677
2014,Malcolm,M,100,0,675,675
2014,Celeste,F,100,674,0,674
2014,Zuri,F,98,660,12,672
2014,Luciana,F,100,670,0,670
2014,Henley,F,88,587,81,668
2014,Savanna,F,100,668,0,668
2014,Anya,F,100,667,0,667
2014,Marissa,F,100,667,0,667
2014,Jazlyn,F,100,663,0,663
2014,Maximilian,M,100,0,662,662
2014,Shiloh,F,72,472,188,660
2014,Kailey,F,100,659,0,659
2014,Saul,M,100,0,659,659
2014,Tony,M,100,0,658,658
2014,Crystal,F,100,657,0,657
2014,Franklin,M,99,5,649,654
2014,Michaela,F,100,654,0,654
2014,Rocco,M,100,0,652,652
2014,Zachariah,M,100,0,652,652
2014,Francis,M,90,62,589,651
2014,Lorelei,F,100,651,0,651
2014,Jerry,M,100,0,650,650
2014,Julio,M,100,0,650,650
2014,Madilynn,F,100,649,0,649
2014,Arjun,M,100,0,648,648
2014,Maeve,F,100,647,0,647
2014,Ibrahim,M,100,0,646,646
2014,Hanna,F,100,645,0,645
2014,Priscilla,F,100,645,0,645
2014,Raven,F,94,608,36,644
2014,Royce,M,93,43,601,644
2014,Kyra,F,100,643,0,643
2014,Lacey,F,100,643,0,643
2014,Nia,F,100,642,0,642
2014,Sterling,M,85,97,545,642
2014,Juniper,F,99,633,8,641
2014,Harlow,F,95,605,35,640
2014,Jaxton,M,100,0,640,640
2014,Jakob,M,100,0,637,637
2014,Cyrus,M,99,5,629,634
2014,Imani,F,97,614,20,634
2014,Lawrence,M,99,6,628,634
2014,Izaiah,M,100,0,633,633
2014,Finnegan,M,99,7,625,632
2014,Moises,M,100,0,632,632
2014,Cynthia,F,100,630,0,630
2014,Karen,F,100,630,0,630
2014,Sylvia,F,100,630,0,630
2014,Aleena,F,100,628,0,628
2014,Khalil,M,99,5,623,628
2014,Pierce,M,98,11,616,627
2014,Caitlin,F,100,625,0,625
2014,Emory,F,60,373,252,625
2014,Mathew,M,100,0,621,621
2014,Felicity,F,100,620,0,620
2014,Case,M,100,0,618,618
2014,Elisa,F,100,617,0,617
2014,Julissa,F,100,617,0,617
2014,Rebekah,F,100,617,0,617
2014,Alec,M,100,0,616,616
2014,Kasen,M,99,7,609,616
2014,Evie,F,100,615,0,615
2014,Quentin,M,99,5,610,615
2014,Helena,F,100,614,0,614
2014,Karla,F,100,614,0,614
2014,Millie,F,100,612,0,612
2014,Lilian,F,100,611,0,611
2014,Amara,F,98,600,10,610
2014,Gianni,M,88,74,535,609
2014,Kailyn,F,99,602,7,609
2014,Rhys,M,95,30,578,608
2014,Darius,M,100,0,607,607
2014,Raiden,M,97,18,589,607
2014,Alijah,M,95,29,577,606
2014,Colten,M,100,0,605,605
2014,Leia,F,100,605,0,605
2014,Raylan,M,93,42,563,605
2014,Devon,M,86,82,522,604
2014,Lillie,F,100,601,0,601
2014,Lawson,M,96,25,574,599
2014,Lauryn,F,100,596,0,596
2014,Odin,M,100,0,594,594
2014,Cassandra,F,100,593,0,593
2014,Tristen,M,93,44,548,592
2014,Kane,M,100,0,590,590
2014,Kaylie,F,100,590,0,590
2014,Madalyn,F,100,590,0,590
2014,Anika,F,100,589,0,589
2014,Hayley,F,100,588,0,588
2014,Winter,F,94,553,35,588
2014,Bria,F,100,587,0,587
2014,Colette,F,100,587,0,587
2014,Uriah,M,95,32,554,586
2014,Beckham,M,98,11,573,584
2014,Trey,M,100,0,584,584
2014,Zariah,F,99,576,8,584
2014,Daxton,M,100,0,583,583
2014,Regina,F,100,583,0,583
2014,Alanna,F,100,582,0,582
2014,Azalea,F,100,582,0,582
2014,Fernanda,F,100,582,0,582
2014,Jaliyah,F,100,582,0,582
2014,Anabella,F,100,581,0,581
2014,Gustavo,M,100,0,581,581
2014,Adelina,F,100,580,0,580
2014,Asa,M,92,49,531,580
2014,Lilyana,F,100,580,0,580
2014,Skyla,F,100,580,0,580
2014,Braylee,F,99,572,7,579
2014,Kaylin,F,97,561,18,579
2014,Addisyn,F,100,577,0,577
2014,Callen,M,97,18,557,575
2014,Dennis,M,99,6,569,575
2014,Uriel,M,99,5,570,575
2014,Bridget,F,100,574,0,574
2014,Quincy,M,74,152,422,574
2014,Kenley,F,95,542,31,573
2014,Moses,M,100,0,573,573
2014,Kian,M,99,7,565,572
2014,Monica,F,100,572,0,572
2014,Zayne,M,98,14,558,572
2014,Rodrigo,M,100,0,571,571
2014,Selah,F,99,563,6,569
2014,Marvin,M,100,0,567,567
2014,Gloria,F,100,566,0,566
2014,Harvey,M,100,0,566,566
2014,Sutton,F,64,361,204,565
2014,Johanna,F,100,564,0,564
2014,Addilyn,F,100,563,0,563
2014,Danna,F,100,563,0,563
2014,Darren,M,100,0,562,562
2014,Frederick,M,100,0,562,562
2014,Aryanna,F,100,561,0,561
2014,Mitchell,M,99,6,555,561
2014,Mohammed,M,100,0,561,561
2014,Trent,M,100,0,561,561
2014,Aniya,F,100,560,0,560
2014,Willa,F,100,559,0,559
2014,Angie,F,100,558,0,558
2014,Boston,M,88,65,493,558
2014,Jonas,M,100,0,558,558
2014,Kaia,F,100,558,0,558
2014,Kaliyah,F,100,557,0,557
2014,Anne,F,100,556,0,556
2014,Legend,M,93,41,515,556
2014,Matias,M,100,0,556,556
2014,Tiana,F,100,556,0,556
2014,Braelynn,F,97,537,18,555
2014,Charleigh,F,100,555,0,555
2014,Sasha,F,96,535,20,555
2014,Killian,M,97,16,535,551
2014,Danica,F,100,550,0,550
2014,Bailee,F,99,543,6,549
2014,Alayah,F,100,548,0,548
2014,Korbin,M,99,5,540,545
2014,Courtney,F,76,412,132,544
2014,Aisha,F,100,543,0,543
2014,Azariah,F,51,278,264,542
2014,Chris,M,99,7,535,542
2014,Theo,M,100,0,542,542
2014,Karsyn,F,80,433,108,541
2014,Larry,M,100,0,541,541
2014,Randy,M,100,0,541,541
2014,Aileen,F,100,540,0,540
2014,Lexie,F,100,540,0,540
2014,Landry,M,50,269,270,539
2014,Lindsey,F,99,534,5,539
2014,Janiyah,F,100,538,0,538
2014,Alberto,M,100,0,537,537
2014,Liberty,F,100,537,0,537
2014,Katelynn,F,100,535,0,535
2014,Mariam,F,100,535,0,535
2014,Princeton,M,100,0,535,535
2014,Arturo,M,100,0,534,534
2014,Ricky,M,100,0,534,534
2014,Montserrat,F,100,533,0,533
2014,Malakai,M,100,0,532,532
2014,Aarav,M,100,0,531,531
2014,Arlo,M,96,20,511,531
2014,Dorian,M,97,18,513,531
2014,Jimmy,M,100,0,531,531
2014,Cecelia,F,100,530,0,530
2014,Mikaela,F,100,530,0,530
2014,Kaelyn,F,100,529,0,529
2014,Rosemary,F,100,529,0,529
2014,Annika,F,100,528,0,528
2014,Sam,M,98,12,516,528
2014,Hendrix,M,95,28,498,526
2014,Kobe,M,97,14,512,526
2014,Tatiana,F,100,526,0,526
2014,Alfredo,M,100,0,524,524
2014,Alonzo,M,100,0,524,524
2014,Benson,M,100,0,524,524
2014,Marie,F,100,523,0,523
2014,Braydon,M,100,0,522,522
2014,Hayes,M,95,24,498,522
2014,Curtis,M,100,0,520,520
2014,Virginia,F,100,519,0,519
2014,Liana,F,100,517,0,517
2014,Matilda,F,100,517,0,517
2014,Remi,F,83,429,88,517
2014,Roy,M,100,0,517,517
2014,Toby,M,86,74,441,515
2014,Kieran,M,94,33,480,513
2014,Nikolai,M,100,0,513,513
2014,Amani,F,85,437,75,512
2014,Freya,F,100,512,0,512
2014,Winston,M,100,0,512,512
2014,Lainey,F,100,511,0,511
2014,Talon,M,97,17,494,511
2014,Hallie,F,100,509,0,509
2014,Blair,F,86,435,73,508
2014,Jamari,M,95,27,481,508
2014,Jaycee,F,91,461,46,507
2014,Layne,M,82,92,414,506
2014,Kamari,M,64,183,322,505
2014,Lance,M,100,0,505,505
2014,Luka,M,97,16,489,505
2014,Wade,M,100,0,505,505
2014,Cannon,M,100,0,504,504
2014,Neymar,M,99,5,498,503
2014,Ronin,M,98,9,494,503
2014,Bowen,M,97,13,489,502
2014,Jalen,M,96,20,482,502
2014,Jaxen,M,99,6,496,502
2014,Audrina,F,100,500,0,500
2014,Augustus,M,100,0,499,499
2014,Saige,F,96,478,21,499
2014,Ayaan,M,97,14,484,498
2014,Isaias,M,100,0,498,498
2014,Jaelynn,F,98,487,11,498
2014,Ahmed,M,100,0,497,497
2014,Hattie,F,100,497,0,497
2014,Monserrat,F,100,496,0,496
2014,Nasir,M,100,0,496,496
2014,Brayan,M,100,0,495,495
2014,Issac,M,100,0,495,495
2014,Sky,F,76,376,119,495
2014,Kiera,F,100,494,0,494
2014,Yahir,M,99,5,489,494
2014,Laylah,F,100,493,0,493
2014,Moshe,M,100,0,493,493
2014,Greta,F,100,492,0,492
2014,Rayan,M,89,53,439,492
2014,Alyson,F,100,491,0,491
2014,Kensley,F,97,477,14,491
2014,Nixon,M,96,22,469,491
2014,Orlando,M,100,0,491,491
2014,Vihaan,M,100,0,491,491
2014,Emilee,F,100,490,0,490
2014,Gary,M,100,0,490,490
2014,Maryam,F,100,490,0,490
2014,Sincere,M,86,70,420,490
2014,Melina,F,100,489,0,489
2014,Nikolas,M,100,0,489,489
2014,Noe,M,98,8,481,489
2014,Dayana,F,100,488,0,488
2014,Jaylin,F,60,291,197,488
2014,Joe,M,100,0,488,488
2014,Leonidas,M,100,0,488,488
2014,Quinton,M,100,0,488,488
2014,Luciano,M,100,0,486,486
2014,Ezequiel,M,100,0,485,485
2014,Ahmad,M,100,0,483,483
2014,Beatrice,F,100,482,0,482
2014,Channing,M,74,124,358,482
2014,Frances,F,100,481,0,481
2014,Mauricio,M,100,0,480,480
2014,Conor,M,100,0,479,479
2014,Elisabeth,F,100,479,0,479
2014,Joey,M,76,114,364,478
2014,Jaelyn,F,93,442,35,477
2014,Johan,M,100,0,477,477
2014,Whitney,F,97,463,14,477
2014,Charli,F,99,471,5,476
2014,Matthias,M,100,0,475,475
2014,Meredith,F,100,475,0,475
2014,Aranza,F,100,473,0,473
2014,Rosa,F,100,473,0,473
2014,Bryant,M,100,0,472,472
2014,Mathias,M,100,0,472,472
2014,Maurice,M,100,0,472,472
2014,Roger,M,100,0,472,472
2014,Elyse,F,100,471,0,471
2014,Memphis,M,78,104,367,471
2014,Monroe,F,75,354,117,471
2014,Alani,F,100,470,0,470
2014,Eddie,M,99,7,463,470
2014,Madden,M,88,54,415,469
2014,Mira,F,100,469,0,469
2014,Nathanael,M,100,0,469,469
2014,Mohammad,M,100,0,468,468
2014,Yusuf,M,100,0,468,468
2014,Lylah,F,100,467,0,467
2014,Linda,F,100,466,0,466
2014,Ansley,F,99,459,6,465
2014,Wilson,M,99,5,459,464
2014,Alena,F,100,462,0,462
2014,Kristopher,M,100,0,462,462
2014,Jacoby,M,100,0,461,461
2014,Joselyn,F,100,460,0,460
2014,Crosby,M,94,28,431,459
2014,Kynlee,F,100,459,0,459
2014,Miah,F,100,459,0,459
2014,Alvin,M,100,0,457,457
2014,Elisha,M,70,138,319,457
2014,Kimber,F,98,447,10,457
2014,Mekhi,M,99,5,452,457
2014,Tenley,F,100,457,0,457
2014,Sidney,F,64,292,164,456
2014,Raphael,M,100,0,455,455
2014,Breanna,F,100,454,0,454
2014,Emelia,F,100,454,0,454
2014,Maia,F,100,454,0,454
2014,Lewis,M,100,0,453,453
2014,Douglas,M,100,0,452,452
2014,Edith,F,100,452,0,452
2014,Pearl,F,100,451,0,451
2014,Anahi,F,100,450,0,450
2014,Coraline,F,100,450,0,450
2014,Cullen,M,99,5,445,450
2014,Samara,F,100,450,0,450
2014,Demi,F,100,449,0,449
2014,Chanel,F,100,448,0,448
2014,Salvador,M,100,0,448,448
2014,Layton,M,91,41,406,447
2014,Lilith,F,100,447,0,447
2014,Hank,M,100,0,446,446
2014,Malaya,F,100,446,0,446
2014,Jemma,F,100,445,0,445
2014,Myra,F,100,444,0,444
2014,Bryanna,F,100,443,0,443
2014,Laney,F,100,443,0,443
2014,Kaylynn,F,100,442,0,442
2014,Lucian,M,99,5,437,442
2014,Dax,M,100,0,441,441
2014,Lindsay,F,98,433,8,441
2014,Kallie,F,100,440,0,440
2014,Frankie,M,51,213,226,439
2014,Natasha,F,100,439,0,439
2014,Nathalie,F,100,439,0,439
2014,Niko,M,97,11,428,439
2014,Perla,F,100,439,0,439
2014,Emmitt,M,100,0,438,438
2014,Lilianna,F,100,437,0,437
2014,Wren,F,91,397,40,437
2014,Bodhi,M,99,6,430,436
2014,Madalynn,F,100,436,0,436
2014,Dominik,M,99,6,429,435
2014,Jasiah,M,95,21,414,435
2014,Jefferson,M,100,0,435,435
2014,Elianna,F,100,434,0,434
2014,Casen,M,100,0,433,433
2014,Jaylynn,F,96,416,17,433
2014,Kristian,M,91,37,396,433
2014,Roland,M,100,0,433,433
2014,Brentley,M,95,23,409,432
2014,Elaine,F,100,432,0,432
2014,Carl,M,100,0,431,431
2014,Dulce,F,100,431,0,431
2014,Ellen,F,100,431,0,431
2014,Erica,F,100,431,0,431
2014,Maisie,F,100,431,0,431
2014,Renata,F,100,431,0,431
2014,Kiley,F,100,430,0,430
2014,Marina,F,100,430,0,430
2014,Emmy,F,100,428,0,428
2014,Soren,M,95,20,408,428
2014,Terry,M,98,9,418,427
2014,Zackary,M,100,0,427,427
2014,Ivanna,F,100,426,0,426
2014,Mina,F,96,408,18,426
2014,Amirah,F,100,425,0,425
2014,Deandre,M,100,0,425,425
2014,Hamza,M,100,0,425,425
2014,Livia,F,100,425,0,425
2014,Amelie,F,100,424,0,424
2014,Atlas,M,95,20,404,424
2014,Irene,F,100,424,0,424
2014,Mabel,F,100,424,0,424
2014,Bo,M,97,14,408,422
2014,Kylan,M,91,36,386,422
2014,Alessandro,M,100,0,421,421
2014,Cara,F,100,421,0,421
2014,Dane,M,100,0,419,419
2014,Ciara,F,100,418,0,418
2014,Kathleen,F,100,418,0,418
2014,Arian,M,89,45,372,417
2014,Otto,M,100,0,416,416
2014,Samson,M,100,0,416,416
2014,Ariah,F,98,407,8,415
2014,Camdyn,M,67,138,277,415
2014,Caylee,F,100,415,0,415
2014,Lea,F,100,415,0,415
2014,Erika,F,100,414,0,414
2014,Santino,M,100,0,414,414
2014,Paola,F,100,413,0,413
2014,Alma,F,100,412,0,412
2014,Mae,F,100,412,0,412
2014,Rohan,M,100,0,412,412
2014,Abdullah,M,100,0,411,411
2014,Robin,F,54,223,188,411
2014,Kassandra,F,100,410,0,410
2014,Maleah,F,100,410,0,410
2014,Bentlee,M,85,61,348,409
2014,Leyla,F,100,409,0,409
2014,Marc,M,100,0,409,409
2014,Callan,M,93,29,379,408
2014,Campbell,F,58,236,172,408
2014,Flynn,M,95,20,388,408
2014,Kyson,M,100,0,408,408
2014,Sloan,F,82,336,72,408
2014,Christine,F,100,407,0,407
2014,Jasmin,F,100,407,0,407
2014,Kora,F,100,407,0,407
2014,Nelson,M,100,0,407,407
2014,Chaya,F,100,406,0,406
2014,Karlee,F,100,406,0,406
2014,Aldo,M,100,0,405,405
2014,Lailah,F,100,405,0,405
2014,Kenya,F,99,398,6,404
2014,Mara,F,100,404,0,404
2014,Ramon,M,100,0,404,404
2014,Conrad,M,100,0,402,402
2014,Jaylee,F,100,402,0,402
2014,Raquel,F,100,402,0,402
2014,Siena,F,100,401,0,401
2014,Brett,M,96,17,383,400
2014,Ernesto,M,100,0,400,400
2014,Ivory,F,92,368,32,400
2014,Tegan,F,81,323,77,400
2014,Byron,M,100,0,399,399
2014,Carmelo,M,100,0,399,399
2014,Desiree,F,100,398,0,398
2014,Finnley,M,65,139,259,398
2014,Hadassah,F,100,398,0,398
2014,Aliana,F,100,397,0,397
2014,Neil,M,100,0,397,397
2014,Amiya,F,100,396,0,396
2014,Isis,F,100,396,0,396
2014,Zaniyah,F,100,396,0,396
2014,Rowen,M,74,103,292,395
2014,Blaine,M,95,20,374,394
2014,Devyn,F,65,255,139,394
2014,Rayden,M,94,24,370,394
2014,Avah,F,100,393,0,393
2014,Zain,M,95,21,372,393
2014,Amia,F,100,392,0,392
2014,Cindy,F,100,391,0,391
2014,Eileen,F,100,391,0,391
2014,Madyson,F,100,391,0,391
2014,Averi,F,95,372,18,390
2014,Tomas,M,100,0,390,390
2014,Celine,F,100,389,0,389
2014,Dana,F,91,353,36,389
2014,Simone,F,98,381,8,389
2014,Aryana,F,100,388,0,388
2014,Elin,F,98,379,9,388
2014,Everleigh,F,100,388,0,388
2014,Isabela,F,100,387,0,387
2014,Lionel,M,100,0,387,387
2014,Brodie,M,96,17,369,386
2014,Kasey,F,64,246,140,386
2014,Reyna,F,100,386,0,386
2014,Teresa,F,100,386,0,386
2014,Jolene,F,100,385,0,385
2014,Keagan,M,82,71,314,385
2014,Marjorie,F,100,385,0,385
2014,Myah,F,100,385,0,385
2014,Tori,F,98,378,7,385
2014,Leonard,M,100,0,384,384
2014,Rex,M,100,0,384,384
2014,Clare,F,100,383,0,383
2014,Claudia,F,100,383,0,383
2014,Jeffery,M,100,0,383,383
2014,Duke,M,100,0,382,382
2014,Leanna,F,100,382,0,382
2014,Noemi,F,100,382,0,382
2014,Corinne,F,100,381,0,381
2014,Sylas,M,100,0,381,381
2014,Alia,F,100,380,0,380
2014,Brenda,F,100,380,0,380
2014,Collins,F,86,327,53,380
2014,Dorothy,F,100,380,0,380
2014,Emilie,F,100,380,0,380
2014,Kingsley,M,81,71,308,379
2014,Tripp,M,100,0,378,378
2014,Bruno,M,100,0,377,377
2014,Martha,F,100,377,0,377
2014,Saylor,F,93,350,27,377
2014,Zechariah,M,100,0,377,377
2014,Ally,F,100,376,0,376
2014,Arely,F,100,376,0,376
2014,Leona,F,100,376,0,376
2014,Melvin,M,100,0,376,376
2014,Patricia,F,100,376,0,376
2014,Branson,M,100,0,375,375
2014,Thalia,F,100,375,0,375
2014,Carolyn,F,100,374,0,374
2014,Jon,M,100,0,374,374
2014,Julien,M,100,0,374,374
2014,Nataly,F,100,373,0,373
2014,Paityn,F,100,373,0,373
2014,Shayla,F,100,373,0,373
2014,Briley,F,85,318,54,372
2014,Guillermo,M,100,0,372,372
2014,Jazlynn,F,100,372,0,372
2014,Margot,F,100,372,0,372
2014,Austyn,F,65,240,131,371
2014,Lee,M,94,23,348,371
2014,Lisa,F,100,371,0,371
2014,Ellison,F,81,300,70,370
2014,Lizbeth,F,100,370,0,370
2014,Nancy,F,100,369,0,369
2014,Deborah,F,100,368,0,368
2014,Edison,M,97,10,358,368
2014,Khaleesi,F,100,368,0,368
2014,Crew,M,100,0,367,367
2014,Meadow,F,100,367,0,367
2014,Yareli,F,100,367,0,367
2014,Farrah,F,100,366,0,366
2014,Kori,F,92,338,28,366
2014,Milania,F,100,366,0,366
2014,Dominique,M,61,144,221,365
2014,Janessa,F,100,365,0,365
2014,Kelvin,M,100,0,365,365
2014,Milana,F,100,365,0,365
2014,Stanley,M,100,0,365,365
2014,Zoie,F,100,363,0,363
2014,Adele,F,100,362,0,362
2014,Clarissa,F,100,362,0,362
2014,Cory,M,98,9,353,362
2014,Dayton,M,95,17,345,362
2014,Lina,F,100,362,0,362
2014,Sariah,F,100,362,0,362
2014,Emmalynn,F,100,361,0,361
2014,Galilea,F,100,361,0,361
2014,Hailee,F,100,361,0,361
2014,Halle,F,100,361,0,361
2014,Kamdyn,M,68,114,247,361
2014,Elian,M,98,8,352,360
2014,Giana,F,100,359,0,359
2014,Holland,F,84,302,57,359
2014,Lucca,M,89,40,319,359
2014,Terrance,M,100,0,359,359
2014,Thea,F,100,359,0,359
2014,Denise,F,100,358,0,358
2014,Naya,F,100,358,0,358
2014,Demetrius,M,100,0,357,357
2014,Kristina,F,100,357,0,357
2014,Liv,F,100,357,0,357
2014,Nathaly,F,100,357,0,357
2014,Ronnie,M,87,47,310,357
2014,Wendy,F,100,357,0,357
2014,Amos,M,100,0,356,356
2014,Cayson,M,100,0,356,356
2014,Joyce,F,98,349,7,356
2014,Aubrielle,F,100,355,0,355
2014,Brenna,F,100,355,0,355
2014,Danika,F,100,355,0,355
2014,Omari,M,96,15,340,355
2014,Rodney,M,100,0,355,355
2014,Alden,M,94,20,334,354
2014,Briar,M,56,155,199,354
2014,Celia,F,100,353,0,353
2014,Jagger,M,97,11,342,353
2014,Jolie,F,100,353,0,353
2014,Taliyah,F,100,353,0,353
2014,Miley,F,100,352,0,352
2014,Yamileth,F,100,352,0,352
2014,Jaylene,F,100,351,0,351
2014,Xzavier,M,100,0,350,350
2014,Bronson,M,100,0,349,349
2014,Makai,M,97,12,337,349
2014,Milena,F,100,349,0,349
2014,Zariyah,F,100,349,0,349
2014,Kristen,F,97,338,10,348
2014,Sandra,F,100,348,0,348
2014,Ariadne,F,100,347,0,347
2014,Noa,F,82,284,63,347
2014,Aviana,F,100,346,0,346
2014,Mollie,F,100,346,0,346
2014,Cherish,F,100,345,0,345
2014,Santana,M,70,103,242,345
2014,Alaya,F,100,344,0,344
2014,Asia,F,100,344,0,344
2014,Chad,M,100,0,344,344
2014,Kolby,M,86,49,295,344
2014,Yael,M,68,109,235,344
2014,Cassius,M,100,0,343,343
2014,Baylor,M,64,124,218,342
2014,Mayson,M,88,42,300,342
2014,Nola,F,100,342,0,342
2014,Penny,F,100,342,0,342
2014,Dixie,F,100,341,0,341
2014,Marisol,F,100,341,0,341
2014,Aryan,M,93,23,317,340
2014,Fletcher,M,100,0,340,340
2014,Kaysen,M,89,38,302,340
2014,Adrienne,F,100,339,0,339
2014,Alonso,M,100,0,339,339
2014,Shannon,F,75,255,84,339
2014,Yosef,M,100,0,339,339
2014,Forrest,M,98,6,332,338
2014,Westin,M,100,0,338,338
2014,Aimee,F,100,337,0,337
2014,Arden,F,72,243,94,337
2014,Brecken,M,90,33,304,337
2014,Brenden,M,100,0,337,337
2014,Esme,F,100,337,0,337
2014,Jordynn,F,96,324,13,337
2014,Laurel,F,100,337,0,337
2014,Aliza,F,100,336,0,336
2014,Langston,M,93,23,313,336
2014,Roselyn,F,100,336,0,336
2014,Felipe,M,100,0,335,335
2014,Harry,M,100,0,335,335
2014,Lorelai,F,100,335,0,335
2014,Taryn,F,96,320,15,335
2014,Jenny,F,100,334,0,334
2014,Katalina,F,100,334,0,334
2014,Lara,F,100,334,0,334
2014,Maxim,M,100,0,334,334
2014,Nickolas,M,100,0,334,334
2014,Amya,F,100,332,0,332
2014,Ayleen,F,100,332,0,332
2014,Davion,M,100,0,332,332
2014,Kaidence,F,92,304,28,332
2014,Ray,M,97,9,323,332
2014,Allan,M,100,0,331,331
2014,Aubri,F,100,331,0,331
2014,Enoch,M,100,0,331,331
2014,Kody,M,98,7,324,331
2014,Willie,M,100,0,331,331
2014,Ariya,F,100,330,0,330
2014,Carlee,F,100,330,0,330
2014,Iliana,F,100,330,0,330
2014,Magnolia,F,100,330,0,330
2014,Aurelia,F,100,329,0,329
2014,Ben,M,100,0,329,329
2014,Evalyn,F,100,329,0,329
2014,Natalee,F,100,329,0,329
2014,Rayna,F,100,329,0,329
2014,Terrence,M,100,0,329,329
2014,Tommy,M,100,0,329,329
2014,Heather,F,100,328,0,328
2014,Adonis,M,100,0,327,327
2014,Aydin,M,98,6,321,327
2014,Cain,M,100,0,327,327
2014,Estrella,F,100,326,0,326
2014,Susan,F,98,321,5,326
2014,Callum,M,100,0,325,325
2014,Diamond,F,93,303,22,325
2014,Hana,F,100,325,0,325
2014,Jermaine,M,100,0,325,325
2014,Kenna,F,100,325,0,325
2014,Jewel,F,96,311,13,324
2014,Kyree,M,83,55,269,324
2014,Rosie,F,100,324,0,324
2014,Thaddeus,M,100,0,324,324
2014,Aiyana,F,100,323,0,323
2014,America,F,100,323,0,323
2014,Angeline,F,100,323,0,323
2014,Janiya,F,100,323,0,323
2014,Jessa,F,100,323,0,323
2014,Sharon,F,96,309,12,321
2014,Zeke,M,100,0,321,321
2014,Emmalee,F,100,320,0,320
2014,Markus,M,100,0,320,320
2014,Temperance,F,100,320,0,320
2014,Alissa,F,100,319,0,319
2014,Kenia,F,100,319,0,319
2014,Marcelo,M,100,0,319,319
2014,Shaun,M,100,0,319,319
2014,Abbigail,F,100,318,0,318
2014,Kailee,F,100,318,0,318
2014,Van,M,94,18,300,318
2014,Zaria,F,100,318,0,318
2014,Vicente,M,100,0,317,317
2014,Chana,F,100,316,0,316
2014,Kairi,F,96,304,12,316
2014,Lillianna,F,100,316,0,316
2014,Aron,M,100,0,315,315
2014,Barbara,F,100,315,0,315
2014,Carla,F,100,315,0,315
2014,Aliya,F,100,314,0,314
2014,Marlon,M,100,0,314,314
2014,Stevie,F,89,280,34,314
2014,Ashtyn,F,74,231,82,313
2014,Bonnie,F,100,313,0,313
2014,Grey,M,75,79,234,313
2014,Keyla,F,100,313,0,313
2014,Lamar,M,84,51,262,313
2014,Marianna,F,100,313,0,313
2014,Ulises,M,100,0,313,313
2014,Wynter,F,98,307,6,313
2014,Anders,M,100,0,312,312
2014,Kareem,M,100,0,312,312
2014,Maison,M,91,28,284,312
2014,Paloma,F,100,312,0,312
2014,Shea,F,66,206,106,312
2014,Trace,M,98,5,307,312
2014,Bobby,M,100,0,311,311
2014,Joslyn,F,100,311,0,311
2014,Saniyah,F,100,311,0,311
2014,Audriana,F,100,310,0,310
2014,Davian,M,100,0,310,310
2014,Giovanna,F,100,310,0,310
2014,Hadleigh,F,100,310,0,310
2014,Harlee,F,97,300,10,310
2014,Mckayla,F,100,310,0,310
2014,Ares,M,95,15,294,309
2014,Denver,M,61,122,187,309
2014,Jadiel,M,100,0,309,309
2014,Jaida,F,100,309,0,309
2014,Salma,F,100,309,0,309
2014,Samir,M,100,0,309,309
2014,Alexzander,M,100,0,308,308
2014,Emmaline,F,100,308,0,308
2014,Hassan,M,100,0,308,308
2014,Kimora,F,100,308,0,308
2014,Axton,M,100,0,307,307
2014,Will,M,100,0,307,307
2014,Avianna,F,100,306,0,306
2014,Rene,M,93,20,286,306
2014,Amalia,F,100,305,0,305
2014,Jamal,M,100,0,305,305
2014,Karlie,F,100,305,0,305
2014,Valentino,M,100,0,305,305
2014,Yousef,M,100,0,305,305
2014,Blaze,M,97,8,296,304
2014,Libby,F,100,304,0,304
2014,Sherlyn,F,100,304,0,304
2014,Fisher,M,100,0,302,302
2014,Giovani,M,100,0,302,302
2014,Zendaya,F,100,302,0,302
2014,Darian,M,95,14,287,301
2014,Mariyah,F,100,301,0,301
2014,Miller,M,82,54,247,301
2014,Zainab,F,100,301,0,301
2014,Alisha,F,100,300,0,300
2014,Ayanna,F,100,300,0,300
2014,Braylin,M,66,102,198,300
2014,Kalani,F,79,237,63,300
2014,Lilyanna,F,100,300,0,300
2014,Maxton,M,100,0,300,300
2014,Bryleigh,F,100,299,0,299
2014,Julianne,F,100,299,0,299
2014,Kaleigh,F,100,299,0,299
2014,Miya,F,100,299,0,299
2014,Yasmin,F,100,299,0,299
2014,Anniston,F,100,298,0,298
2014,Estelle,F,100,298,0,298
2014,Emmeline,F,100,297,0,297
2014,Faye,F,100,297,0,297
2014,Hezekiah,M,100,0,297,297
2014,Urijah,M,98,5,292,297
2014,Kiana,F,100,296,0,296
2014,Kolten,M,100,0,296,296
2014,Misael,M,100,0,296,296
2014,Anabel,F,100,295,0,295
2014,Azaria,F,97,287,8,295
2014,Javon,M,100,0,295,295
2014,Justus,M,93,21,274,295
2014,Rogelio,M,100,0,295,295
2014,Adrien,M,97,10,284,294
2014,Brantlee,M,92,23,271,294
2014,Jedidiah,M,100,0,294,294
2014,Tara,F,100,294,0,294
2014,Astrid,F,100,293,0,293
2014,Blaise,M,89,31,262,293
2014,Bode,M,100,0,293,293
2014,Emerie,F,100,293,0,293
2014,Leandro,M,100,0,293,293
2014,Mercy,F,97,284,9,293
2014,Billy,M,98,6,286,292
2014,Cedric,M,100,0,292,292
2014,Zahra,F,100,292,0,292
2014,Kinslee,F,100,291,0,291
2014,Tabitha,F,100,291,0,291
2014,Wayne,M,100,0,291,291
2014,Aubriella,F,100,290,0,290
2014,Kaylen,F,82,238,52,290
2014,Addilynn,F,100,289,0,289
2014,Alyvia,F,100,289,0,289
2014,Eugene,M,100,0,289,289
2014,Hadlee,F,100,289,0,289
2014,Ingrid,F,100,289,0,289
2014,Lilia,F,100,289,0,289
2014,Macey,F,100,289,0,289
2014,Regan,F,82,237,52,289
2014,Kole,M,100,0,288,288
2014,Camron,M,100,0,287,287
2014,Jaidyn,F,50,144,143,287
2014,Kaitlynn,F,100,287,0,287
2014,Neriah,F,100,287,0,287
2014,Annabell,F,100,286,0,286
2014,Ariyah,F,100,286,0,286
2014,Janae,F,100,286,0,286
2014,Kaiya,F,100,286,0,286
2014,Kase,M,100,0,286,286
2014,Reina,F,100,286,0,286
2014,Rivka,F,100,286,0,286
2014,Alisa,F,100,285,0,285
2014,Duncan,M,100,0,285,285
2014,Marleigh,F,100,285,0,285
2014,Alfred,M,100,0,284,284
2014,Alisson,F,100,284,0,284
2014,Bryn,F,96,274,10,284
2014,Maliah,F,100,284,0,284
2014,Scarlette,F,100,284,0,284
2014,Apollo,M,100,0,283,283
2014,Braeden,M,100,0,283,283
2014,Clementine,F,100,283,0,283
2014,Frida,F,100,283,0,283
2014,Graysen,M,88,34,249,283
2014,Mack,M,100,0,283,283
2014,Palmer,F,61,173,110,283
2014,Ann,F,100,282,0,282
2014,Clyde,M,100,0,282,282
2014,Reginald,M,100,0,282,282
2014,Sonia,F,100,282,0,282
2014,Alannah,F,100,281,0,281
2014,Anson,M,100,0,281,281
2014,Avalynn,F,100,281,0,281
2014,Dalia,F,100,281,0,281
2014,Jerome,M,100,0,281,281
2014,Renee,F,98,276,5,281
2014,Ryann,F,96,270,11,281
2014,Ayva,F,100,280,0,280
2014,Ishaan,M,100,0,280,280
2014,Jael,F,56,156,124,280
2014,Noor,F,91,256,24,280
2014,Rayne,F,92,258,22,280
2014,Chevy,M,85,43,236,279
2014,Javion,M,100,0,279,279
2014,Judith,F,100,279,0,279
2014,Paulina,F,100,279,0,279
2014,Estella,F,100,278,0,278
2014,Micheal,M,100,0,278,278
2014,Vincenzo,M,100,0,278,278
2014,Gauge,M,100,0,277,277
2014,Gwen,F,100,277,0,277
2014,Keenan,M,100,0,277,277
2014,Mattie,F,100,277,0,277
2014,Milani,F,100,277,0,277
2014,Raina,F,100,277,0,277
2014,Julieta,F,100,276,0,276
2014,Zaire,M,86,39,237,276
2014,Amare,M,96,12,263,275
2014,Andi,F,93,255,20,275
2014,Fallon,F,91,249,26,275
2014,Gerald,M,100,0,275,275
2014,Kailani,F,98,269,6,275
2014,Kaya,F,94,259,16,275
2014,Kendal,F,82,225,50,275
2014,Kymani,M,83,46,229,275
2014,Lesly,F,100,275,0,275
2014,Abrielle,F,100,274,0,274
2014,Berkley,F,87,238,36,274
2014,Carlie,F,100,274,0,274
2014,Dilan,M,98,6,268,274
2014,Franco,M,100,0,274,274
2014,Junior,M,100,0,274,274
2014,Riya,F,100,274,0,274
2014,Jamir,M,100,0,273,273
2014,Semaj,M,79,56,217,273
2014,Terrell,M,100,0,273,273
2014,Abril,F,100,272,0,272
2014,Aubrianna,F,100,272,0,272
2014,Dani,F,92,249,23,272
2014,Giancarlo,M,100,0,272,272
2014,Patience,F,98,267,5,272
2014,Braiden,M,100,0,271,271
2014,Draven,M,100,0,271,271
2014,Jocelynn,F,100,271,0,271
2014,Kylah,F,100,271,0,271
2014,Louisa,F,100,271,0,271
2014,Pyper,F,100,271,0,271
2014,Titan,M,100,0,271,271
2014,Antonia,F,100,270,0,270
2014,Harold,M,100,0,270,270
2014,Jayde,F,96,259,11,270
2014,Magdalena,F,100,270,0,270
2014,Moriah,F,100,270,0,270
2014,Tamia,F,100,270,0,270
2014,Zayn,M,100,0,270,270
2014,Briggs,M,100,0,269,269
2014,Kourtney,F,94,252,17,269
2014,Akira,F,87,233,35,268
2014,Aya,F,100,268,0,268
2014,Chaim,M,100,0,268,268
2014,Dariel,M,98,6,262,268
2014,Ellery,F,95,254,14,268
2014,Ireland,F,100,268,0,268
2014,Jaydon,M,96,10,258,268
2014,Joziah,M,100,0,268,268
2014,Kaidyn,M,71,79,189,268
2014,Marquis,M,100,0,268,268
2014,Mercedes,F,100,268,0,268
2014,Rosalyn,F,100,268,0,268
2014,Alaysia,F,100,267,0,267
2014,Annalee,F,100,267,0,267
2014,Harlem,M,74,70,197,267
2014,Aanya,F,100,266,0,266
2014,Carsyn,F,63,167,99,266
2014,Paula,F,100,266,0,266
2014,Samiyah,F,100,266,0,266
2014,Yaritza,F,100,266,0,266
2014,Jonathon,M,100,0,265,265
2014,Cordelia,F,100,264,0,264
2014,Ira,M,61,104,160,264
2014,Joelle,F,93,245,19,264
2014,Kenny,M,100,0,264,264
2014,Nala,F,100,264,0,264
2014,Belen,F,100,263,0,263
2014,Brent,M,100,0,263,263
2014,Cambria,F,100,263,0,263
2014,Clay,M,100,0,263,263
2014,Natalya,F,100,263,0,263
2014,Stetson,M,100,0,263,263
2014,Tyrone,M,100,0,263,263
2014,Gibson,M,97,8,254,262
2014,Kaelynn,F,100,262,0,262
2014,Reuben,M,100,0,262,262
2014,Alfonso,M,100,0,261,261
2014,Axl,M,100,0,261,261
2014,Kyndall,F,97,254,7,261
2014,Neveah,F,100,261,0,261
2014,Aidyn,M,88,31,229,260
2014,Amaris,F,95,247,13,260
2014,Stefan,M,100,0,260,260
2014,Adilene,F,100,259,0,259
2014,Karma,F,97,250,9,259
2014,Krystal,F,100,259,0,259
2014,Marcel,M,100,0,259,259
2014,Promise,F,96,248,11,259
2014,Scout,F,79,205,54,259
2014,Brisa,F,100,258,0,258
2014,Charlize,F,100,258,0,258
2014,Emani,F,96,247,11,258
2014,Jurnee,F,100,258,0,258
2014,Rudy,M,98,5,253,258
2014,Castiel,M,98,5,252,257
2014,Esperanza,F,100,257,0,257
2014,Jean,M,71,74,183,257
2014,Kailynn,F,100,257,0,257
2014,Kalel,M,100,0,257,257
2014,Sonny,M,94,16,241,257
2014,Treasure,F,95,245,12,257
2014,Triston,M,100,0,257,257
2014,Alianna,F,100,256,0,256
2014,Bayleigh,F,100,256,0,256
2014,Darrell,M,100,0,256,256
2014,Steve,M,100,0,256,256
2014,Abdiel,M,100,0,255,255
2014,Cristina,F,100,255,0,255
2014,Carina,F,100,254,0,254
2014,Caydence,F,94,239,15,254
2014,Nathalia,F,100,254,0,254
2014,Princess,F,100,254,0,254
2014,Thatcher,M,100,0,254,254
2014,Tristian,M,97,7,247,254
2014,Henrik,M,100,0,253,253
2014,Honesty,F,100,253,0,253
2014,Jadon,M,100,0,253,253
2014,Jairo,M,100,0,253,253
2014,Vienna,F,100,253,0,253
2014,Avalyn,F,100,251,0,251
2014,Ayana,F,100,251,0,251
2014,Hugh,M,100,0,251,251
2014,Karsen,M,77,57,194,251
2014,Belle,F,100,250,0,250
2014,Ever,M,55,113,137,250
2014,Konnor,M,100,0,250,250
2014,Lachlan,M,94,14,236,250
2014,Raylee,F,100,250,0,250
2014,Aadhya,F,100,249,0,249
2014,Brighton,M,61,97,152,249
2014,Kaitlin,F,100,249,0,249
2014,Vaughn,M,90,25,224,249
2014,Mylah,F,100,248,0,248
2014,Robyn,F,97,241,7,248
2014,Rylen,M,83,43,205,248
2014,Salem,F,57,141,107,248
2014,Cristiano,M,100,0,247,247
2014,Deshawn,M,100,0,247,247
2014,Eliezer,M,100,0,247,247
2014,Harmoni,F,100,247,0,247
2014,Lyra,F,100,247,0,247
2014,Agustin,M,100,0,246,246
2014,Destinee,F,100,246,0,246
2014,Ernest,M,100,0,246,246
2014,Saanvi,F,100,246,0,246
2014,Sarahi,F,100,246,0,246
2014,Selina,F,100,246,0,246
2014,Sunny,F,82,201,45,246
2014,Brice,M,98,5,240,245
2014,Dwayne,M,100,0,245,245
2014,Ellianna,F,100,245,0,245
2014,Harlan,M,91,21,224,245
2014,Jacquelyn,F,100,245,0,245
2014,Kaeden,M,97,7,238,245
2014,Abbie,F,100,244,0,244
2014,Dimitri,M,100,0,244,244
2014,Ford,M,100,0,244,244
2014,Jakayla,F,100,244,0,244
2014,Kaley,F,100,244,0,244
2014,Poppy,F,100,244,0,244
2014,Rey,M,100,0,244,244
2014,Zavier,M,100,0,244,244
2014,Charity,F,100,243,0,243
2014,Gwyneth,F,100,243,0,243
2014,Haleigh,F,100,243,0,243
2014,Arnav,M,100,0,242,242
2014,Aydan,M,97,7,235,242
2014,Cecily,F,100,242,0,242
2014,Darwin,M,97,7,235,242
2014,Houston,M,93,16,226,242
2014,Vance,M,100,0,242,242
2014,Vivien,F,100,242,0,242
2014,Jamarion,M,100,0,241,241
2014,Kohen,M,97,7,234,241
2014,Lochlan,M,97,8,233,241
2014,Luz,F,98,236,5,241
2014,Ramiro,M,100,0,241,241
2014,Elissa,F,100,240,0,240
2014,Gilbert,M,100,0,239,239
2014,Preslee,F,96,230,9,239
2014,Rilynn,F,95,228,11,239
2014,Aleigha,F,100,238,0,238
2014,Aminah,F,100,238,0,238
2014,Augustine,M,92,18,220,238
2014,Dalilah,F,100,238,0,238
2014,Jayse,M,98,5,233,238
2014,Londynn,F,100,238,0,238
2014,Anton,M,100,0,237,237
2014,Coen,M,100,0,237,237
2014,Hollis,M,53,112,125,237
2014,Jordy,M,96,9,228,237
2014,Kannon,M,98,5,232,237
2014,Konner,M,98,5,232,237
2014,Salvatore,M,100,0,237,237
2014,Seamus,M,100,0,237,237
2014,Turner,M,95,13,224,237
2014,Aaden,M,100,0,236,236
2014,Anais,F,96,227,9,236
2014,Ayan,M,88,29,207,236
2014,Bree,F,100,236,0,236
2014,Korbyn,M,83,39,197,236
2014,Rolando,M,100,0,236,236
2014,Carleigh,F,100,235,0,235
2014,Karis,F,100,235,0,235
2014,Kensington,F,97,229,6,235
2014,Kinlee,F,100,235,0,235
2014,Randall,M,100,0,235,235
2014,Santos,M,100,0,235,235
2014,Aubriana,F,100,234,0,234
2014,Damari,M,92,18,216,234
2014,Elora,F,100,234,0,234
2014,Rashad,M,100,0,234,234
2014,Romina,F,100,234,0,234
2014,Tinley,F,100,234,0,234
2014,Carley,F,100,233,0,233
2014,Micaela,F,100,233,0,233
2014,Mustafa,M,100,0,233,233
2014,Ramona,F,100,233,0,233
2014,Rhea,F,100,233,0,233
2014,Tess,F,100,233,0,233
2014,Analia,F,100,232,0,232
2014,Johnathon,M,100,0,232,232
2014,Kataleya,F,100,232,0,232
2014,Larissa,F,100,232,0,232
2014,Camren,M,94,15,216,231
2014,Carsen,M,88,27,204,231
2014,Giada,F,100,231,0,231
2014,Jazmyn,F,100,231,0,231
2014,Jovani,M,100,0,231,231
2014,Mavis,F,100,231,0,231
2014,Maximo,M,100,0,231,231
2014,Raleigh,F,52,120,111,231
2014,Alvaro,M,100,0,230,230
2014,Clinton,M,100,0,230,230
2014,Elina,F,100,230,0,230
2014,Katrina,F,100,230,0,230
2014,Kinleigh,F,100,230,0,230
2014,Audra,F,100,229,0,229
2014,Deanna,F,100,229,0,229
2014,Emerald,F,95,217,12,229
2014,Jana,F,100,229,0,229
2014,Saniya,F,100,229,0,229
2014,Aven,M,53,108,120,228
2014,Davin,M,100,0,228,228
2014,Gavyn,M,98,5,223,228
2014,Jai,M,86,32,196,228
2014,Jericho,M,97,7,221,228
2014,Kamilah,F,100,228,0,228
2014,Lillyana,F,100,228,0,228
2014,Aries,M,70,68,159,227
2014,Elayna,F,100,227,0,227
2014,Karleigh,F,100,227,0,227
2014,Kylen,M,92,18,209,227
2014,Ephraim,M,100,0,226,226
2014,Heath,M,100,0,226,226
2014,India,F,100,226,0,226
2014,Kamron,M,100,0,226,226
2014,Kinsey,F,100,226,0,226
2014,Sylvie,F,100,226,0,226
2014,Coleman,M,98,5,220,225
2014,Craig,M,100,0,225,225
2014,Dash,M,98,5,220,225
2014,Joan,M,67,75,150,225
2014,Makhi,M,97,6,219,225
2014,Ophelia,F,100,225,0,225
2014,Veda,F,100,225,0,225
2014,Zoya,F,100,225,0,225
2014,Cristopher,M,100,0,224,224
2014,Gordon,M,100,0,224,224
2014,Kelsie,F,100,224,0,224
2014,Kendyl,F,97,218,6,224
2014,Maylee,F,100,224,0,224
2014,Vivaan,M,100,0,224,224
2014,Ameer,M,100,0,223,223
2014,Gino,M,100,0,223,223
2014,Jovanni,M,100,0,223,223
2014,Kyndal,F,98,218,5,223
2014,Maddux,M,93,15,208,223
2014,Marion,F,63,141,82,223
2014,Stacy,F,90,201,22,223
2014,Theresa,F,100,223,0,223
2014,Benton,M,100,0,222,222
2014,Eliot,M,86,31,191,222
2014,Giavanna,F,100,222,0,222
2014,Izabelle,F,100,222,0,222
2014,Kamille,F,100,222,0,222
2014,Rodolfo,M,100,0,222,222
2014,Jaycob,M,100,0,221,221
2014,Jorden,M,87,29,192,221
2014,Sailor,F,90,198,23,221
2014,Sariyah,F,100,221,0,221
2014,Tinsley,F,100,221,0,221
2014,Avi,M,85,34,186,220
2014,Eliseo,M,100,0,220,220
2014,Khalid,M,100,0,220,220
2014,Lillyanna,F,100,220,0,220
2014,Quintin,M,100,0,220,220
2014,Adilynn,F,100,219,0,219
2014,Cheyanne,F,100,219,0,219
2014,Jaleah,F,100,219,0,219
2014,Marlowe,F,93,203,16,219
2014,Sanaa,F,100,219,0,219
2014,Zaid,M,100,0,219,219
2014,Anakin,M,100,0,218,218
2014,Emmet,M,100,0,218,218
2014,Foster,M,95,11,207,218
2014,Haiden,M,72,60,158,218
2014,Judson,M,100,0,218,218
2014,Rian,M,59,89,129,218
2014,Truman,M,100,0,218,218
2014,Brogan,M,92,18,199,217
2014,Camilo,M,100,0,217,217
2014,Darien,M,98,5,212,217
2014,Efrain,M,100,0,217,217
2014,Gisselle,F,100,217,0,217
2014,Leela,F,100,217,0,217
2014,Anneliese,F,100,216,0,216
2014,Annelise,F,100,216,0,216
2014,Antonella,F,100,216,0,216
2014,Delia,F,100,216,0,216
2014,Araceli,F,100,215,0,215
2014,Dalary,F,100,215,0,215
2014,Deangelo,M,100,0,215,215
2014,Egypt,F,80,173,42,215
2014,Emmie,F,100,215,0,215
2014,Giovanny,M,100,0,215,215
2014,Maddie,F,100,215,0,215
2014,Mike,M,100,0,215,215
2014,Addalyn,F,100,214,0,214
2014,Dario,M,100,0,214,214
2014,Gentry,M,52,102,112,214
2014,Kale,M,100,0,214,214
2014,Maren,F,100,214,0,214
2014,Perry,M,68,68,146,214
2014,Britney,F,100,213,0,213
2014,Broderick,M,100,0,213,213
2014,Jayvion,M,100,0,213,213
2014,Kaison,M,100,0,213,213
2014,Koen,M,100,0,213,213
2014,Magnus,M,100,0,213,213
2014,Kayleen,F,100,212,0,212
2014,Valentin,M,100,0,212,212
2014,Zelda,F,100,212,0,212
2014,Belinda,F,100,211,0,211
2014,Bodie,M,100,0,211,211
2014,Brayson,M,100,0,211,211
2014,Chace,M,100,0,211,211
2014,Dania,F,100,211,0,211
2014,Leilah,F,100,211,0,211
2014,Meghan,F,100,211,0,211
2014,Whitley,F,93,197,14,211
2014,Adalee,F,100,210,0,210
2014,Damaris,F,96,201,9,210
2014,Kacey,F,84,177,33,210
2014,Mika,F,84,176,34,210
2014,Rachael,F,100,209,0,209
2014,Rosalee,F,100,209,0,209
2014,Roxanne,F,100,209,0,209
2014,Sally,F,100,209,0,209
2014,Yehuda,M,100,0,209,209
2014,Bridger,M,100,0,208,208
2014,Diya,F,100,208,0,208
2014,Everlee,F,100,208,0,208
2014,Howard,M,100,0,208,208
2014,Jadyn,F,62,130,78,208
2014,Jenesis,F,100,208,0,208
2014,Marlene,F,100,208,0,208
2014,Osvaldo,M,100,0,208,208
2014,Priya,F,100,208,0,208
2014,Rocky,M,100,0,208,208
2014,Annabeth,F,100,207,0,207
2014,Boden,M,100,0,207,207
2014,Elodie,F,100,207,0,207
2014,Etta,F,100,207,0,207
2014,Itzayana,F,100,207,0,207
2014,Jair,M,100,0,207,207
2014,Reyansh,M,100,0,207,207
2014,Tyree,M,100,0,207,207
2014,Ailyn,F,100,206,0,206
2014,Amayah,F,100,206,0,206
2014,Ean,M,100,0,206,206
2014,Katerina,F,100,206,0,206
2014,Malayah,F,100,206,0,206
2014,Samira,F,100,206,0,206
2014,Taraji,F,97,200,6,206
2014,Tristin,M,93,15,191,206
2014,Addie,F,100,205,0,205
2014,Amiah,F,100,205,0,205
2014,Coral,F,100,205,0,205
2014,Evalynn,F,100,205,0,205
2014,Kooper,M,86,28,177,205
2014,Laken,F,53,108,97,205
2014,Leif,M,100,0,205,205
2014,Garrison,M,100,0,204,204
2014,Kaycee,F,97,197,7,204
2014,Merrick,M,95,11,193,204
2014,Rihanna,F,100,204,0,204
2014,Annaliese,F,100,203,0,203
2014,Audrianna,F,100,203,0,203
2014,Demarcus,M,100,0,203,203
2014,Karissa,F,100,203,0,203
2014,Kaylani,F,100,203,0,203
2014,Pierre,M,100,0,203,203
2014,Branden,M,100,0,202,202
2014,Keily,F,100,202,0,202
2014,Kenleigh,F,100,202,0,202
2014,Maxine,F,100,202,0,202
2014,Musa,M,100,0,202,202
2014,Otis,M,100,0,202,202
2014,Anayah,F,100,201,0,201
2014,Gerard,M,100,0,201,201
2014,Gracyn,F,97,195,6,201
2014,Ila,F,100,201,0,201
2014,Jaylyn,F,82,165,36,201
2014,Maritza,F,100,201,0,201
2014,Marlie,F,100,201,0,201
2014,Tyrell,M,100,0,201,201
2014,Asha,F,100,200,0,200
2014,Blaire,F,98,195,5,200
2014,Britton,M,52,97,103,200
2014,Freddy,M,100,0,200,200
2014,Hailie,F,100,200,0,200
2014,Immanuel,M,100,0,200,200
2014,Jamar,M,100,0,200,200
2014,Kaylyn,F,100,200,0,200
2014,Nahla,F,100,200,0,200
2014,Ryley,M,54,92,108,200
2014,Shirley,F,100,200,0,200
2014,Vada,F,100,200,0,200
2014,Aarya,F,89,178,21,199
2014,Cassie,F,100,199,0,199
2014,Harleigh,F,100,199,0,199
2014,Jordin,F,62,124,75,199
2014,Kaleah,F,100,199,0,199
2014,Kamren,M,94,12,187,199
2014,Karmen,F,100,199,0,199
2014,Lorena,F,100,199,0,199
2014,Louise,F,100,199,0,199
2014,Makena,F,100,199,0,199
2014,Persephone,F,100,199,0,199
2014,Yesenia,F,100,199,0,199
2014,Abner,M,100,0,198,198
2014,Alessia,F,100,198,0,198
2014,Areli,F,100,198,0,198
2014,Brenton,M,100,0,198,198
2014,Dariana,F,100,198,0,198
2014,Gilberto,M,100,0,198,198
2014,Jackie,F,60,119,79,198
2014,Sofie,F,100,198,0,198
2014,Zayla,F,100,198,0,198
2014,Cambree,F,100,197,0,197
2014,Jakobe,M,100,0,197,197
2014,Keller,M,85,29,168,197
2014,Menachem,M,100,0,197,197
2014,Brynleigh,F,100,196,0,196
2014,Calliope,F,100,196,0,196
2014,Darnell,M,100,0,196,196
2014,Elia,F,88,173,23,196
2014,Emi,F,100,196,0,196
2014,Isabell,F,100,196,0,196
2014,Rayyan,M,94,12,184,196
2014,Silvia,F,100,196,0,196
2014,Clarence,M,100,0,195,195
2014,Cormac,M,100,0,195,195
2014,Darcy,F,94,183,12,195
2014,Deon,M,100,0,195,195
2014,Jacey,F,94,183,12,195
2014,Xiomara,F,100,195,0,195
2014,Yuliana,F,100,195,0,195
2014,Adley,F,91,176,18,194
2014,Blessing,F,92,179,15,194
2014,Brysen,M,100,0,194,194
2014,Cortez,M,100,0,194,194
2014,Dangelo,M,100,0,194,194
2014,Krish,M,100,0,194,194
2014,Leena,F,100,194,0,194
2014,Maryjane,F,100,194,0,194
2014,Maxx,M,96,8,186,194
2014,Zyaire,M,88,24,170,194
2014,Adilyn,F,100,193,0,193
2014,Boone,M,100,0,193,193
2014,Della,F,100,193,0,193
2014,Kalia,F,100,193,0,193
2014,Ralph,M,100,0,193,193
2014,Raya,F,100,193,0,193
2014,Selene,F,100,193,0,193
2014,Annaleigh,F,100,192,0,192
2014,Antoine,M,100,0,192,192
2014,Isa,M,51,94,98,192
2014,Nya,F,100,192,0,192
2014,Octavio,M,100,0,192,192
2014,Viola,F,100,192,0,192
2014,Aliyana,F,100,191,0,191
2014,Jarrett,M,100,0,191,191
2014,Karli,F,100,191,0,191
2014,Rylynn,F,96,183,8,191
2014,Tania,F,100,191,0,191
2014,Betty,F,100,190,0,190
2014,Brynley,F,100,190,0,190
2014,Canaan,M,94,12,178,190
2014,Derick,M,100,0,190,190
2014,Haylie,F,100,190,0,190
2014,Reilly,M,54,88,102,190
2014,Rubi,F,100,190,0,190
2014,Shay,F,72,137,53,190
2014,Tia,F,100,190,0,190
2014,Valery,F,100,190,0,190
2014,Violeta,F,100,190,0,190
2014,Addelyn,F,100,189,0,189
2014,Ananya,F,100,189,0,189
2014,Bishop,M,100,0,189,189
2014,Capri,F,100,189,0,189
2014,Marian,F,100,189,0,189
2014,Nyah,F,100,189,0,189
2014,Aayden,M,100,0,188,188
2014,Aditya,M,100,0,188,188
2014,Aleyda,F,100,188,0,188
2014,Celina,F,100,188,0,188
2014,Essence,F,100,188,0,188
2014,Gretchen,F,100,188,0,188
2014,Juelz,M,95,9,179,188
2014,Kenton,M,100,0,188,188
2014,Naima,F,100,188,0,188
2014,Rebeca,F,100,188,0,188
2014,Agnes,F,100,187,0,187
2014,Katarina,F,100,187,0,187
2014,Kye,M,91,16,171,187
2014,Roslyn,F,100,187,0,187
2014,Tadeo,M,100,0,187,187
2014,Teegan,F,58,109,78,187
2014,Trystan,M,91,16,171,187
2014,Violette,F,100,187,0,187
2014,Elvis,M,100,0,186,186
2014,Kenzi,F,100,186,0,186
2014,Kiersten,F,100,186,0,186
2014,Alora,F,100,185,0,185
2014,Brayleigh,F,100,185,0,185
2014,Cairo,M,92,14,171,185
2014,Davina,F,100,185,0,185
2014,Dior,F,75,139,46,185
2014,Eisley,F,100,185,0,185
2014,Emmerson,F,84,155,30,185
2014,Kaila,F,100,185,0,185
2014,Paisleigh,F,100,185,0,185
2014,Pamela,F,100,185,0,185
2014,Samiya,F,100,185,0,185
2014,Skylynn,F,100,185,0,185
2014,Abrianna,F,100,184,0,184
2014,Adela,F,100,184,0,184
2014,Decker,M,97,5,179,184
2014,Isiah,M,100,0,184,184
2014,Kadyn,M,74,48,136,184
2014,Kynleigh,F,100,184,0,184
2014,Ross,M,100,0,184,184
2014,Yisroel,M,100,0,184,184
2014,Ashanti,F,100,183,0,183
2014,Dale,M,97,5,178,183
2014,Emry,F,75,138,45,183
2014,Graeme,M,100,0,183,183
2014,Heavenly,F,100,183,0,183
2014,Kirsten,F,100,183,0,183
2014,Leroy,M,100,0,183,183
2014,Masen,M,97,5,178,183
2014,Yazmin,F,100,183,0,183
2014,Denzel,M,100,0,182,182
2014,Florence,F,100,182,0,182
2014,Jaqueline,F,100,182,0,182
2014,Katy,F,100,182,0,182
2014,Nellie,F,100,182,0,182
2014,Stone,M,97,6,176,182
2014,Aarush,M,100,0,181,181
2014,Amora,F,100,181,0,181
2014,Harris,M,97,5,176,181
2014,Leigha,F,100,181,0,181
2014,Malak,F,92,166,15,181
2014,Zaylee,F,100,181,0,181
2014,Alanis,F,100,180,0,180
2014,Annette,F,100,180,0,180
2014,Brendon,M,100,0,180,180
2014,Damarion,M,100,0,180,180
2014,Izayah,M,100,0,180,180
2014,Maite,F,100,180,0,180
2014,Reign,F,74,133,47,180
2014,Todd,M,100,0,180,180
2014,Devan,M,84,29,150,179
2014,Hayleigh,F,100,179,0,179
2014,Karim,M,100,0,179,179
2014,Luisa,F,100,179,0,179
2014,Maisy,F,100,179,0,179
2014,Yadiel,M,100,0,179,179
2014,Alanah,F,100,178,0,178
2014,Arantza,F,100,178,0,178
2014,Darryl,M,100,0,178,178
2014,Dion,M,91,16,162,178
2014,Lyle,M,94,10,168,178
2014,Miyah,F,100,178,0,178
2014,Opal,F,100,178,0,178
2014,Roderick,M,100,0,178,178
2014,Vivianna,F,100,178,0,178
2014,Adyson,F,100,177,0,177
2014,Aliah,F,100,177,0,177
2014,Carlo,M,100,0,177,177
2014,Karly,F,100,177,0,177
2014,Koda,M,91,16,161,177
2014,Ledger,M,100,0,177,177
2014,Loretta,F,100,177,0,177
2014,Nikita,M,55,79,98,177
2014,Blythe,F,95,167,9,176
2014,Colbie,F,96,169,7,176
2014,Hillary,F,100,176,0,176
2014,Janice,F,100,176,0,176
2014,Keila,F,100,176,0,176
2014,Kya,F,100,176,0,176
2014,Milah,F,100,176,0,176
2014,Slade,M,100,0,176,176
2014,Tianna,F,100,176,0,176
2014,Yasmine,F,100,176,0,176
2014,Alistair,M,100,0,175,175
2014,Beatrix,F,100,175,0,175
2014,Cailyn,F,100,175,0,175
2014,Caleigh,F,100,175,0,175
2014,Lathan,M,100,0,175,175
2014,Mariano,M,100,0,175,175
2014,Marin,F,93,162,13,175
2014,Milton,M,100,0,175,175
2014,Seraphina,F,100,175,0,175
2014,Soraya,F,100,175,0,175
2014,Torin,M,94,10,165,175
2014,Vida,F,100,175,0,175
2014,Aarna,F,100,174,0,174
2014,Aiyanna,F,100,174,0,174
2014,Ignacio,M,100,0,174,174
2014,Laniyah,F,100,174,0,174
2014,Micaiah,M,76,41,133,174
2014,Rayleigh,F,100,174,0,174
2014,Suri,F,100,174,0,174
2014,Westley,M,100,0,174,174
2014,Yair,M,100,0,174,174
2014,Youssef,M,100,0,174,174
2014,Cale,M,100,0,173,173
2014,Elly,F,100,173,0,173
2014,Gray,M,73,47,126,173
2014,Lizeth,F,100,173,0,173
2014,Montana,F,72,124,49,173
2014,Nikhil,M,100,0,173,173
2014,Tracy,F,74,128,45,173
2014,Yandel,M,100,0,173,173
2014,Chevelle,F,95,163,9,172
2014,Edmund,M,100,0,172,172
2014,Jaylon,M,100,0,172,172
2014,Jazelle,F,100,172,0,172
2014,Kinzley,F,100,172,0,172
2014,Marisa,F,100,172,0,172
2014,Meera,F,100,172,0,172
2014,Shyanne,F,100,172,0,172
2014,Simeon,M,100,0,172,172
2014,Addalynn,F,100,171,0,171
2014,Cael,M,100,0,171,171
2014,Corbyn,M,89,19,152,171
2014,Deklan,M,100,0,171,171
2014,Jaxx,M,100,0,171,171
2014,Jesiah,M,84,27,144,171
2014,Litzy,F,100,171,0,171
2014,Louie,M,100,0,171,171
2014,Malka,F,100,171,0,171
2014,Mariela,F,100,171,0,171
2014,Shreya,F,100,171,0,171
2014,Ulysses,M,100,0,171,171
2014,Zahir,M,100,0,171,171
2014,Amar,M,91,16,154,170
2014,Audree,F,100,170,0,170
2014,Eason,M,100,0,170,170
2014,Elana,F,100,170,0,170
2014,Fox,M,96,7,163,170
2014,Greysen,M,91,15,155,170
2014,Humberto,M,100,0,170,170
2014,Lilyann,F,100,170,0,170
2014,Mikah,M,74,45,125,170
2014,Norman,M,100,0,170,170
2014,Achilles,M,100,0,169,169
2014,Aedan,M,100,0,169,169
2014,Aleksander,M,100,0,169,169
2014,Damion,M,100,0,169,169
2014,Darlene,F,100,169,0,169
2014,Imran,M,100,0,169,169
2014,Irie,F,87,147,22,169
2014,Jaeden,M,93,11,158,169
2014,Jovie,F,100,169,0,169
2014,Austen,M,74,43,125,168
2014,Christiana,F,100,168,0,168
2014,Davon,M,100,0,168,168
2014,Jeremias,M,100,0,168,168
2014,Jovan,M,100,0,168,168
2014,Kashton,M,100,0,168,168
2014,Keon,M,100,0,168,168
2014,Loren,F,55,93,75,168
2014,Milagros,F,100,168,0,168
2014,Mordechai,M,100,0,168,168
2014,Sami,M,88,21,147,168
2014,Taylin,F,85,142,26,168
2014,Xavi,M,100,0,168,168
2014,Brinlee,F,100,167,0,167
2014,Dhruv,M,100,0,167,167
2014,Flora,F,100,167,0,167
2014,Isadora,F,100,167,0,167
2014,Isai,M,100,0,167,167
2014,Izzabella,F,100,167,0,167
2014,Janet,F,100,167,0,167
2014,Jaxxon,M,100,0,167,167
2014,Lyndon,M,87,21,146,167
2014,Malaki,M,100,0,167,167
2014,Novalee,F,100,167,0,167
2014,Raylynn,F,97,162,5,167
2014,Ridge,M,100,0,167,167
2014,Azul,F,95,158,8,166
2014,Bradyn,M,100,0,166,166
2014,Brixton,M,92,14,152,166
2014,Corban,M,100,0,166,166
2014,Geneva,F,100,166,0,166
2014,Iyanna,F,100,166,0,166
2014,Jaslyn,F,100,166,0,166
2014,Kallen,M,95,8,158,166
2014,Rita,F,100,166,0,166
2014,Tamara,F,100,166,0,166
2014,Vladimir,M,100,0,166,166
2014,Yahya,M,100,0,166,166
2014,Aniston,F,100,165,0,165
2014,Aston,M,97,5,160,165
2014,Elmer,M,100,0,165,165
2014,Jabari,M,100,0,165,165
2014,Melinda,F,100,165,0,165
2014,Nalani,F,100,165,0,165
2014,Taytum,F,82,135,30,165
2014,Aadya,F,100,164,0,164
2014,Anita,F,100,164,0,164
2014,Carissa,F,100,164,0,164
2014,Deegan,M,100,0,164,164
2014,Jamiyah,F,100,164,0,164
2014,Janie,F,100,164,0,164
2014,Johnpaul,M,100,0,164,164
2014,Jubilee,F,100,164,0,164
2014,Leilany,F,100,164,0,164
2014,Lianna,F,100,164,0,164
2014,Marcello,M,100,0,164,164
2014,Sammy,M,87,21,143,164
2014,Sheldon,M,100,0,164,164
2014,Adler,M,88,19,144,163
2014,Donte,M,100,0,163,163
2014,Josh,M,100,0,163,163
2014,Khadija,F,100,163,0,163
2014,Kylar,M,64,58,105,163
2014,Linus,M,100,0,163,163
2014,Mac,M,100,0,163,163
2014,Murphy,M,74,42,121,163
2014,Tayden,M,94,10,153,163
2014,Unique,F,90,147,16,163
2014,Zayd,M,100,0,163,163
2014,Adaline,F,100,162,0,162
2014,Colter,M,100,0,162,162
2014,Ivana,F,100,162,0,162
2014,Jaceon,M,100,0,162,162
2014,Skylah,F,100,162,0,162
2014,Yaneli,F,100,162,0,162
2014,Alton,M,100,0,161,161
2014,Darla,F,100,161,0,161
2014,Donna,F,100,161,0,161
2014,Farah,F,94,152,9,161
2014,German,M,100,0,161,161
2014,Guinevere,F,100,161,0,161
2014,Karley,F,100,161,0,161
2014,Maura,F,100,161,0,161
2014,Mayra,F,100,161,0,161
2014,Shanaya,F,100,161,0,161
2014,Yvette,F,100,161,0,161
2014,Carmine,M,97,5,155,160
2014,Imogen,F,100,160,0,160
2014,Jamya,F,100,160,0,160
2014,Karl,M,100,0,160,160
2014,Mccoy,M,96,7,153,160
2014,Mikel,M,100,0,160,160
2014,Ronaldo,M,100,0,160,160
2014,Sheila,F,100,160,0,160
2014,Shlomo,M,100,0,160,160
2014,Winnie,F,100,160,0,160
2014,Coby,M,100,0,159,159
2014,Dayanna,F,100,159,0,159
2014,Gisele,F,100,159,0,159
2014,Jordi,M,92,13,146,159
2014,Kamiyah,F,100,159,0,159
2014,Leticia,F,100,159,0,159
2014,Rylin,F,66,105,54,159
2014,Sapphire,F,100,159,0,159
2014,Shyla,F,100,159,0,159
2014,Eleni,F,100,158,0,158
2014,Geraldine,F,100,158,0,158
2014,Gianluca,M,100,0,158,158
2014,Glenn,M,100,0,158,158
2014,Kael,M,100,0,158,158
2014,Leyton,M,83,27,131,158
2014,Lidia,F,100,158,0,158
2014,Nadine,F,100,158,0,158
2014,Ocean,M,51,77,81,158
2014,Shimon,M,100,0,158,158
2014,Toni,F,94,149,9,158
2014,Yaretzy,F,100,158,0,158
2014,Abbey,F,100,157,0,157
2014,Bernard,M,100,0,157,157
2014,Charlene,F,100,157,0,157
2014,Daylen,M,96,7,150,157
2014,Ewan,M,100,0,157,157
2014,Gatlin,M,100,0,157,157
2014,Journi,F,100,157,0,157
2014,Marcella,F,100,157,0,157
2014,Pepper,F,100,157,0,157
2014,Shepherd,M,100,0,157,157
2014,Sonya,F,100,157,0,157
2014,Stephan,M,100,0,157,157
2014,Susanna,F,100,157,0,157
2014,Tristyn,M,60,63,94,157
2014,Viktor,M,100,0,157,157
2014,Wesson,M,100,0,157,157
2014,Brennen,M,97,5,151,156
2014,Carmella,F,100,156,0,156
2014,Guy,M,100,0,156,156
2014,Honor,F,69,107,49,156
2014,Jaydan,M,93,11,145,156
2014,Jazzlyn,F,100,156,0,156
2014,Lacy,F,96,149,7,156
2014,Mariella,F,100,156,0,156
2014,Mikael,M,96,6,150,156
2014,Mireya,F,100,156,0,156
2014,Nick,M,100,0,156,156
2014,Shaylee,F,100,156,0,156
2014,Shmuel,M,100,0,156,156
2014,Angely,F,100,155,0,155
2014,Brookelynn,F,100,155,0,155
2014,Cayla,F,100,155,0,155
2014,Coy,M,97,5,150,155
2014,Evangelina,F,100,155,0,155
2014,Gus,M,100,0,155,155
2014,Halo,F,86,133,22,155
2014,Keziah,F,100,155,0,155
2014,Kyren,M,97,5,150,155
2014,Linnea,F,100,155,0,155
2014,Avalon,F,100,154,0,154
2014,Calista,F,100,154,0,154
2014,Delanie,F,100,154,0,154
2014,Diesel,M,100,0,154,154
2014,Gaige,M,94,9,145,154
2014,Justyce,F,81,125,29,154
2014,Ruger,M,100,0,154,154
2014,Taj,M,92,12,142,154
2014,Yara,F,100,154,0,154
2014,Aida,F,100,153,0,153
2014,Bently,M,100,0,153,153
2014,Clover,F,100,153,0,153
2014,Dafne,F,100,153,0,153
2014,Dalila,F,100,153,0,153
2014,Gina,F,100,153,0,153
2014,Jarvis,M,100,0,153,153
2014,Johnnie,M,76,37,116,153
2014,Kiyan,M,95,7,146,153
2014,Maribel,F,100,153,0,153
2014,Ramsey,M,61,60,93,153
2014,Raylen,M,68,49,104,153
2014,Shania,F,100,153,0,153
2014,Analise,F,100,152,0,152
2014,Armaan,M,100,0,152,152
2014,Cian,M,100,0,152,152
2014,Dillan,M,91,13,139,152
2014,Emir,M,100,0,152,152
2014,Idris,M,97,5,147,152
2014,Jaclyn,F,100,152,0,152
2014,Kain,M,100,0,152,152
2014,Kelton,M,100,0,152,152
2014,Sarina,F,100,152,0,152
2014,Soleil,F,100,152,0,152
2014,Tobin,M,100,0,152,152
2014,Vince,M,100,0,152,152
2014,Ayesha,F,100,151,0,151
2014,Cornelius,M,100,0,151,151
2014,Evolet,F,100,151,0,151
2014,Layan,F,100,151,0,151
2014,Lux,F,82,124,27,151
2014,Alaric,M,100,0,150,150
2014,Amor,F,84,126,24,150
2014,Bridgette,F,100,150,0,150
2014,Jionni,M,100,0,150,150
2014,Lucie,F,100,150,0,150
2014,Margo,F,100,150,0,150
2014,Merritt,F,57,86,64,150
2014,Nigel,M,100,0,150,150
2014,Peighton,F,97,145,5,150
2014,Rico,M,100,0,150,150
2014,Tina,F,100,150,0,150
2014,Yoselin,F,100,150,0,150
2014,Alba,F,100,149,0,149
2014,Aracely,F,100,149,0,149
2014,Araya,F,100,149,0,149
2014,Arlene,F,100,149,0,149
2014,Bilal,M,100,0,149,149
2014,Claira,F,100,149,0,149
2014,Dereck,M,100,0,149,149
2014,Izabel,F,100,149,0,149
2014,Jaziel,M,100,0,149,149
2014,Lela,F,100,149,0,149
2014,Lucien,M,100,0,149,149
2014,Yamilet,F,100,149,0,149
2014,Alyse,F,100,148,0,148
2014,Cambrie,F,100,148,0,148
2014,Carol,F,100,148,0,148
2014,Carrie,F,100,148,0,148
2014,Evelina,F,100,148,0,148
2014,Jacobi,M,100,0,148,148
2014,Kalea,F,100,148,0,148
2014,Kent,M,100,0,148,148
2014,Korie,F,94,139,9,148
2014,Lian,M,80,29,119,148
2014,Nailah,F,100,148,0,148
2014,Raheem,M,100,0,148,148
2014,Zamir,M,100,0,148,148
2014,Zev,M,100,0,148,148
2014,Ariane,F,100,147,0,147
2014,Denisse,F,100,147,0,147
2014,Destin,M,88,17,130,147
2014,Jacen,M,100,0,147,147
2014,Jersey,F,93,137,10,147
2014,Josias,M,100,0,147,147
2014,Jules,F,57,84,63,147
2014,Keeley,F,100,147,0,147
2014,Kynslee,F,100,147,0,147
2014,Lillyann,F,100,147,0,147
2014,Oaklee,F,72,106,41,147
2014,Pranav,M,100,0,147,147
2014,Queen,F,100,147,0,147
2014,Rilee,F,86,127,20,147
2014,Yaakov,M,100,0,147,147
2014,Gonzalo,M,100,0,146,146
2014,Judy,F,100,146,0,146
2014,Payson,M,51,72,74,146
2014,Rio,M,69,45,101,146
2014,Tevin,M,100,0,146,146
2014,Baron,M,100,0,145,145
2014,Elan,M,88,18,127,145
2014,Emiliana,F,100,145,0,145
2014,Eunice,F,100,145,0,145
2014,Janiah,F,100,145,0,145
2014,Kruz,M,100,0,145,145
2014,Kylin,M,57,63,82,145
2014,Luella,F,100,145,0,145
2014,Adalie,F,100,144,0,144
2014,Avani,F,97,139,5,144
2014,Avraham,M,100,0,144,144
2014,Dina,F,100,144,0,144
2014,Ema,F,100,144,0,144
2014,Ida,F,100,144,0,144
2014,Makenzi,F,100,144,0,144
2014,Nikko,M,100,0,144,144
2014,Ziva,F,100,144,0,144
2014,Adina,F,100,143,0,143
2014,Anaiah,F,100,143,0,143
2014,Benny,M,97,5,138,143
2014,Cristobal,M,100,0,143,143
2014,Damani,M,80,28,115,143
2014,Grecia,F,100,143,0,143
2014,Hartley,F,82,117,26,143
2014,Huxley,M,87,18,125,143
2014,Keelan,M,92,12,131,143
2014,Kyan,M,95,7,136,143
2014,Lucinda,F,100,143,0,143
2014,Marceline,F,100,143,0,143
2014,Marlo,F,61,87,56,143
2014,Petra,F,100,143,0,143
2014,Siddharth,M,100,0,143,143
2014,Smith,M,96,6,137,143
2014,Amarie,F,89,126,16,142
2014,Amarion,M,100,0,142,142
2014,Colson,M,100,0,142,142
2014,Elyssa,F,100,142,0,142
2014,Emme,F,100,142,0,142
2014,Eryn,F,94,133,9,142
2014,Francesco,M,100,0,142,142
2014,Indigo,F,76,108,34,142
2014,Irvin,M,100,0,142,142
2014,Kayley,F,100,142,0,142
2014,Maycee,F,100,142,0,142
2014,Mikhail,M,96,5,137,142
2014,Nariah,F,100,142,0,142
2014,Nicolette,F,100,142,0,142
2014,Sandy,F,92,130,12,142
2014,Tiago,M,100,0,142,142
2014,Yaseen,M,100,0,142,142
2014,Yeshua,M,100,0,142,142
2014,Zaniya,F,100,142,0,142
2014,Zyon,M,79,30,112,142
2014,Andie,F,100,141,0,141
2014,Ariela,F,100,141,0,141
2014,Harlie,F,100,141,0,141
2014,Jad,M,100,0,141,141
2014,Kamora,F,100,141,0,141
2014,Keanu,M,100,0,141,141
2014,Lacie,F,100,141,0,141
2014,Layna,F,100,141,0,141
2014,Miabella,F,100,141,0,141
2014,Zephaniah,M,87,18,123,141
2014,Adaleigh,F,100,140,0,140
2014,Aditi,F,100,140,0,140
2014,Beverly,F,100,140,0,140
2014,Brigitte,F,100,140,0,140
2014,Deven,M,100,0,140,140
2014,Elinor,F,100,140,0,140
2014,Fredrick,M,100,0,140,140
2014,Jaxsen,M,100,0,140,140
2014,Kathy,F,100,140,0,140
2014,Kyron,M,100,0,140,140
2014,Myka,F,87,122,18,140
2014,Noble,M,92,11,129,140
2014,Rome,M,89,15,125,140
2014,Sol,F,65,91,49,140
2014,Aayan,M,100,0,139,139
2014,Anyla,F,100,139,0,139
2014,Beatriz,F,100,139,0,139
2014,Calla,F,100,139,0,139
2014,Chelsey,F,100,139,0,139
2014,Chyna,F,100,139,0,139
2014,Eddy,M,100,0,139,139
2014,Geovanni,M,100,0,139,139
2014,Jailyn,F,83,115,24,139
2014,Kodi,F,58,81,58,139
2014,Love,F,91,127,12,139
2014,Meir,M,100,0,139,139
2014,Nichole,F,100,139,0,139
2014,Payten,F,91,126,13,139
2014,Reynaldo,M,100,0,139,139
2014,Syed,M,100,0,139,139
2014,Tallulah,F,100,139,0,139
2014,Zaden,M,100,0,139,139
2014,Annamarie,F,100,138,0,138
2014,Ariyanna,F,100,138,0,138
2014,Creed,M,100,0,138,138
2014,Emoni,F,95,131,7,138
2014,Estevan,M,100,0,138,138
2014,Heidy,F,100,138,0,138
2014,Jet,M,100,0,138,138
2014,Legacy,F,75,104,34,138
2014,Nelly,F,100,138,0,138
2014,Nikki,F,100,138,0,138
2014,Nyomi,F,100,138,0,138
2014,Rhyan,F,75,103,35,138
2014,Ridley,F,52,72,66,138
2014,Tahiry,F,100,138,0,138
2014,Tenzin,M,60,55,83,138
2014,Tyrese,M,100,0,138,138
2014,Zackery,M,100,0,138,138
2014,Aleeah,F,100,137,0,137
2014,Arabelle,F,100,137,0,137
2014,Benedict,M,100,0,137,137
2014,Eiza,F,100,137,0,137
2014,Emalyn,F,100,137,0,137
2014,Ishmael,M,100,0,137,137
2014,Maryann,F,100,137,0,137
2014,Taylen,M,55,62,75,137
2014,Wilder,M,93,9,128,137
2014,Yarely,F,100,137,0,137
2014,Zack,M,100,0,137,137
2014,Adolfo,M,100,0,136,136
2014,Antwan,M,100,0,136,136
2014,Arie,F,69,94,42,136
2014,Ariyana,F,100,136,0,136
2014,Auden,M,70,41,95,136
2014,Charly,F,79,108,28,136
2014,Chasity,F,100,136,0,136
2014,Daryl,M,100,0,136,136
2014,Ismail,M,100,0,136,136
2014,Kamiya,F,100,136,0,136
2014,Laci,F,100,136,0,136
2014,Leeland,M,96,5,131,136
2014,May,F,100,136,0,136
2014,Maylin,F,100,136,0,136
2014,Onyx,M,67,45,91,136
2014,Rain,F,75,102,34,136
2014,Rigoberto,M,100,0,136,136
2014,Rosemarie,F,100,136,0,136
2014,Rowdy,M,100,0,136,136
2014,Tala,F,100,136,0,136
2014,Zaylen,M,100,0,136,136
2014,Ahmir,M,100,0,135,135
2014,Cashton,M,100,0,135,135
2014,Deion,M,96,5,130,135
2014,Eamon,M,100,0,135,135
2014,Estefania,F,100,135,0,135
2014,Georgina,F,100,135,0,135
2014,Isha,F,100,135,0,135
2014,Khai,M,87,17,118,135
2014,Laith,M,100,0,135,135
2014,Lamont,M,100,0,135,135
2014,Pierson,M,100,0,135,135
2014,Renesmee,F,100,135,0,135
2014,Wallace,M,100,0,135,135
2014,Zia,F,90,122,13,135
2014,Alexandro,M,100,0,134,134
2014,Amyah,F,100,134,0,134
2014,Bryden,M,100,0,134,134
2014,Denim,M,70,40,94,134
2014,Eleanora,F,100,134,0,134
2014,Gracen,F,51,68,66,134
2014,Harmonie,F,100,134,0,134
2014,Jaron,M,100,0,134,134
2014,Karolina,F,100,134,0,134
2014,Kiran,M,72,38,96,134
2014,Lenora,F,100,134,0,134
2014,Lyrik,F,60,81,53,134
2014,Malina,F,100,134,0,134
2014,Ollie,M,54,61,73,134
2014,Quinten,M,100,0,134,134
2014,Shaniya,F,100,134,0,134
2014,Tahlia,F,100,134,0,134
2014,Unknown,M,51,65,69,134
2014,Zuriel,M,69,42,92,134
2014,Abbygail,F,100,133,0,133
2014,Avion,M,94,8,125,133
2014,Constance,F,100,133,0,133
2014,Darby,F,79,105,28,133
2014,Isaak,M,100,0,133,133
2014,Joslynn,F,100,133,0,133
2014,Josslyn,F,100,133,0,133
2014,Kace,M,100,0,133,133
2014,Kaylah,F,100,133,0,133
2014,Kristin,F,100,133,0,133
2014,Symphony,F,100,133,0,133
2014,Zahara,F,100,133,0,133
2014,Zora,F,100,133,0,133
2014,Amariah,F,100,132,0,132
2014,Billie,F,91,120,12,132
2014,Bronx,M,96,5,127,132
2014,Elvin,M,100,0,132,132
2014,Ethen,M,100,0,132,132
2014,Hans,M,100,0,132,132
2014,Jianna,F,100,132,0,132
2014,Kenlee,F,100,132,0,132
2014,Keyon,M,100,0,132,132
2014,Makinley,F,100,132,0,132
2014,Marquise,M,100,0,132,132
2014,Oskar,M,100,0,132,132
2014,Sanai,F,100,132,0,132
2014,Sebastien,M,100,0,132,132
2014,Seven,M,70,39,93,132
2014,Susana,F,100,132,0,132
2014,Vayda,F,100,132,0,132
2014,Waverly,F,100,132,0,132
2014,Westyn,M,93,9,123,132
2014,Alek,M,95,7,124,131
2014,Amerie,F,100,131,0,131
2014,Annmarie,F,100,131,0,131
2014,Betsy,F,100,131,0,131
2014,Braylynn,F,88,115,16,131
2014,Candice,F,100,131,0,131
2014,Chiara,F,100,131,0,131
2014,Donnie,M,96,5,126,131
2014,Hagen,M,95,7,124,131
2014,Iman,F,84,110,21,131
2014,Jaquan,M,100,0,131,131
2014,Kamilla,F,100,131,0,131
2014,Kamya,F,100,131,0,131
2014,Katia,F,100,131,0,131
2014,Maksim,M,100,0,131,131
2014,Margarita,F,100,131,0,131
2014,Precious,F,100,131,0,131
2014,Prisha,F,100,131,0,131
2014,Rhiannon,F,100,131,0,131
2014,Ajay,M,100,0,130,130
2014,Ashlee,F,100,130,0,130
2014,Braxtyn,M,90,13,117,130
2014,Caysen,M,96,5,125,130
2014,Emeri,F,94,122,8,130
2014,Graciela,F,100,130,0,130
2014,Izaac,M,100,0,130,130
2014,Johann,M,100,0,130,130
2014,Kalina,F,100,130,0,130
2014,Magdalene,F,100,130,0,130
2014,Mayah,F,100,130,0,130
2014,Nikola,M,91,12,118,130
2014,Skylee,F,100,130,0,130
2014,Syncere,M,79,27,103,130
2014,Taliah,F,100,130,0,130
2014,Tanya,F,100,130,0,130
2014,Aila,F,100,129,0,129
2014,Alessa,F,100,129,0,129
2014,Anjali,F,100,129,0,129
2014,Armoni,F,70,90,39,129
2014,Atreyu,M,100,0,129,129
2014,Bear,M,100,0,129,129
2014,Bernadette,F,100,129,0,129
2014,Blanca,F,100,129,0,129
2014,Citlali,F,100,129,0,129
2014,Dwight,M,100,0,129,129
2014,Forest,M,100,0,129,129
2014,Indiana,F,53,69,60,129
2014,Jakari,M,88,16,113,129
2014,Melani,F,100,129,0,129
2014,Abagail,F,100,128,0,128
2014,Andreas,M,100,0,128,128
2014,Benicio,M,100,0,128,128
2014,Cal,M,100,0,128,128
2014,Eliel,M,100,0,128,128
2014,Janney,F,100,128,0,128
2014,Keely,F,100,128,0,128
2014,Kenzley,F,100,128,0,128
2014,Milly,F,100,128,0,128
2014,Raeleigh,F,100,128,0,128
2014,Taelyn,F,91,116,12,128
2014,Tahj,M,100,0,128,128
2014,Trisha,F,100,128,0,128
2014,Wiley,M,92,10,118,128
2014,Brandt,M,100,0,127,127
2014,Devonte,M,100,0,127,127
2014,Ely,M,80,25,102,127
2014,Harriet,F,100,127,0,127
2014,Kaci,F,100,127,0,127
2014,Linden,M,54,58,69,127
2014,Lonnie,M,94,8,119,127
2014,Martina,F,100,127,0,127
2014,Shia,M,71,37,90,127
2014,Arianny,F,100,126,0,126
2014,Brea,F,100,126,0,126
2014,Haddie,F,100,126,0,126
2014,Iyana,F,100,126,0,126
2014,Jaedyn,M,60,50,76,126
2014,Korben,M,100,0,126,126
2014,Lori,F,100,126,0,126
2014,Mazie,F,100,126,0,126
2014,Moira,F,100,126,0,126
2014,Abigale,F,100,125,0,125
2014,Braedyn,M,94,7,118,125
2014,Brittney,F,100,125,0,125
2014,Canon,M,100,0,125,125
2014,Evelin,F,100,125,0,125
2014,Giuseppe,M,100,0,125,125
2014,Hansel,M,100,0,125,125
2014,Josselyn,F,100,125,0,125
2014,Lucero,F,100,125,0,125
2014,Marcellus,M,100,0,125,125
2014,Rileigh,F,100,125,0,125
2014,Shayne,M,62,48,77,125
2014,Yuna,F,100,125,0,125
2014,Yvonne,F,100,125,0,125
2014,Aksel,M,100,0,124,124
2014,Cattleya,F,100,124,0,124
2014,Damoni,M,84,20,104,124
2014,Dempsey,M,76,30,94,124
2014,Eleazar,M,100,0,124,124
2014,Faris,M,100,0,124,124
2014,Finnian,M,100,0,124,124
2014,Gillian,F,100,124,0,124
2014,Inara,F,100,124,0,124
2014,Jaya,F,100,124,0,124
2014,Jaycion,M,100,0,124,124
2014,Jenson,M,96,5,119,124
2014,Kabir,M,100,0,124,124
2014,Kacie,F,100,124,0,124
2014,Keilani,F,100,124,0,124
2014,Kinsleigh,F,100,124,0,124
2014,Lazarus,M,100,0,124,124
2014,Noelia,F,100,124,0,124
2014,Sydnee,F,100,124,0,124
2014,Tayler,F,77,96,28,124
2014,Tylan,M,96,5,119,124
2014,Zachery,M,100,0,124,124
2014,Zavion,M,100,0,124,124
2014,Amberly,F,100,123,0,123
2014,Aspyn,F,100,123,0,123
2014,Bastian,M,100,0,123,123
2014,Caius,M,100,0,123,123
2014,Carmela,F,100,123,0,123
2014,Cedar,M,59,51,72,123
2014,Dashawn,M,100,0,123,123
2014,Dashiell,M,100,0,123,123
2014,Kloe,F,100,123,0,123
2014,Koa,M,89,13,110,123
2014,Lexington,F,64,79,44,123
2014,Maddex,M,100,0,123,123
2014,Maddix,M,85,19,104,123
2014,Makiyah,F,100,123,0,123
2014,Nayla,F,100,123,0,123
2014,Stacey,F,84,103,20,123
2014,Abdirahman,M,100,0,122,122
2014,Barry,M,100,0,122,122
2014,Cierra,F,100,122,0,122
2014,Daylin,M,62,46,76,122
2014,Doris,F,100,122,0,122
2014,Eastyn,M,65,43,79,122
2014,Gian,M,100,0,122,122
2014,Gwenyth,F,100,122,0,122
2014,Jariel,M,100,0,122,122
2014,Liza,F,100,122,0,122
2014,Lucius,M,100,0,122,122
2014,Niyah,F,100,122,0,122
2014,Abdulrahman,M,100,0,121,121
2014,Abigayle,F,100,121,0,121
2014,Beck,M,100,0,121,121
2014,Caelyn,F,100,121,0,121
2014,Candace,F,100,121,0,121
2014,Carver,M,100,0,121,121
2014,Diane,F,100,121,0,121
2014,Italia,F,100,121,0,121
2014,Kenadee,F,100,121,0,121
2014,Raniyah,F,100,121,0,121
2014,Sahana,F,100,121,0,121
2014,Tesla,F,93,112,9,121
2014,Wes,M,100,0,121,121
2014,Yolanda,F,100,121,0,121
2014,Zola,F,100,121,0,121
2014,Ammar,M,100,0,120,120
2014,Ariadna,F,100,120,0,120
2014,Batsheva,F,100,120,0,120
2014,Brently,M,100,0,120,120
2014,Cielo,F,94,113,7,120
2014,Daleysa,F,100,120,0,120
2014,Divine,F,60,72,48,120
2014,Elli,F,100,120,0,120
2014,Hasan,M,100,0,120,120
2014,Jacelyn,F,100,120,0,120
2014,Kyran,M,100,0,120,120
2014,Larkin,F,70,84,36,120
2014,Montgomery,M,85,18,102,120
2014,Shayna,F,100,120,0,120
2014,Zaina,F,100,120,0,120
2014,Zaira,F,100,120,0,120
2014,Zephyr,M,82,21,99,120
2014,Analeigh,F,100,119,0,119
2014,Ayah,F,100,119,0,119
2014,Clifford,M,100,0,119,119
2014,Gionni,M,100,0,119,119
2014,Jaydin,M,82,21,98,119
2014,Lloyd,M,100,0,119,119
2014,Loki,M,93,8,111,119
2014,Makaylah,F,100,119,0,119
2014,Maliya,F,100,119,0,119
2014,Mariajose,F,100,119,0,119
2014,Navya,F,100,119,0,119
2014,Pippa,F,100,119,0,119
2014,Rosalia,F,100,119,0,119
2014,Stephany,F,100,119,0,119
2014,Storm,M,51,58,61,119
2014,Vernon,M,100,0,119,119
2014,Yitzchok,M,100,0,119,119
2014,Zaya,F,100,119,0,119
2014,Amilia,F,100,118,0,118
2014,Antony,M,100,0,118,118
2014,Anylah,F,100,118,0,118
2014,Ayvah,F,100,118,0,118
2014,Deja,F,100,118,0,118
2014,Demarion,M,100,0,118,118
2014,Dezmond,M,100,0,118,118
2014,Domenic,M,100,0,118,118
2014,Emil,M,100,0,118,118
2014,Emmit,M,100,0,118,118
2014,Ender,M,100,0,118,118
2014,Haidyn,F,79,93,25,118
2014,Jamiya,F,100,118,0,118
2014,Jaycie,F,100,118,0,118
2014,Jiselle,F,100,118,0,118
2014,Khali,F,78,92,26,118
2014,Neal,M,100,0,118,118
2014,Preslie,F,100,118,0,118
2014,Sana,F,100,118,0,118
2014,Shae,F,84,99,19,118
2014,Yoel,M,100,0,118,118
2014,Yuri,M,52,57,61,118
2014,Alexavier,M,100,0,117,117
2014,Clifton,M,100,0,117,117
2014,Cordell,M,100,0,117,117
2014,Cristal,F,100,117,0,117
2014,Emelyn,F,100,117,0,117
2014,Estefany,F,100,117,0,117
2014,Fabiola,F,100,117,0,117
2014,Jaslene,F,100,117,0,117
2014,Jordon,M,95,6,111,117
2014,Kalvin,M,100,0,117,117
2014,Kayleb,M,100,0,117,117
2014,Krista,F,100,117,0,117
2014,Lakyn,F,96,112,5,117
2014,Masyn,M,74,31,86,117
2014,Savion,M,100,0,117,117
2014,Tzvi,M,100,0,117,117
2014,Annalisa,F,100,116,0,116
2014,Eder,M,100,0,116,116
2014,Kambree,F,100,116,0,116
2014,Laina,F,100,116,0,116
2014,Saphira,F,100,116,0,116
2014,Savanah,F,100,116,0,116
2014,Serafina,F,100,116,0,116
2014,Afton,F,85,98,17,115
2014,Akshara,F,100,115,0,115
2014,Aleyah,F,100,115,0,115
2014,Canyon,M,92,9,106,115
2014,Colleen,F,100,115,0,115
2014,Edie,F,100,115,0,115
2014,Hussein,M,100,0,115,115
2014,Jackeline,F,100,115,0,115
2014,Jalayah,F,100,115,0,115
2014,Kalli,F,100,115,0,115
2014,Kenyon,M,100,0,115,115
2014,Kolt,M,100,0,115,115
2014,Kyrin,M,100,0,115,115
2014,Lev,M,94,7,108,115
2014,Majesty,F,77,88,27,115
2014,Melia,F,100,115,0,115
2014,Navy,F,81,93,22,115
2014,Paizley,F,100,115,0,115
2014,Yasmeen,F,100,115,0,115
2014,Aamir,M,100,0,114,114
2014,Amauri,M,72,32,82,114
2014,Boaz,M,100,0,114,114
2014,Cree,M,61,44,70,114
2014,Dakari,M,93,8,106,114
2014,Ester,F,100,114,0,114
2014,Jaci,F,100,114,0,114
2014,Jessiah,M,89,13,101,114
2014,Kari,F,96,109,5,114
2014,Kelsi,F,100,114,0,114
2014,Raizy,F,100,114,0,114
2014,Raylin,F,70,80,34,114
2014,Rishi,M,100,0,114,114
2014,Shalom,M,61,45,69,114
2014,Thor,M,100,0,114,114
2014,Tyce,M,100,0,114,114
2014,Aniah,F,100,113,0,113
2014,Carys,F,100,113,0,113
2014,Chaz,M,100,0,113,113
2014,Danilo,M,100,0,113,113
2014,Dev,M,100,0,113,113
2014,Emmarie,F,100,113,0,113
2014,Faigy,F,100,113,0,113
2014,Hafsa,F,100,113,0,113
2014,Irving,M,100,0,113,113
2014,Jaysen,M,100,0,113,113
2014,Josef,M,100,0,113,113
2014,Kayli,F,100,113,0,113
2014,Keren,F,100,113,0,113
2014,Laylani,F,100,113,0,113
2014,Lesley,F,100,113,0,113
2014,Massimo,M,100,0,113,113
2014,Nori,F,89,101,12,113
2014,Shoshana,F,100,113,0,113
2014,Zakaria,M,90,11,102,113
2014,Alyna,F,100,112,0,112
2014,Bryer,M,86,16,96,112
2014,Ellyana,F,100,112,0,112
2014,Jahmir,M,100,0,112,112
2014,Jaina,F,100,112,0,112
2014,Jakai,M,96,5,107,112
2014,Jayna,F,100,112,0,112
2014,Joanne,F,100,112,0,112
2014,Jones,M,100,0,112,112
2014,Journie,F,100,112,0,112
2014,Kerrigan,F,92,103,9,112
2014,Khalia,F,100,112,0,112
2014,Kiya,F,100,112,0,112
2014,Kurt,M,100,0,112,112
2014,Lanie,F,100,112,0,112
2014,Lorraine,F,100,112,0,112
2014,Marcela,F,100,112,0,112
2014,Mauro,M,100,0,112,112
2014,Taniyah,F,100,112,0,112
2014,Thorin,M,100,0,112,112
2014,Alexus,F,100,111,0,111
2014,Ansh,M,100,0,111,111
2014,Arlette,F,100,111,0,111
2014,Avarie,F,100,111,0,111
2014,Jalynn,F,94,104,7,111
2014,Journei,F,100,111,0,111
2014,Klara,F,100,111,0,111
2014,Laine,F,70,78,33,111
2014,Maiya,F,100,111,0,111
2014,Myron,M,100,0,111,111
2014,Samaya,F,100,111,0,111
2014,Terence,M,100,0,111,111
2014,Zayvion,M,100,0,111,111
2014,Anas,M,100,0,110,110
2014,Arman,M,100,0,110,110
2014,Brystol,F,100,110,0,110
2014,Carli,F,100,110,0,110
2014,Cartier,M,91,10,100,110
2014,Charleston,M,65,39,71,110
2014,Chayse,M,85,17,93,110
2014,Constantine,M,100,0,110,110
2014,Damir,M,100,0,110,110
2014,Desirae,F,100,110,0,110
2014,Don,M,100,0,110,110
2014,Eliyahu,M,100,0,110,110
2014,Gizelle,F,100,110,0,110
2014,Jannah,F,100,110,0,110
2014,Jaziah,M,57,47,63,110
2014,Kellin,M,100,0,110,110
2014,Khari,M,67,36,74,110
2014,Kierra,F,100,110,0,110
2014,Lillith,F,100,110,0,110
2014,Miguelangel,M,100,0,110,110
2014,Morris,M,100,0,110,110
2014,Nechama,F,100,110,0,110
2014,Nila,F,100,110,0,110
2014,Niya,F,100,110,0,110
2014,Presleigh,F,100,110,0,110
2014,Saoirse,F,100,110,0,110
2014,Sonja,F,100,110,0,110
2014,Stormy,F,95,104,6,110
2014,Tamar,F,89,98,12,110
2014,Tanvi,F,100,110,0,110
2014,True,M,55,49,61,110
2014,Veer,M,100,0,110,110
2014,Aaryn,F,64,70,39,109
2014,Abriella,F,100,109,0,109
2014,Alyanna,F,100,109,0,109
2014,Archie,M,100,0,109,109
2014,Brandy,F,85,93,16,109
2014,Emalee,F,100,109,0,109
2014,Fred,M,100,0,109,109
2014,Jaiceon,M,100,0,109,109
2014,Jeramiah,M,100,0,109,109
2014,Joselin,F,100,109,0,109
2014,Kaedyn,M,74,28,81,109
2014,Kenan,M,100,0,109,109
2014,Khadijah,F,100,109,0,109
2014,Laiyah,F,100,109,0,109
2014,Leanne,F,100,109,0,109
2014,Lillyan,F,100,109,0,109
2014,Malena,F,100,109,0,109
2014,Roselynn,F,100,109,0,109
2014,Sevyn,F,67,73,36,109
2014,Timber,F,57,62,47,109
2014,Trevon,M,100,0,109,109
2014,Viktoria,F,100,109,0,109
2014,Ansel,M,100,0,108,108
2014,Ashly,F,100,108,0,108
2014,Axle,M,100,0,108,108
2014,Bernardo,M,100,0,108,108
2014,Brigham,M,100,0,108,108
2014,Carrington,F,75,81,27,108
2014,Cosette,F,100,108,0,108
2014,Denis,M,94,6,102,108
2014,Dewayne,M,100,0,108,108
2014,Dream,F,81,88,20,108
2014,Ervin,M,100,0,108,108
2014,Jaleel,M,100,0,108,108
2014,Jamil,M,100,0,108,108
2014,Jayveon,M,100,0,108,108
2014,Jencarlos,M,100,0,108,108
2014,Johana,F,100,108,0,108
2014,Justine,F,94,101,7,108
2014,Kaine,M,100,0,108,108
2014,Landin,M,100,0,108,108
2014,Laniya,F,100,108,0,108
2014,Lupita,F,100,108,0,108
2014,Maelynn,F,100,108,0,108
2014,Marek,M,100,0,108,108
2014,Nestor,M,100,0,108,108
2014,Niam,M,100,0,108,108
2014,Rosalinda,F,100,108,0,108
2014,Rowyn,F,80,86,22,108
2014,Sahara,F,100,108,0,108
2014,Selma,F,100,108,0,108
2014,Tru,M,65,38,70,108
2014,Viaan,M,100,0,108,108
2014,Vivianne,F,100,108,0,108
2014,Wylie,M,81,21,87,108
2014,Zooey,F,100,108,0,108
2014,Aiza,F,100,107,0,107
2014,Anisa,F,100,107,0,107
2014,Cleo,F,93,100,7,107
2014,Deasia,F,100,107,0,107
2014,Dianna,F,100,107,0,107
2014,Freyja,F,100,107,0,107
2014,Ishan,M,100,0,107,107
2014,Jamarcus,M,100,0,107,107
2014,Jiovanni,M,100,0,107,107
2014,Lenox,M,74,28,79,107
2014,Noam,M,92,9,98,107
2014,Osiris,M,84,17,90,107
2014,Ruthie,F,100,107,0,107
2014,Salman,M,100,0,107,107
2014,Wilhelmina,F,100,107,0,107
2014,Anish,M,100,0,106,106
2014,Arionna,F,100,106,0,106
2014,Audrie,F,100,106,0,106
2014,Bradlee,M,76,25,81,106
2014,Elysia,F,100,106,0,106
2014,Ezrah,M,85,16,90,106
2014,Iyla,F,100,106,0,106
2014,Jacie,F,100,106,0,106
2014,Karmyn,F,100,106,0,106
2014,Marianne,F,100,106,0,106
2014,Markell,M,100,0,106,106
2014,Muhammed,M,100,0,106,106
2014,Nazir,M,100,0,106,106
2014,Rickey,M,100,0,106,106
2014,Taha,M,100,0,106,106
2014,Wynn,M,57,46,60,106
2014,Zaidyn,M,100,0,106,106
2014,Aaleyah,F,100,105,0,105
2014,Aaralyn,F,100,105,0,105
2014,Ailani,F,100,105,0,105
2014,Angus,M,100,0,105,105
2014,Avary,F,90,95,10,105
2014,Calleigh,F,100,105,0,105
2014,Devorah,F,100,105,0,105
2014,Everley,F,100,105,0,105
2014,Fatimah,F,100,105,0,105
2014,Karoline,F,100,105,0,105
2014,Kenzlee,F,100,105,0,105
2014,Kynzlee,F,100,105,0,105
2014,Leann,F,100,105,0,105
2014,Mickey,M,94,6,99,105
2014,Reem,F,100,105,0,105
2014,Roxana,F,100,105,0,105
2014,Roxanna,F,100,105,0,105
2014,Sanvi,F,100,105,0,105
2014,Star,F,100,105,0,105
2014,Veronika,F,100,105,0,105
2014,Yariel,M,100,0,105,105
2014,Yasin,M,100,0,105,105
2014,Zoee,F,100,105,0,105
2014,Aaryan,M,100,0,104,104
2014,Ameera,F,100,104,0,104
2014,Arwen,F,100,104,0,104
2014,Asiya,F,100,104,0,104
2014,Azael,M,100,0,104,104
2014,Carmello,M,100,0,104,104
2014,Daria,F,100,104,0,104
2014,Dasia,F,100,104,0,104
2014,Elliette,F,100,104,0,104
2014,Glen,M,100,0,104,104
2014,Isley,F,88,91,13,104
2014,Izaak,M,100,0,104,104
2014,Juana,F,100,104,0,104
2014,Kamarion,M,100,0,104,104
2014,Kaydon,M,92,8,96,104
2014,Kelis,F,100,104,0,104
2014,Kianna,F,100,104,0,104
2014,Korey,M,87,14,90,104
2014,Kyden,M,100,0,104,104
2014,Lester,M,100,0,104,104
2014,Marli,F,100,104,0,104
2014,Mykah,F,54,56,48,104
2014,Nate,M,100,0,104,104
2014,Phineas,M,100,0,104,104
2014,Rebel,F,56,58,46,104
2014,Said,M,100,0,104,104
2014,Talan,M,100,0,104,104
2014,Trayvon,M,100,0,104,104
2014,Zakariya,M,100,0,104,104
2014,Zyana,F,100,104,0,104
2014,Abdul,M,100,0,103,103
2014,Abdullahi,M,100,0,103,103
2014,Adamaris,F,100,103,0,103
2014,Arion,M,86,14,89,103
2014,Aris,M,60,41,62,103
2014,Arleth,F,100,103,0,103
2014,Bellamy,F,100,103,0,103
2014,Charis,F,100,103,0,103
2014,Earl,M,100,0,103,103
2014,Jamel,M,100,0,103,103
2014,Josey,F,83,86,17,103
2014,Karol,F,74,76,27,103
2014,Kirk,M,100,0,103,103
2014,Lenny,M,93,7,96,103
2014,Levon,M,100,0,103,103
2014,Lilyan,F,100,103,0,103
2014,Lynn,F,84,87,16,103
2014,Malani,F,100,103,0,103
2014,Mandy,F,100,103,0,103
2014,Mariya,F,100,103,0,103
2014,Mayte,F,100,103,0,103
2014,Rania,F,100,103,0,103
2014,Sheyla,F,100,103,0,103
2014,Stryker,M,100,0,103,103
2014,Xochitl,F,100,103,0,103
2014,Ander,M,100,0,102,102
2014,Ansleigh,F,100,102,0,102
2014,Aribella,F,100,102,0,102
2014,Avril,F,100,102,0,102
2014,Caidence,F,90,92,10,102
2014,Cori,F,88,90,12,102
2014,Emmaleigh,F,100,102,0,102
2014,Jaceyon,M,100,0,102,102
2014,Jasen,M,100,0,102,102
2014,Jeanette,F,100,102,0,102
2014,Kavya,F,100,102,0,102
2014,Khloee,F,100,102,0,102
2014,Malakhi,M,100,0,102,102
2014,Mckinlee,F,100,102,0,102
2014,Mylee,F,100,102,0,102
2014,Rochel,F,100,102,0,102
2014,Rosalynn,F,100,102,0,102
2014,Talya,F,100,102,0,102
2014,Alli,F,100,101,0,101
2014,Ani,F,100,101,0,101
2014,Anistyn,F,100,101,0,101
2014,Ashleigh,F,100,101,0,101
2014,Athan,M,100,0,101,101
2014,Bryar,M,81,19,82,101
2014,Brylie,F,100,101,0,101
2014,Cayleigh,F,100,101,0,101
2014,Danae,F,100,101,0,101
2014,Gareth,M,100,0,101,101
2014,Inaya,F,100,101,0,101
2014,Jerimiah,M,100,0,101,101
2014,Jethro,M,100,0,101,101
2014,Kyah,F,100,101,0,101
2014,Maxon,M,100,0,101,101
2014,Merida,F,100,101,0,101
2014,Nahomi,F,100,101,0,101
2014,Sabina,F,100,101,0,101
2014,Salome,F,100,101,0,101
2014,Shyann,F,100,101,0,101
2014,Adalina,F,100,100,0,100
2014,Angelie,F,100,100,0,100
2014,Arizona,F,100,100,0,100
2014,Dakotah,F,61,61,39,100
2014,Dan,M,100,0,100,100
2014,Duane,M,100,0,100,100
2014,Echo,F,87,87,13,100
2014,Ela,F,100,100,0,100
2014,Fischer,M,100,0,100,100
2014,Hadi,M,100,0,100,100
2014,Hiram,M,100,0,100,100
2014,Jaxyn,M,84,16,84,100
2014,Khaled,M,100,0,100,100
2014,Mari,F,95,95,5,100
2014,Monique,F,100,100,0,100
2014,Ria,F,100,100,0,100
2014,Rishaan,M,100,0,100,100
2014,Rosalind,F,100,100,0,100
2014,Sahasra,F,100,100,0,100
2014,Stephon,M,100,0,100,100
2014,Tiara,F,100,100,0,100
2014,Aeris,F,100,99,0,99
2014,Alonna,F,100,99,0,99
2014,Azriel,M,83,17,82,99
2014,Baileigh,F,100,99,0,99
2014,Berkeley,F,86,85,14,99
2014,Brayton,M,100,0,99,99
2014,Efren,M,100,0,99,99
2014,Hensley,F,91,90,9,99
2014,Hollie,F,100,99,0,99
2014,Janyla,F,100,99,0,99
2014,Jasiel,M,89,11,88,99
2014,Kasyn,M,81,19,80,99
2014,Kendell,M,63,37,62,99
2014,Kennadi,F,100,99,0,99
2014,Lakota,M,55,45,54,99
2014,Lois,F,100,99,0,99
2014,Marielle,F,100,99,0,99
2014,Priscila,F,100,99,0,99
2014,Raine,F,93,92,7,99
2014,Rhylee,F,89,88,11,99
2014,Rivers,M,69,31,68,99
2014,Rogan,M,93,7,92,99
2014,Roxy,F,100,99,0,99
2014,Samya,F,100,99,0,99
2014,Shamar,M,100,0,99,99
2014,Siya,F,100,99,0,99
2014,Wilmer,M,100,0,99,99
2014,Winifred,F,100,99,0,99
2014,Yulissa,F,100,99,0,99
2014,Zeus,M,100,0,99,99
2014,Adiel,M,93,7,91,98
2014,Caliyah,F,100,98,0,98
2014,Dandre,M,100,0,98,98
2014,Elam,M,100,0,98,98
2014,Ericka,F,100,98,0,98
2014,Flor,F,100,98,0,98
2014,Hyrum,M,100,0,98,98
2014,Izel,F,88,86,12,98
2014,Jaheim,M,100,0,98,98
2014,Jailynn,F,100,98,0,98
2014,Jayven,M,100,0,98,98
2014,Kadin,M,100,0,98,98
2014,Kalen,M,79,21,77,98
2014,Letty,F,100,98,0,98
2014,Liah,F,100,98,0,98
2014,Mackenna,F,100,98,0,98
2014,Margaux,F,100,98,0,98
2014,Marshawn,M,100,0,98,98
2014,Mindy,F,100,98,0,98
2014,Nyasia,F,100,98,0,98
2014,Sanaya,F,100,98,0,98
2014,Steele,M,95,5,93,98
2014,Zaynab,F,100,98,0,98
2014,Zuleyka,F,100,98,0,98
2014,Zyler,M,100,0,98,98
2014,Abdulaziz,M,100,0,97,97
2014,Aleksandra,F,100,97,0,97
2014,Alexi,F,70,68,29,97
2014,Ammon,M,100,0,97,97
2014,Boyd,M,100,0,97,97
2014,Brailyn,F,74,72,25,97
2014,Brentlee,M,88,12,85,97
2014,Callahan,M,78,21,76,97
2014,Cameryn,F,65,63,34,97
2014,Cecil,M,100,0,97,97
2014,Dasha,F,100,97,0,97
2014,Elon,M,91,9,88,97
2014,Eternity,F,100,97,0,97
2014,Henri,M,100,0,97,97
2014,Isobel,F,100,97,0,97
2014,Javian,M,100,0,97,97
2014,Jeff,M,100,0,97,97
2014,Jessalyn,F,100,97,0,97
2014,Kerry,M,61,38,59,97
2014,Kirra,F,100,97,0,97
2014,Kurtis,M,100,0,97,97
2014,Liya,F,100,97,0,97
2014,Malky,F,100,97,0,97
2014,Ramses,M,100,0,97,97
2014,Rocio,F,100,97,0,97
2014,Taleah,F,100,97,0,97
2014,Theron,M,100,0,97,97
2014,Yadira,F,100,97,0,97
2014,Zaine,M,100,0,97,97
2014,Zen,M,89,11,86,97
2014,Aarohi,F,100,96,0,96
2014,Adalia,F,100,96,0,96
2014,Andrey,M,100,0,96,96
2014,Blayne,M,85,14,82,96
2014,Desean,M,100,0,96,96
2014,Ilan,M,90,10,86,96
2014,Kenji,M,100,0,96,96
2014,Khristian,M,89,11,85,96
2014,Lourdes,F,100,96,0,96
2014,Luther,M,100,0,96,96
2014,Lyam,M,100,0,96,96
2014,Malek,M,100,0,96,96
2014,Marcelino,M,100,0,96,96
2014,Marko,M,100,0,96,96
2014,Melodie,F,100,96,0,96
2014,Mona,F,100,96,0,96
2014,Oren,M,100,0,96,96
2014,Rosalina,F,100,96,0,96
2014,Rosario,F,84,81,15,96
2014,Sabine,F,100,96,0,96
2014,Samarth,M,100,0,96,96
2014,Vianney,F,100,96,0,96
2014,Violetta,F,100,96,0,96
2014,Adelle,F,100,95,0,95
2014,Anslee,F,100,95,0,95
2014,Aubry,F,88,84,11,95
2014,Brynna,F,100,95,0,95
2014,Clint,M,100,0,95,95
2014,Eitan,M,100,0,95,95
2014,Emberly,F,100,95,0,95
2014,Fynn,M,95,5,90,95
2014,Geoffrey,M,100,0,95,95
2014,Gitty,F,100,95,0,95
2014,Glory,F,100,95,0,95
2014,Indie,F,91,86,9,95
2014,Jakub,M,100,0,95,95
2014,Jayvon,M,100,0,95,95
2014,Kiyah,F,100,95,0,95
2014,Liyah,F,100,95,0,95
2014,Maelyn,F,100,95,0,95
2014,Markel,M,100,0,95,95
2014,Oriana,F,100,95,0,95
2014,Samaria,F,100,95,0,95
2014,Sinai,F,100,95,0,95
2014,Taniya,F,100,95,0,95
2014,Yousif,M,100,0,95,95
2014,Aisley,F,100,94,0,94
2014,Amaia,F,100,94,0,94
2014,Aviva,F,100,94,0,94
2014,Benaiah,M,100,0,94,94
2014,Brianne,F,100,94,0,94
2014,Cam,M,100,0,94,94
2014,Chanelle,F,100,94,0,94
2014,Dawn,F,100,94,0,94
2014,Eliyah,F,70,66,28,94
2014,Emmi,F,100,94,0,94
2014,Fredy,M,100,0,94,94
2014,Hoyt,M,100,0,94,94
2014,Iva,F,100,94,0,94
2014,Ivey,F,94,88,6,94
2014,Jahir,M,100,0,94,94
2014,Jamila,F,100,94,0,94
2014,Kaisen,M,94,6,88,94
2014,Kaydin,M,73,25,69,94
2014,Lotus,F,95,89,5,94
2014,Milla,F,100,94,0,94
2014,Paizlee,F,100,94,0,94
2014,Rae,F,93,87,7,94
2014,Rafe,M,100,0,94,94
2014,Rhyder,M,91,8,86,94
2014,Ripley,F,78,73,21,94
2014,Ryden,M,100,0,94,94
2014,Shaila,F,100,94,0,94
2014,Taelynn,F,100,94,0,94
2014,Zadie,F,100,94,0,94
2014,Zakary,M,100,0,94,94
2014,Zayan,M,100,0,94,94
2014,Acelynn,F,100,93,0,93
2014,Amethyst,F,100,93,0,93
2014,Amin,M,100,0,93,93
2014,Artemis,F,73,68,25,93
2014,Aubreigh,F,100,93,0,93
2014,Breckin,M,88,11,82,93
2014,Carsten,M,100,0,93,93
2014,Dallin,M,100,0,93,93
2014,Dov,M,100,0,93,93
2014,Hamilton,M,100,0,93,93
2014,Janaya,F,100,93,0,93
2014,Jeshua,M,100,0,93,93
2014,Link,M,100,0,93,93
2014,Millicent,F,100,93,0,93
2014,Obed,M,100,0,93,93
2014,Shira,F,100,93,0,93
2014,Sumaya,F,100,93,0,93
2014,Umar,M,100,0,93,93
2014,Valencia,F,100,93,0,93
2014,Wells,M,92,7,86,93
2014,Wolfgang,M,100,0,93,93
2014,Akeem,M,100,0,92,92
2014,Alexandre,M,100,0,92,92
2014,Antoinette,F,100,92,0,92
2014,Evander,M,100,0,92,92
2014,Everest,M,87,12,80,92
2014,Hayven,F,86,79,13,92
2014,Heriberto,M,100,0,92,92
2014,Ilyas,M,100,0,92,92
2014,Jolee,F,100,92,0,92
2014,Jovanny,M,100,0,92,92
2014,Kinzlee,F,100,92,0,92
2014,Klaire,F,100,92,0,92
2014,Lake,M,57,40,52,92
2014,Lluvia,F,100,92,0,92
2014,Maizie,F,100,92,0,92
2014,Neo,M,100,0,92,92
2014,Ransom,M,100,0,92,92
2014,Roan,M,95,5,87,92
2014,Sabastian,M,100,0,92,92
2014,Safa,F,100,92,0,92
2014,Sora,F,73,67,25,92
2014,Tatyana,F,100,92,0,92
2014,Truett,M,100,0,92,92
2014,Watson,M,100,0,92,92
2014,Aleyna,F,100,91,0,91
2014,Amal,F,95,86,5,91
2014,Avian,M,88,11,80,91
2014,Banks,M,100,0,91,91
2014,Benito,M,100,0,91,91
2014,Berlin,F,95,86,5,91
2014,Demari,M,100,0,91,91
2014,Demario,M,100,0,91,91
2014,Giulia,F,100,91,0,91
2014,Issa,M,78,20,71,91
2014,Jamia,F,100,91,0,91
2014,Jody,M,73,25,66,91
2014,Joi,F,100,91,0,91
2014,Kaily,F,100,91,0,91
2014,Kanon,M,91,8,83,91
2014,Kilian,M,100,0,91,91
2014,Krishna,M,73,25,66,91
2014,Lilyanne,F,100,91,0,91
2014,Magaly,F,100,91,0,91
2014,Olyvia,F,100,91,0,91
2014,Reya,F,100,91,0,91
2014,Shaniyah,F,100,91,0,91
2014,Tariq,M,100,0,91,91
2014,Tayla,F,100,91,0,91
2014,Zarah,F,100,91,0,91
2014,Abygail,F,100,90,0,90
2014,Althea,F,100,90,0,90
2014,Braxten,M,100,0,90,90
2014,Cai,M,77,21,69,90
2014,Christy,F,94,85,5,90
2014,Collette,F,100,90,0,90
2014,Crimson,F,58,52,38,90
2014,Daylan,M,93,6,84,90
2014,Deonte,M,100,0,90,90
2014,Dovid,M,100,0,90,90
2014,Eian,M,100,0,90,90
2014,Emarie,F,100,90,0,90
2014,Ilana,F,100,90,0,90
2014,Jalyn,F,69,62,28,90
2014,Kahlil,M,100,0,90,90
2014,Koby,M,100,0,90,90
2014,Kollin,M,100,0,90,90
2014,Kyara,F,100,90,0,90
2014,Kyrah,F,100,90,0,90
2014,Linkin,M,100,0,90,90
2014,Loyal,M,69,28,62,90
2014,Marlin,M,88,11,79,90
2014,Nariyah,F,100,90,0,90
2014,Skyy,F,93,84,6,90
2014,Susannah,F,100,90,0,90
2014,Taya,F,100,90,0,90
2014,Teddy,M,80,18,72,90
2014,Vianey,F,100,90,0,90
2014,Yana,F,100,90,0,90
2014,Zaida,F,100,90,0,90
2014,Zyion,M,80,18,72,90
2014,Acacia,F,100,89,0,89
2014,Adalynne,F,100,89,0,89
2014,Allisson,F,100,89,0,89
2014,Annalynn,F,100,89,0,89
2014,Annistyn,F,100,89,0,89
2014,Azeneth,F,100,89,0,89
2014,Baylie,F,100,89,0,89
2014,Bowie,M,66,30,59,89
2014,Brooklynne,F,100,89,0,89
2014,Cristofer,M,100,0,89,89
2014,Donnell,M,100,0,89,89
2014,Drayden,M,100,0,89,89
2014,Fidel,M,100,0,89,89
2014,Gerson,M,100,0,89,89
2014,Juancarlos,M,100,0,89,89
2014,Kameryn,F,65,58,31,89
2014,Keandre,M,100,0,89,89
2014,Kemari,M,71,26,63,89
2014,Kensi,F,100,89,0,89
2014,Kolbie,F,81,72,17,89
2014,Loyalty,F,81,72,17,89
2014,Marlena,F,100,89,0,89
2014,Monte,M,100,0,89,89
2014,Mykel,M,91,8,81,89
2014,Nathen,M,100,0,89,89
2014,Neel,M,100,0,89,89
2014,Saif,M,100,0,89,89
2014,Tyshawn,M,100,0,89,89
2014,Zinnia,F,100,89,0,89
2014,Aaradhya,F,100,88,0,88
2014,Alaiyah,F,100,88,0,88
2014,Ameerah,F,100,88,0,88
2014,Anissa,F,100,88,0,88
2014,Avrohom,M,100,0,88,88
2014,Ayman,M,94,5,83,88
2014,Baila,F,100,88,0,88
2014,Cailey,F,100,88,0,88
2014,Chayce,M,92,7,81,88
2014,Dora,F,100,88,0,88
2014,Dyllan,M,80,18,70,88
2014,Edna,F,100,88,0,88
2014,Elyana,F,100,88,0,88
2014,Emree,F,100,88,0,88
2014,Grayden,M,100,0,88,88
2014,Ileana,F,100,88,0,88
2014,Irelynn,F,100,88,0,88
2014,Jennah,F,100,88,0,88
2014,Katharine,F,100,88,0,88
2014,Konrad,M,100,0,88,88
2014,Kristine,F,100,88,0,88
2014,Landan,M,100,0,88,88
2014,Maddilyn,F,100,88,0,88
2014,Rachelle,F,100,88,0,88
2014,Rick,M,100,0,88,88
2014,Samar,M,68,28,60,88
2014,Saydee,F,100,88,0,88
2014,Treyson,M,100,0,88,88
2014,Triton,M,100,0,88,88
2014,Alyana,F,100,87,0,87
2014,Ambrose,M,100,0,87,87
2014,Amyra,F,100,87,0,87
2014,Calder,M,100,0,87,87
2014,Caspian,M,100,0,87,87
2014,Cillian,M,100,0,87,87
2014,Conley,M,80,17,70,87
2014,Debora,F,100,87,0,87
2014,Donavan,M,100,0,87,87
2014,Ethyn,M,100,0,87,87
2014,Janeth,F,100,87,0,87
2014,Jaxin,M,100,0,87,87
2014,Jayme,F,76,66,21,87
2014,Juanpablo,M,100,0,87,87
2014,Kacen,M,100,0,87,87
2014,Kainoa,M,100,0,87,87
2014,Kim,F,78,68,19,87
2014,Kipton,M,100,0,87,87
2014,Korra,F,100,87,0,87
2014,Kory,M,84,14,73,87
2014,Krew,M,100,0,87,87
2014,Lula,F,100,87,0,87
2014,Mariel,F,100,87,0,87
2014,Marquez,M,100,0,87,87
2014,Maryn,F,100,87,0,87
2014,Natali,F,100,87,0,87
2014,Noelani,F,100,87,0,87
2014,Nyjah,M,79,18,69,87
2014,Om,M,100,0,87,87
2014,Riyan,M,52,42,45,87
2014,Sameer,M,100,0,87,87
2014,Sariya,F,100,87,0,87
2014,Shiv,M,100,0,87,87
2014,Willem,M,100,0,87,87
2014,Adin,M,100,0,86,86
2014,Adison,F,94,81,5,86
2014,Aja,F,100,86,0,86
2014,Alayla,F,100,86,0,86
2014,Anabell,F,100,86,0,86
2014,Arley,M,72,24,62,86
2014,Arrow,M,67,28,58,86
2014,Aryeh,M,100,0,86,86
2014,Aryn,F,73,63,23,86
2014,Avaya,F,100,86,0,86
2014,Breck,M,92,7,79,86
2014,Brigid,F,100,86,0,86
2014,Calli,F,100,86,0,86
2014,Daenerys,F,100,86,0,86
2014,Dakoda,M,72,24,62,86
2014,Dontae,M,100,0,86,86
2014,Ezio,M,100,0,86,86
2014,Fatoumata,F,100,86,0,86
2014,Felicia,F,100,86,0,86
2014,Floyd,M,100,0,86,86
2014,Hawa,F,100,86,0,86
2014,Ike,M,100,0,86,86
2014,Jalaya,F,100,86,0,86
2014,Jaxsyn,M,84,14,72,86
2014,Jiya,F,100,86,0,86
2014,Joseluis,M,100,0,86,86
2014,Kalyn,F,87,75,11,86
2014,Kenzo,M,100,0,86,86
2014,Leana,F,100,86,0,86
2014,Luc,M,100,0,86,86
2014,Massiah,M,90,9,77,86
2014,Mattias,M,100,0,86,86
2014,Meagan,F,100,86,0,86
2014,Neva,F,100,86,0,86
2014,Pharaoh,M,100,0,86,86
2014,Ren,M,83,15,71,86
2014,Royalty,F,73,63,23,86
2014,Story,F,100,86,0,86
2014,Sybil,F,100,86,0,86
2014,Teagen,F,56,48,38,86
2014,Trevin,M,100,0,86,86
2014,Tye,M,91,8,78,86
2014,Tyrus,M,100,0,86,86
2014,Zayda,F,100,86,0,86
2014,Zyla,F,100,86,0,86
2014,Aura,F,100,85,0,85
2014,Bane,M,100,0,85,85
2014,Beaux,M,82,15,70,85
2014,Casper,M,100,0,85,85
2014,Chayton,M,100,0,85,85
2014,Dayanara,F,100,85,0,85
2014,Demetri,M,100,0,85,85
2014,Elyas,M,100,0,85,85
2014,Emberlyn,F,100,85,0,85
2014,Jacklyn,F,100,85,0,85
2014,Jaycen,M,100,0,85,85
2014,Jaylan,M,81,16,69,85
2014,Jayleigh,F,100,85,0,85
2014,Jessy,F,58,49,36,85
2014,Jimmie,M,94,5,80,85
2014,Jullian,M,100,0,85,85
2014,Kalynn,F,100,85,0,85
2014,Kaniyah,F,100,85,0,85
2014,Katheryn,F,100,85,0,85
2014,Leen,F,100,85,0,85
2014,Marwa,F,100,85,0,85
2014,Mohamad,M,100,0,85,85
2014,Olin,M,100,0,85,85
2014,Terra,F,100,85,0,85
2014,Tiberius,M,100,0,85,85
2014,Valentine,F,54,46,39,85
2014,Vicky,F,100,85,0,85
2014,Adleigh,F,100,84,0,84
2014,Aleeyah,F,100,84,0,84
2014,Amarah,F,100,84,0,84
2014,Antwon,M,100,0,84,84
2014,Avalee,F,100,84,0,84
2014,Avamarie,F,100,84,0,84
2014,Bracha,F,100,84,0,84
2014,Breckyn,F,69,58,26,84
2014,Chesney,F,88,74,10,84
2014,Daelyn,F,58,49,35,84
2014,Destini,F,100,84,0,84
2014,Italy,F,100,84,0,84
2014,Jacobo,M,100,0,84,84
2014,Jakobi,M,100,0,84,84
2014,Jamere,M,100,0,84,84
2014,Jayne,F,100,84,0,84
2014,Kaliah,F,100,84,0,84
2014,Karas,M,100,0,84,84
2014,Karsten,M,100,0,84,84
2014,Ken,M,100,0,84,84
2014,Kyng,M,100,0,84,84
2014,Laiken,F,76,64,20,84
2014,Loralei,F,100,84,0,84
2014,Lucio,M,100,0,84,84
2014,Lynlee,F,100,84,0,84
2014,Makaila,F,100,84,0,84
2014,Marla,F,100,84,0,84
2014,Maven,F,76,64,20,84
2014,Maximillian,M,100,0,84,84
2014,Meyer,M,76,20,64,84
2014,Mirabelle,F,100,84,0,84
2014,Nile,M,85,13,71,84
2014,Norma,F,100,84,0,84
2014,Rayven,F,100,84,0,84
2014,Starr,F,100,84,0,84
2014,Tai,M,82,15,69,84
2014,Yakov,M,100,0,84,84
2014,Yasir,M,100,0,84,84
2014,Zella,F,100,84,0,84
2014,Ahmari,M,76,20,63,83
2014,Amere,M,100,0,83,83
2014,Avia,F,100,83,0,83
2014,Avigail,F,100,83,0,83
2014,Brant,M,100,0,83,83
2014,Caesar,M,100,0,83,83
2014,Chester,M,100,0,83,83
2014,Ciaran,M,100,0,83,83
2014,Coltyn,M,100,0,83,83
2014,Deshaun,M,100,0,83,83
2014,Eris,F,92,76,7,83
2014,Filip,M,100,0,83,83
2014,Jan,M,100,0,83,83
2014,Josephina,F,100,83,0,83
2014,Jovany,M,100,0,83,83
2014,Kaidan,M,93,6,77,83
2014,Leylani,F,100,83,0,83
2014,Marilynn,F,100,83,0,83
2014,Melisa,F,100,83,0,83
2014,Nour,F,82,68,15,83
2014,Oswaldo,M,100,0,83,83
2014,Savana,F,100,83,0,83
2014,Snow,F,93,77,6,83
2014,Teo,M,100,0,83,83
2014,Theodora,F,100,83,0,83
2014,Zofia,F,100,83,0,83
2014,Ahana,F,100,82,0,82
2014,Aj,M,100,0,82,82
2014,Amiracle,F,100,82,0,82
2014,Anaiya,F,100,82,0,82
2014,Avonlea,F,100,82,0,82
2014,Brandi,F,100,82,0,82
2014,Braylan,M,94,5,77,82
2014,Brilee,F,91,75,7,82
2014,Bryton,M,91,7,75,82
2014,Carlton,M,100,0,82,82
2014,Chava,F,100,82,0,82
2014,Daniyah,F,100,82,0,82
2014,Eliam,M,100,0,82,82
2014,Emeline,F,100,82,0,82
2014,Evalina,F,100,82,0,82
2014,Greer,F,79,65,17,82
2014,Ines,F,100,82,0,82
2014,Kage,M,100,0,82,82
2014,Kaileigh,F,100,82,0,82
2014,Kaius,M,100,0,82,82
2014,Kamran,M,100,0,82,82
2014,Kynnedi,F,100,82,0,82
2014,Laya,F,100,82,0,82
2014,Lovely,F,100,82,0,82
2014,Mahogany,F,100,82,0,82
2014,Mildred,F,100,82,0,82
2014,Naila,F,100,82,0,82
2014,Navaeh,F,100,82,0,82
2014,Nolen,M,94,5,77,82
2014,Paulette,F,100,82,0,82
2014,Radley,M,94,5,77,82
2014,Rena,F,100,82,0,82
2014,Shaindy,F,100,82,0,82
2014,Stuart,M,100,0,82,82
2014,Tytus,M,100,0,82,82
2014,Yahel,M,100,0,82,82
2014,Zac,M,100,0,82,82
2014,Zakai,M,100,0,82,82
2014,Zamari,M,70,25,57,82
2014,Amen,M,54,37,44,81
2014,Ami,F,72,58,23,81
2014,Arianne,F,100,81,0,81
2014,Arnold,M,100,0,81,81
2014,Avni,F,100,81,0,81
2014,Azalia,F,100,81,0,81
2014,Azlynn,F,100,81,0,81
2014,Brantly,M,100,0,81,81
2014,Cienna,F,100,81,0,81
2014,Coralie,F,100,81,0,81
2014,Danni,F,94,76,5,81
2014,Delylah,F,100,81,0,81
2014,Everette,M,80,16,65,81
2014,Faisal,M,100,0,81,81
2014,Federico,M,100,0,81,81
2014,Jamiah,F,89,72,9,81
2014,Jannat,F,100,81,0,81
2014,Jaslynn,F,100,81,0,81
2014,Jenelle,F,100,81,0,81
2014,Kambrie,F,100,81,0,81
2014,Lael,F,73,59,22,81
2014,Lars,M,100,0,81,81
2014,Layah,F,100,81,0,81
2014,Layken,F,81,66,15,81
2014,Maizy,F,100,81,0,81
2014,Manuela,F,100,81,0,81
2014,Naia,F,100,81,0,81
2014,Nevin,M,100,0,81,81
2014,Novah,F,73,59,22,81
2014,Orin,M,100,0,81,81
2014,Quinlan,M,68,26,55,81
2014,Ryatt,M,91,7,74,81
2014,Shaurya,M,100,0,81,81
2014,Sulaiman,M,100,0,81,81
2014,Sylus,M,100,0,81,81
2014,Tylen,M,100,0,81,81
2014,Akiva,M,100,0,80,80
2014,Alysia,F,100,80,0,80
2014,Analeah,F,100,80,0,80
2014,Aurelio,M,100,0,80,80
2014,Bay,F,92,74,6,80
2014,Caitlynn,F,100,80,0,80
2014,Coltin,M,100,0,80,80
2014,Dara,F,92,74,6,80
2014,Darrius,M,100,0,80,80
2014,Eithan,M,100,0,80,80
2014,Fallyn,F,100,80,0,80
2014,Freddie,M,100,0,80,80
2014,Gabe,M,100,0,80,80
2014,Giulianna,F,100,80,0,80
2014,Huntley,M,68,26,54,80
2014,Jazmyne,F,100,80,0,80
2014,Jazzlynn,F,100,80,0,80
2014,Jeriah,M,81,15,65,80
2014,Jesslyn,F,100,80,0,80
2014,Jireh,F,56,45,35,80
2014,Job,M,100,0,80,80
2014,Juanita,F,100,80,0,80
2014,Kahlan,F,100,80,0,80
2014,Kaniya,F,100,80,0,80
2014,Kentrell,M,100,0,80,80
2014,Kris,M,79,17,63,80
2014,Leora,F,100,80,0,80
2014,Malika,F,100,80,0,80
2014,Misha,F,89,71,9,80
2014,Noella,F,100,80,0,80
2014,Romello,M,100,0,80,80
2014,Royale,F,66,53,27,80
2014,Tremaine,M,100,0,80,80
2014,Treyvon,M,100,0,80,80
2014,Yousuf,M,100,0,80,80
2014,Aaliya,F,100,79,0,79
2014,Analee,F,100,79,0,79
2014,Arham,M,100,0,79,79
2014,Bryana,F,100,79,0,79
2014,Camari,M,62,30,49,79
2014,Cassadee,F,100,79,0,79
2014,Corrine,F,100,79,0,79
2014,Devante,M,100,0,79,79
2014,Dyson,M,100,0,79,79
2014,Edmond,M,100,0,79,79
2014,Elyjah,M,100,0,79,79
2014,Ginger,F,100,79,0,79
2014,Hampton,M,91,7,72,79
2014,Hernan,M,100,0,79,79
2014,Jasleen,F,100,79,0,79
2014,Jelani,M,87,10,69,79
2014,Joseline,F,100,79,0,79
2014,Kaira,F,100,79,0,79
2014,Kayle,F,86,68,11,79
2014,Kimberlyn,F,100,79,0,79
2014,Lazaro,M,100,0,79,79
2014,Lexy,F,100,79,0,79
2014,Madisen,F,100,79,0,79
2014,Marlow,F,78,62,17,79
2014,Nahomy,F,100,79,0,79
2014,Naiya,F,100,79,0,79
2014,Nilah,F,100,79,0,79
2014,Osman,M,100,0,79,79
2014,Penn,M,100,0,79,79
2014,Rori,F,100,79,0,79
2014,Sequoia,F,84,66,13,79
2014,Shepard,M,100,0,79,79
2014,Taylynn,F,100,79,0,79
2014,Zariya,F,100,79,0,79
2014,Adrianne,F,100,78,0,78
2014,Aislinn,F,100,78,0,78
2014,Aislynn,F,100,78,0,78
2014,Alize,F,100,78,0,78
2014,Anay,M,100,0,78,78
2014,Ania,F,100,78,0,78
2014,Asma,F,100,78,0,78
2014,Blakelee,F,90,70,8,78
2014,Braylyn,F,59,46,32,78
2014,Brynnlee,F,100,78,0,78
2014,Chauncey,M,94,5,73,78
2014,Cianna,F,100,78,0,78
2014,Dyland,M,100,0,78,78
2014,Georgiana,F,100,78,0,78
2014,Irelyn,F,100,78,0,78
2014,Jacari,M,100,0,78,78
2014,Jaren,M,100,0,78,78
2014,Keiry,F,100,78,0,78
2014,Keoni,M,88,9,69,78
2014,Keshawn,M,100,0,78,78
2014,Kimi,M,68,25,53,78
2014,Kristy,F,100,78,0,78
2014,Lailani,F,100,78,0,78
2014,Lakelyn,F,100,78,0,78
2014,Lilli,F,100,78,0,78
2014,Maelee,F,100,78,0,78
2014,Mallorie,F,100,78,0,78
2014,Oakleigh,F,100,78,0,78
2014,Olga,F,100,78,0,78
2014,Rami,M,100,0,78,78
2014,Rayaan,M,88,9,69,78
2014,Shaya,M,63,29,49,78
2014,Taylee,F,100,78,0,78
2014,Wendell,M,100,0,78,78
2014,Willis,M,100,0,78,78
2014,Xavion,M,100,0,78,78
2014,Adriano,M,100,0,77,77
2014,Alaynah,F,100,77,0,77
2014,Aliviah,F,100,77,0,77
2014,Aminata,F,100,77,0,77
2014,Atley,F,66,51,26,77
2014,Avelyn,F,100,77,0,77
2014,Aylah,F,100,77,0,77
2014,Ayub,M,100,0,77,77
2014,Briseis,F,100,77,0,77
2014,Brookelyn,F,100,77,0,77
2014,Burke,M,92,6,71,77
2014,Caelan,M,81,15,62,77
2014,Clive,M,100,0,77,77
2014,Colston,M,100,0,77,77
2014,Darin,M,100,0,77,77
2014,Dave,M,100,0,77,77
2014,Davi,M,91,7,70,77
2014,Devlin,M,91,7,70,77
2014,Divya,F,100,77,0,77
2014,Eowyn,F,100,77,0,77
2014,Kaeson,M,100,0,77,77
2014,Kaylene,F,100,77,0,77
2014,Lynette,F,100,77,0,77
2014,Malinda,F,100,77,0,77
2014,Melania,F,100,77,0,77
2014,Mylo,M,91,7,70,77
2014,Oziel,M,100,0,77,77
2014,Raelee,F,100,77,0,77
2014,Randi,F,94,72,5,77
2014,Ronny,M,100,0,77,77
2014,Rosanna,F,100,77,0,77
2014,Rudra,M,100,0,77,77
2014,Samaira,F,100,77,0,77
2014,Serene,F,100,77,0,77
2014,Shayan,M,100,0,77,77
2014,Suzanne,F,100,77,0,77
2014,Triniti,F,100,77,0,77
2014,Uma,F,100,77,0,77
2014,Vanellope,F,100,77,0,77
2014,Yitty,F,100,77,0,77
2014,Yonatan,M,100,0,77,77
2014,Yusra,F,100,77,0,77
2014,Adah,F,100,76,0,76
2014,Adella,F,100,76,0,76
2014,Adnan,M,100,0,76,76
2014,Aislyn,F,100,76,0,76
2014,Aly,F,75,57,19,76
2014,Aziyah,F,100,76,0,76
2014,Bradford,M,100,0,76,76
2014,Brailynn,F,100,76,0,76
2014,Brissa,F,100,76,0,76
2014,Ellington,F,63,48,28,76
2014,Emmersyn,F,100,76,0,76
2014,Estela,F,100,76,0,76
2014,Gracey,F,100,76,0,76
2014,Graycen,F,57,43,33,76
2014,Jakoby,M,100,0,76,76
2014,Jed,M,100,0,76,76
2014,Khylee,F,100,76,0,76
2014,Knowledge,M,93,5,71,76
2014,Lamya,F,100,76,0,76
2014,Leyna,F,100,76,0,76
2014,Lucianna,F,100,76,0,76
2014,Macee,F,100,76,0,76
2014,Marques,M,100,0,76,76
2014,Maycie,F,100,76,0,76
2014,Mylan,M,71,22,54,76
2014,Naveen,M,59,31,45,76
2014,Percy,M,92,6,70,76
2014,Riker,M,100,0,76,76
2014,Susie,F,100,76,0,76
2014,Tom,M,100,0,76,76
2014,Yohan,M,100,0,76,76
2014,Yusef,M,100,0,76,76
2014,Zaniah,F,100,76,0,76
2014,Zipporah,F,100,76,0,76
2014,Abella,F,100,75,0,75
2014,Ainslee,F,100,75,0,75
2014,Alea,F,100,75,0,75
2014,Amie,F,100,75,0,75
2014,Amore,F,85,64,11,75
2014,Annalyn,F,100,75,0,75
2014,Atharv,M,100,0,75,75
2014,Baker,M,91,7,68,75
2014,Bexley,F,85,64,11,75
2014,Brad,M,100,0,75,75
2014,Brook,F,80,60,15,75
2014,Chole,F,100,75,0,75
2014,Daiana,F,100,75,0,75
2014,Daquan,M,100,0,75,75
2014,Darion,M,100,0,75,75
2014,Denali,F,73,55,20,75
2014,Elif,F,100,75,0,75
2014,Finnigan,M,100,0,75,75
2014,Goldie,F,100,75,0,75
2014,Harmonee,F,100,75,0,75
2014,Hiba,F,100,75,0,75
2014,Jackelyn,F,100,75,0,75
2014,Jeancarlos,M,100,0,75,75
2014,Kevon,M,100,0,75,75
2014,Krisha,F,100,75,0,75
2014,Kymber,F,100,75,0,75
2014,Mahmoud,M,100,0,75,75
2014,Maleigha,F,100,75,0,75
2014,Maricela,F,100,75,0,75
2014,Patricio,M,100,0,75,75
2014,Richie,M,100,0,75,75
2014,Saad,M,100,0,75,75
2014,Sama,F,100,75,0,75
2014,Samia,F,100,75,0,75
2014,Slater,M,100,0,75,75
2014,Sylar,M,92,6,69,75
2014,Sylvester,M,100,0,75,75
2014,Symone,F,100,75,0,75
2014,Talen,M,91,7,68,75
2014,Travon,M,100,0,75,75
2014,Westen,M,100,0,75,75
2014,Aayush,M,100,0,74,74
2014,Abriana,F,100,74,0,74
2014,Aliannah,F,100,74,0,74
2014,Aoife,F,100,74,0,74
2014,Baxter,M,100,0,74,74
2014,Blayze,M,93,5,69,74
2014,Brie,F,100,74,0,74
2014,Brinkley,F,100,74,0,74
2014,Coleson,M,100,0,74,74
2014,Corina,F,100,74,0,74
2014,Cylus,M,100,0,74,74
2014,Danya,F,100,74,0,74
2014,Dixon,M,100,0,74,74
2014,Emilyn,F,100,74,0,74
2014,Evin,M,84,12,62,74
2014,Herbert,M,100,0,74,74
2014,Jahzara,F,100,74,0,74
2014,Javen,M,100,0,74,74
2014,Jedediah,M,100,0,74,74
2014,Josefina,F,100,74,0,74
2014,Kenslee,F,100,74,0,74
2014,Linley,F,100,74,0,74
2014,Michelangelo,M,100,0,74,74
2014,Naveah,F,100,74,0,74
2014,Nayomi,F,100,74,0,74
2014,Nehemias,M,100,0,74,74
2014,Nika,F,100,74,0,74
2014,Paulo,M,100,0,74,74
2014,Rilyn,F,91,67,7,74
2014,Riot,M,81,14,60,74
2014,Shaan,M,100,0,74,74
2014,Tim,M,100,0,74,74
2014,Tylee,F,85,63,11,74
2014,Virgil,M,100,0,74,74
2014,Yanely,F,100,74,0,74
2014,Zakiyah,F,100,74,0,74
2014,Zarina,F,100,74,0,74
2014,Alexandrea,F,100,73,0,73
2014,Alise,F,100,73,0,73
2014,Anvi,F,100,73,0,73
2014,Aralynn,F,100,73,0,73
2014,Beckam,M,100,0,73,73
2014,Berenice,F,100,73,0,73
2014,Braulio,M,100,0,73,73
2014,Brileigh,F,100,73,0,73
2014,Cerenity,F,100,73,0,73
2014,Deanthony,M,100,0,73,73
2014,Desire,F,100,73,0,73
2014,Elouise,F,100,73,0,73
2014,Emberlynn,F,100,73,0,73
2014,Emmalin,F,100,73,0,73
2014,Emrie,F,100,73,0,73
2014,Gadiel,M,100,0,73,73
2014,Gladys,F,100,73,0,73
2014,Henrietta,F,100,73,0,73
2014,Herman,M,100,0,73,73
2014,Isidro,M,100,0,73,73
2014,Janelly,F,100,73,0,73
2014,Jareth,M,100,0,73,73
2014,Judd,M,100,0,73,73
2014,Kaisley,F,100,73,0,73
2014,Kambri,F,100,73,0,73
2014,Kaydance,F,100,73,0,73
2014,Lexus,F,100,73,0,73
2014,Lizette,F,100,73,0,73
2014,Maceo,M,100,0,73,73
2014,Marguerite,F,100,73,0,73
2014,Rion,M,60,29,44,73
2014,Shlok,M,100,0,73,73
2014,Yehudis,F,100,73,0,73
2014,Zyair,M,89,8,65,73
2014,Adelia,F,100,72,0,72
2014,Aiyden,M,100,0,72,72
2014,Alysson,F,100,72,0,72
2014,Asiyah,F,85,61,11,72
2014,Ayush,M,100,0,72,72
2014,Azaiah,M,100,0,72,72
2014,Azrael,M,76,17,55,72
2014,Brilynn,F,93,67,5,72
2014,Caeden,M,100,0,72,72
2014,Chloee,F,100,72,0,72
2014,Deklyn,M,72,20,52,72
2014,Demarco,M,100,0,72,72
2014,Female,F,100,72,0,72
2014,Hakeem,M,100,0,72,72
2014,Jahlil,M,100,0,72,72
2014,Janai,F,93,67,5,72
2014,Jasmyn,F,100,72,0,72
2014,Jeremih,M,100,0,72,72
2014,Joana,F,100,72,0,72
2014,Klayton,M,100,0,72,72
2014,Kloey,F,100,72,0,72
2014,Laynie,F,100,72,0,72
2014,Mahdi,M,100,0,72,72
2014,Morrison,M,92,6,66,72
2014,Nazareth,F,53,38,34,72
2014,Neve,F,100,72,0,72
2014,Rivky,F,100,72,0,72
2014,Ryu,M,100,0,72,72
2014,Sade,F,92,66,6,72
2014,Safiya,F,100,72,0,72
2014,Sahil,M,100,0,72,72
2014,Saira,F,100,72,0,72
2014,Shaylynn,F,100,72,0,72
2014,Tennyson,M,65,25,47,72
2014,Wisdom,F,57,41,31,72
2014,Yazan,M,100,0,72,72
2014,Zamiyah,F,100,72,0,72
2014,Advik,M,100,0,71,71
2014,Analiyah,F,100,71,0,71
2014,Anisha,F,100,71,0,71
2014,Aryah,F,100,71,0,71
2014,Avett,M,90,7,64,71
2014,Barron,M,100,0,71,71
2014,Baylen,M,85,11,60,71
2014,Brennon,M,100,0,71,71
2014,Clarke,M,55,32,39,71
2014,Connie,F,100,71,0,71
2014,Cruze,M,100,0,71,71
2014,Cy,M,100,0,71,71
2014,Eh,M,61,28,43,71
2014,Emmery,F,100,71,0,71
2014,Emrys,M,82,13,58,71
2014,Fayth,F,100,71,0,71
2014,Gavriel,M,100,0,71,71
2014,Graydon,M,100,0,71,71
2014,Issabella,F,100,71,0,71
2014,Jadore,F,93,66,5,71
2014,Jovi,F,80,57,14,71
2014,Kairo,M,100,0,71,71
2014,Kamil,M,79,15,56,71
2014,Kayne,M,100,0,71,71
2014,Kennady,F,100,71,0,71
2014,Khamari,M,85,11,60,71
2014,Kirby,M,56,31,40,71
2014,Kree,F,63,45,26,71
2014,Makiya,F,100,71,0,71
2014,Marbella,F,100,71,0,71
2014,Maryah,F,100,71,0,71
2014,Maxson,M,100,0,71,71
2014,Nikole,F,100,71,0,71
2014,Oden,M,100,0,71,71
2014,Pia,F,100,71,0,71
2014,Rider,M,100,0,71,71
2014,Rya,F,100,71,0,71
2014,Rylei,F,90,64,7,71
2014,Sparrow,F,89,63,8,71
2014,Therese,F,100,71,0,71
2014,Xaiden,M,100,0,71,71
2014,Xena,F,100,71,0,71
2014,Yash,M,100,0,71,71
2014,Yessenia,F,100,71,0,71
2014,Aaiden,M,100,0,70,70
2014,Agatha,F,100,70,0,70
2014,Akhil,M,100,0,70,70
2014,Aleen,F,100,70,0,70
2014,Allana,F,100,70,0,70
2014,Alliyah,F,100,70,0,70
2014,Amaree,M,71,20,50,70
2014,Britain,M,56,31,39,70
2014,Corben,M,100,0,70,70
2014,Ellia,F,100,70,0,70
2014,Gaia,F,100,70,0,70
2014,Geovanny,M,100,0,70,70
2014,Hadassa,F,100,70,0,70
2014,Hosanna,F,100,70,0,70
2014,Isael,M,100,0,70,70
2014,Izabela,F,100,70,0,70
2014,Jacques,M,100,0,70,70
2014,Jakhi,M,100,0,70,70
2014,Jayvian,M,100,0,70,70
2014,Joann,F,100,70,0,70
2014,Jodi,F,93,65,5,70
2014,Kenadie,F,100,70,0,70
2014,Kensleigh,F,100,70,0,70
2014,Kenzleigh,F,100,70,0,70
2014,Laikyn,F,100,70,0,70
2014,Lani,F,100,70,0,70
2014,Lemuel,M,100,0,70,70
2014,Melannie,F,100,70,0,70
2014,Obadiah,M,100,0,70,70
2014,Robbie,M,87,9,61,70
2014,Roscoe,M,100,0,70,70
2014,Shylah,F,100,70,0,70
2014,Sydni,F,100,70,0,70
2014,Tyra,F,100,70,0,70
2014,Yatziri,F,100,70,0,70
2014,Yechiel,M,100,0,70,70
2014,Annemarie,F,100,69,0,69
2014,Arlen,M,77,16,53,69
2014,Avan,M,90,7,62,69
2014,Aydenn,M,100,0,69,69
2014,Blayke,F,64,44,25,69
2014,Braedon,M,100,0,69,69
2014,Brylan,M,100,0,69,69
2014,Calen,M,100,0,69,69
2014,Cylas,M,100,0,69,69
2014,Daxon,M,100,0,69,69
2014,Demian,M,100,0,69,69
2014,Ebony,F,100,69,0,69
2014,Emaan,F,93,64,5,69
2014,Halen,M,54,32,37,69
2014,Halima,F,100,69,0,69
2014,Jeronimo,M,100,0,69,69
2014,Kaiser,M,100,0,69,69
2014,Kami,F,100,69,0,69
2014,Kelby,M,58,29,40,69
2014,Lili,F,100,69,0,69
2014,Macklin,M,100,0,69,69
2014,Maysen,M,55,31,38,69
2014,Meah,F,100,69,0,69
2014,Octavia,F,100,69,0,69
2014,Omer,M,100,0,69,69
2014,Rehan,M,100,0,69,69
2014,Rush,M,100,0,69,69
2014,Samari,F,74,51,18,69
2014,Saya,F,100,69,0,69
2014,Shaina,F,100,69,0,69
2014,Stormie,F,100,69,0,69
2014,Syrus,M,100,0,69,69
2014,Tasneem,F,100,69,0,69
2014,Tavin,M,100,0,69,69
2014,Warner,M,100,0,69,69
2014,Xitlali,F,100,69,0,69
2014,Yasiel,M,100,0,69,69
2014,Adair,F,51,35,33,68
2014,Adamari,F,100,68,0,68
2014,Adara,F,100,68,0,68
2014,Allegra,F,100,68,0,68
2014,Alycia,F,100,68,0,68
2014,Andrei,M,100,0,68,68
2014,Arin,M,59,28,40,68
2014,Charisma,F,100,68,0,68
2014,Daylon,M,100,0,68,68
2014,Deniz,M,63,25,43,68
2014,Draya,F,100,68,0,68
2014,Eila,F,100,68,0,68
2014,Eleanore,F,100,68,0,68
2014,Eliott,M,100,0,68,68
2014,Emsley,F,100,68,0,68
2014,Finlee,F,85,58,10,68
2014,Hagan,M,81,13,55,68
2014,Hashim,M,100,0,68,68
2014,Haya,F,100,68,0,68
2014,Jacelynn,F,100,68,0,68
2014,Jaila,F,100,68,0,68
2014,Jairus,M,100,0,68,68
2014,Janna,F,100,68,0,68
2014,Jordana,F,100,68,0,68
2014,Kaylei,F,100,68,0,68
2014,Kendyll,F,100,68,0,68
2014,Kobi,M,68,22,46,68
2014,Layden,M,100,0,68,68
2014,Leandra,F,100,68,0,68
2014,Leopold,M,100,0,68,68
2014,Lettie,F,100,68,0,68
2014,Lillia,F,100,68,0,68
2014,Makiah,F,84,57,11,68
2014,Manha,F,100,68,0,68
2014,Marely,F,100,68,0,68
2014,Mayla,F,100,68,0,68
2014,Nicolai,M,100,0,68,68
2014,Osiel,M,100,0,68,68
2014,Rashawn,M,100,0,68,68
2014,Rockwell,M,100,0,68,68
2014,Romy,F,91,62,6,68
2014,Tatianna,F,100,68,0,68
2014,Tavion,M,100,0,68,68
2014,Tyanna,F,100,68,0,68
2014,Tyron,M,100,0,68,68
2014,Vanesa,F,100,68,0,68
2014,Aalayah,F,100,67,0,67
2014,Abbas,M,100,0,67,67
2014,Abhinav,M,100,0,67,67
2014,Ahna,F,100,67,0,67
2014,Aiva,F,100,67,0,67
2014,Akari,F,64,43,24,67
2014,Alyce,F,100,67,0,67
2014,Ameena,F,100,67,0,67
2014,Analisa,F,100,67,0,67
2014,Azari,F,67,45,22,67
2014,Camellia,F,100,67,0,67
2014,Caterina,F,100,67,0,67
2014,Collier,M,76,16,51,67
2014,Daniya,F,100,67,0,67
2014,Emmanuelle,F,90,60,7,67
2014,Gregorio,M,100,0,67,67
2014,Huck,M,100,0,67,67
2014,Ilyana,F,100,67,0,67
2014,Jahari,M,82,12,55,67
2014,Jariyah,F,100,67,0,67
2014,Jaylani,F,100,67,0,67
2014,Jenessa,F,100,67,0,67
2014,Jenevieve,F,100,67,0,67
2014,Katya,F,100,67,0,67
2014,Kensie,F,100,67,0,67
2014,Kylei,F,100,67,0,67
2014,Leander,M,100,0,67,67
2014,Leyah,F,100,67,0,67
2014,Lilliann,F,100,67,0,67
2014,Lottie,F,100,67,0,67
2014,Nahum,M,100,0,67,67
2014,Neha,F,100,67,0,67
2014,Niah,F,100,67,0,67
2014,Omarion,M,100,0,67,67
2014,Paolo,M,100,0,67,67
2014,Pete,M,100,0,67,67
2014,Quincey,M,67,22,45,67
2014,Ravyn,F,100,67,0,67
2014,Rozlyn,F,100,67,0,67
2014,Sayuri,F,100,67,0,67
2014,Scotlyn,F,100,67,0,67
2014,Shaelyn,F,100,67,0,67
2014,Simran,F,100,67,0,67
2014,Tilly,F,100,67,0,67
2014,Uziel,M,100,0,67,67
2014,Uzziah,M,100,0,67,67
2014,Victory,F,82,55,12,67
2014,Yehoshua,M,100,0,67,67
2014,Zach,M,100,0,67,67
2014,Zyan,M,73,18,49,67
2014,Zylen,M,100,0,67,67
2014,Adyn,M,86,9,57,66
2014,Aitana,F,100,66,0,66
2014,Alasia,F,100,66,0,66
2014,Alona,F,100,66,0,66
2014,Alston,M,100,0,66,66
2014,Analy,F,100,66,0,66
2014,Anastacia,F,100,66,0,66
2014,Anela,F,100,66,0,66
2014,Aniylah,F,100,66,0,66
2014,Annaleah,F,100,66,0,66
2014,Aralyn,F,100,66,0,66
2014,Arissa,F,100,66,0,66
2014,Ash,M,100,0,66,66
2014,Averee,F,92,61,5,66
2014,Caylin,F,91,60,6,66
2014,Christa,F,100,66,0,66
2014,Crawford,M,91,6,60,66
2014,Darrin,M,100,0,66,66
2014,Emari,M,56,29,37,66
2014,Ensley,F,100,66,0,66
2014,Hazen,M,92,5,61,66
2014,Hendrik,M,100,0,66,66
2014,Inez,F,91,60,6,66
2014,Irma,F,100,66,0,66
2014,Ishani,F,100,66,0,66
2014,Itzae,M,79,14,52,66
2014,Jaela,F,100,66,0,66
2014,Jamaya,F,100,66,0,66
2014,Jancarlos,M,100,0,66,66
2014,Jermiah,M,100,0,66,66
2014,Jessi,F,91,60,6,66
2014,Joella,F,100,66,0,66
2014,Johannah,F,100,66,0,66
2014,Kal,M,100,0,66,66
2014,Karrington,F,83,55,11,66
2014,Kay,F,91,60,6,66
2014,Kellie,F,100,66,0,66
2014,Kolbe,M,92,5,61,66
2014,Koltyn,M,100,0,66,66
2014,Landri,F,100,66,0,66
2014,Laron,M,100,0,66,66
2014,Liora,F,100,66,0,66
2014,Locke,M,100,0,66,66
2014,Lora,F,100,66,0,66
2014,Lynden,M,62,25,41,66
2014,Magali,F,100,66,0,66
2014,Malikai,M,100,0,66,66
2014,Marshal,M,100,0,66,66
2014,Mattison,F,100,66,0,66
2014,Naomy,F,100,66,0,66
2014,Olivier,M,100,0,66,66
2014,Pauline,F,100,66,0,66
2014,Raniya,F,100,66,0,66
2014,Rooney,F,58,38,28,66
2014,Sai,M,80,13,53,66
2014,Samiah,F,100,66,0,66
2014,Samirah,F,100,66,0,66
2014,Simona,F,100,66,0,66
2014,Waylen,M,100,0,66,66
2014,Yassin,M,100,0,66,66
2014,Zayna,F,100,66,0,66
2014,Aahil,M,100,0,65,65
2014,Aaniyah,F,100,65,0,65
2014,Addelynn,F,100,65,0,65
2014,Adelynne,F,100,65,0,65
2014,Aislin,F,100,65,0,65
2014,Aizen,M,100,0,65,65
2014,Alaia,F,100,65,0,65
2014,Amaria,F,100,65,0,65
2014,An,F,51,33,32,65
2014,Anasofia,F,100,65,0,65
2014,Arianah,F,100,65,0,65
2014,Ashwin,M,100,0,65,65
2014,Aysha,F,100,65,0,65
2014,Bernice,F,100,65,0,65
2014,Chelsie,F,100,65,0,65
2014,Corrina,F,100,65,0,65
2014,Cutler,M,100,0,65,65
2014,Dallis,F,85,55,10,65
2014,Dylann,F,60,39,26,65
2014,Elton,M,100,0,65,65
2014,Erwin,M,100,0,65,65
2014,Everardo,M,100,0,65,65
2014,Giorgio,M,100,0,65,65
2014,Hanan,F,89,58,7,65
2014,Haniya,F,100,65,0,65
2014,Harbor,F,60,39,26,65
2014,Haroon,M,100,0,65,65
2014,Jae,M,52,31,34,65
2014,Jaquelin,F,100,65,0,65
2014,Kaili,F,100,65,0,65
2014,Karmelo,M,100,0,65,65
2014,Kavin,M,100,0,65,65
2014,Kemper,M,65,23,42,65
2014,Lillianne,F,100,65,0,65
2014,Liyana,F,100,65,0,65
2014,Lucky,M,83,11,54,65
2014,Meara,F,100,65,0,65
2014,Melanny,F,100,65,0,65
2014,Mileena,F,100,65,0,65
2014,Nataleigh,F,100,65,0,65
2014,Quin,M,58,27,38,65
2014,Renzo,M,100,0,65,65
2014,Roberta,F,100,65,0,65
2014,Ryanne,F,100,65,0,65
2014,Shaelynn,F,100,65,0,65
2014,Shriya,F,100,65,0,65
2014,Somaya,F,100,65,0,65
2014,Sylis,M,100,0,65,65
2014,Valor,M,82,12,53,65
2014,Vito,M,100,0,65,65
2014,Zavian,M,100,0,65,65
2014,Aariz,M,100,0,64,64
2014,Adel,M,66,22,42,64
2014,Alessio,M,100,0,64,64
2014,Anirudh,M,100,0,64,64
2014,Blaize,M,88,8,56,64
2014,Bradly,M,100,0,64,64
2014,Brenley,F,92,59,5,64
2014,Briseida,F,100,64,0,64
2014,Broden,M,100,0,64,64
2014,Catalaya,F,100,64,0,64
2014,Chassidy,F,100,64,0,64
2014,Coleton,M,100,0,64,64
2014,Copeland,M,67,21,43,64
2014,Eben,M,100,0,64,64
2014,Emalynn,F,100,64,0,64
2014,Emmarose,F,100,64,0,64
2014,Eshaal,F,100,64,0,64
2014,Ezri,F,92,59,5,64
2014,Flint,M,100,0,64,64
2014,Ivette,F,100,64,0,64
2014,Jacion,M,100,0,64,64
2014,Jhett,M,100,0,64,64
2014,Juno,F,77,49,15,64
2014,Kalena,F,100,64,0,64
2014,Kamani,F,61,39,25,64
2014,Kenadi,F,100,64,0,64
2014,Kimani,F,56,36,28,64
2014,Kimberlee,F,100,64,0,64
2014,Lashawn,M,81,12,52,64
2014,Lindy,F,100,64,0,64
2014,Liz,F,100,64,0,64
2014,Male,M,100,0,64,64
2014,Manny,M,100,0,64,64
2014,Marta,F,100,64,0,64
2014,Mendel,M,100,0,64,64
2014,Michal,F,66,42,22,64
2014,Mirabella,F,100,64,0,64
2014,Nada,F,100,64,0,64
2014,Niall,M,100,0,64,64
2014,Payden,M,59,26,38,64
2014,Philippa,F,100,64,0,64
2014,Philomena,F,100,64,0,64
2014,Serina,F,100,64,0,64
2014,Sia,F,100,64,0,64
2014,Stellan,M,100,0,64,64
2014,Tierney,F,100,64,0,64
2014,Tre,M,100,0,64,64
2014,Valen,M,84,10,54,64
2014,Yahaira,F,100,64,0,64
2014,Aharon,M,100,0,63,63
2014,Amariana,F,100,63,0,63
2014,Anaiyah,F,100,63,0,63
2014,Anayeli,F,100,63,0,63
2014,Anessa,F,100,63,0,63
2014,Angelia,F,100,63,0,63
2014,Anushka,F,100,63,0,63
2014,Aram,M,92,5,58,63
2014,Ashten,M,87,8,55,63
2014,Audri,F,100,63,0,63
2014,Avayah,F,100,63,0,63
2014,Cailee,F,100,63,0,63
2014,Carlito,M,100,0,63,63
2014,Clarity,F,100,63,0,63
2014,Crue,M,100,0,63,63
2014,Dailyn,F,79,50,13,63
2014,Devora,F,100,63,0,63
2014,Eliah,M,75,16,47,63
2014,Ellee,F,100,63,0,63
2014,Elyza,F,100,63,0,63
2014,Eshal,F,100,63,0,63
2014,Faithlynn,F,100,63,0,63
2014,Fern,F,100,63,0,63
2014,Gretel,F,100,63,0,63
2014,Havana,F,100,63,0,63
2014,Hosea,M,100,0,63,63
2014,Indy,F,62,39,24,63
2014,Jaice,M,86,9,54,63
2014,Jathan,M,100,0,63,63
2014,Jaziyah,F,100,63,0,63
2014,Jazleen,F,100,63,0,63
2014,Jim,M,100,0,63,63
2014,Karam,M,100,0,63,63
2014,Karthik,M,100,0,63,63
2014,Kegan,M,100,0,63,63
2014,Keion,M,100,0,63,63
2014,Kiyomi,F,100,63,0,63
2014,Kolin,M,100,0,63,63
2014,Kyli,F,100,63,0,63
2014,Leigh,F,87,55,8,63
2014,Lenore,F,100,63,0,63
2014,Liara,F,100,63,0,63
2014,Mckay,M,87,8,55,63
2014,Molli,F,100,63,0,63
2014,Nadya,F,100,63,0,63
2014,Niklaus,M,100,0,63,63
2014,Oona,F,100,63,0,63
2014,Paetyn,F,92,58,5,63
2014,Rayshawn,M,100,0,63,63
2014,Roel,M,100,0,63,63
2014,Sabella,F,100,63,0,63
2014,Sakura,F,100,63,0,63
2014,Suzanna,F,100,63,0,63
2014,Tailynn,F,100,63,0,63
2014,Talyn,F,56,35,28,63
2014,Tory,F,56,35,28,63
2014,Treyton,M,100,0,63,63
2014,Adalind,F,100,62,0,62
2014,Ahuva,F,100,62,0,62
2014,Amberlynn,F,100,62,0,62
2014,Aniyla,F,100,62,0,62
2014,Annalyse,F,100,62,0,62
2014,Ariannah,F,100,62,0,62
2014,Arleen,F,100,62,0,62
2014,Avaleigh,F,100,62,0,62
2014,Bjorn,M,100,0,62,62
2014,Caine,M,100,0,62,62
2014,Cru,M,100,0,62,62
2014,Domenico,M,100,0,62,62
2014,Dresden,M,84,10,52,62
2014,Eldon,M,100,0,62,62
2014,Esai,M,100,0,62,62
2014,Fabiana,F,100,62,0,62
2014,Isela,F,100,62,0,62
2014,Janylah,F,100,62,0,62
2014,Keven,M,100,0,62,62
2014,Kitai,M,100,0,62,62
2014,Kyliee,F,100,62,0,62
2014,Luci,F,100,62,0,62
2014,Mabry,F,100,62,0,62
2014,Makynlee,F,100,62,0,62
2014,Marcell,M,100,0,62,62
2014,Masiah,M,100,0,62,62
2014,Mayar,F,89,55,7,62
2014,Meilani,F,100,62,0,62
2014,Misty,F,100,62,0,62
2014,Natanael,M,100,0,62,62
2014,Nella,F,100,62,0,62
2014,Ozzie,M,100,0,62,62
2014,Remmy,M,53,29,33,62
2014,Robinson,M,100,0,62,62
2014,Rochelle,F,100,62,0,62
2014,Ruhi,F,100,62,0,62
2014,Sherry,F,100,62,0,62
2014,Stefany,F,100,62,0,62
2014,Syeda,F,100,62,0,62
2014,Abriel,M,69,19,42,61
2014,Alekzander,M,100,0,61,61
2014,Arvin,M,100,0,61,61
2014,Aziza,F,100,61,0,61
2014,Breelyn,F,100,61,0,61
2014,Cami,F,100,61,0,61
2014,Cate,F,100,61,0,61
2014,Cedrick,M,100,0,61,61
2014,Daliyah,F,100,61,0,61
2014,Damya,F,100,61,0,61
2014,Darrion,M,100,0,61,61
2014,Dejuan,M,100,0,61,61
2014,Edin,M,89,7,54,61
2014,Eligh,M,100,0,61,61
2014,Emile,M,84,10,51,61
2014,Favian,M,100,0,61,61
2014,Garret,M,100,0,61,61
2014,Gema,F,100,61,0,61
2014,Harleen,F,100,61,0,61
2014,Heston,M,100,0,61,61
2014,Iqra,F,100,61,0,61
2014,Isac,M,100,0,61,61
2014,Izzy,F,74,45,16,61
2014,Jalissa,F,100,61,0,61
2014,Jamaal,M,100,0,61,61
2014,Jennie,F,100,61,0,61
2014,Joah,M,100,0,61,61
2014,Johnson,M,100,0,61,61
2014,Jowell,M,100,0,61,61
2014,Kaelin,F,62,38,23,61
2014,Kailah,F,100,61,0,61
2014,Karely,F,100,61,0,61
2014,Kenai,M,100,0,61,61
2014,Keylin,F,66,40,21,61
2014,Kitana,F,100,61,0,61
2014,Laela,F,100,61,0,61
2014,Latrell,M,100,0,61,61
2014,Mace,M,100,0,61,61
2014,Matt,M,100,0,61,61
2014,Mayrin,F,100,61,0,61
2014,Nathanial,M,100,0,61,61
2014,Pilar,F,100,61,0,61
2014,Rana,F,85,52,9,61
2014,Rina,F,100,61,0,61
2014,Ron,M,100,0,61,61
2014,Skylyn,F,100,61,0,61
2014,Sofiya,F,100,61,0,61
2014,Tamera,F,100,61,0,61
2014,Tayvion,M,100,0,61,61
2014,Teigan,F,74,45,16,61
2014,Tirzah,F,100,61,0,61
2014,Ved,M,100,0,61,61
2014,Yadier,M,100,0,61,61
2014,Zylah,F,100,61,0,61
2014,Akshaj,M,100,0,60,60
2014,Alaiya,F,100,60,0,60
2014,Aleksandr,M,100,0,60,60
2014,Aleya,F,100,60,0,60
2014,Alysa,F,100,60,0,60
2014,Alyssia,F,100,60,0,60
2014,Amyiah,F,100,60,0,60
2014,Armin,M,100,0,60,60
2014,Arrianna,F,100,60,0,60
2014,Auria,F,100,60,0,60
2014,Bladen,M,100,0,60,60
2014,Brooklin,F,100,60,0,60
2014,Bryston,M,100,0,60,60
2014,Cailin,F,100,60,0,60
2014,Chael,M,100,0,60,60
2014,Chancellor,M,100,0,60,60
2014,Chasen,M,100,0,60,60
2014,Citlalli,F,100,60,0,60
2014,Cloe,F,100,60,0,60
2014,Creighton,M,100,0,60,60
2014,Daven,M,100,0,60,60
2014,Demarius,M,100,0,60,60
2014,Edyn,F,87,52,8,60
2014,Eliora,F,100,60,0,60
2014,Emmanuella,F,100,60,0,60
2014,Gaven,M,100,0,60,60
2014,Hala,F,100,60,0,60
2014,Hilary,F,100,60,0,60
2014,Huda,F,100,60,0,60
2014,Hussain,M,100,0,60,60
2014,Izabell,F,100,60,0,60
2014,Izak,M,100,0,60,60
2014,Jalisa,F,100,60,0,60
2014,Janette,F,100,60,0,60
2014,Jaydyn,M,63,22,38,60
2014,Jewell,F,82,49,11,60
2014,Jocelyne,F,100,60,0,60
2014,Joni,F,82,49,11,60
2014,Kalaya,F,100,60,0,60
2014,Kateri,F,100,60,0,60
2014,Katlyn,F,100,60,0,60
2014,Keilyn,F,83,50,10,60
2014,Kendalyn,F,100,60,0,60
2014,Klarissa,F,100,60,0,60
2014,Kristofer,M,100,0,60,60
2014,Landree,F,100,60,0,60
2014,Liesel,F,100,60,0,60
2014,Lizzie,F,100,60,0,60
2014,Lynda,F,100,60,0,60
2014,Mazen,M,100,0,60,60
2014,Myracle,F,100,60,0,60
2014,Odessa,F,100,60,0,60
2014,Reyes,M,100,0,60,60
2014,Rosabella,F,100,60,0,60
2014,Ryen,F,57,34,26,60
2014,Shakira,F,100,60,0,60
2014,Sire,M,100,0,60,60
2014,Terrion,M,100,0,60,60
2014,Tyla,F,100,60,0,60
2014,Tyrion,M,100,0,60,60
2014,Venus,F,100,60,0,60
2014,Zade,M,100,0,60,60
2014,Aahana,F,100,59,0,59
2014,Adria,F,100,59,0,59
2014,Alister,M,100,0,59,59
2014,Alya,F,100,59,0,59
2014,Alyza,F,100,59,0,59
2014,Analiah,F,100,59,0,59
2014,Anamaria,F,100,59,0,59
2014,Aric,M,100,0,59,59
2014,Basil,M,73,16,43,59
2014,Bethel,F,100,59,0,59
2014,Cailynn,F,100,59,0,59
2014,Cydney,F,100,59,0,59
2014,Damiyah,F,100,59,0,59
2014,Deisy,F,100,59,0,59
2014,Edan,M,85,9,50,59
2014,Eldana,F,100,59,0,59
2014,Elie,M,76,14,45,59
2014,Erianna,F,100,59,0,59
2014,Galen,M,100,0,59,59
2014,Haden,M,100,0,59,59
2014,Iain,M,100,0,59,59
2014,Ibraheem,M,100,0,59,59
2014,Irina,F,100,59,0,59
2014,Jawad,M,100,0,59,59
2014,Jenni,F,100,59,0,59
2014,Jentry,F,73,43,16,59
2014,Jodie,F,78,46,13,59
2014,Kenzington,F,100,59,0,59
2014,Kenzlie,F,100,59,0,59
2014,Lamiyah,F,100,59,0,59
2014,Laurence,M,100,0,59,59
2014,Lillee,F,100,59,0,59
2014,Lillyanne,F,100,59,0,59
2014,Lissette,F,100,59,0,59
2014,Macyn,F,85,50,9,59
2014,Makyla,F,100,59,0,59
2014,Malea,F,100,59,0,59
2014,Marlyn,F,100,59,0,59
2014,Ravi,M,100,0,59,59
2014,Raylyn,F,83,49,10,59
2014,Reegan,F,64,38,21,59
2014,Rhylan,M,59,24,35,59
2014,Saleh,M,100,0,59,59
2014,Selim,M,100,0,59,59
2014,Sephora,F,100,59,0,59
2014,Serinity,F,100,59,0,59
2014,Shai,M,58,25,34,59
2014,Skarlett,F,100,59,0,59
2014,Starla,F,100,59,0,59
2014,Swayze,F,85,50,9,59
2014,Ted,M,100,0,59,59
2014,Truth,M,59,24,35,59
2014,Tyren,M,100,0,59,59
2014,Tysen,M,100,0,59,59
2014,Vania,F,100,59,0,59
2014,Verity,F,100,59,0,59
2014,West,M,100,0,59,59
2014,Xavian,M,100,0,59,59
2014,Yisrael,M,100,0,59,59
2014,Zaedyn,M,100,0,59,59
2014,Zakari,M,78,13,46,59
2014,Zoei,F,100,59,0,59
2014,Amairany,F,100,58,0,58
2014,Aveline,F,100,58,0,58
2014,Aylen,F,79,46,12,58
2014,Ayra,F,100,58,0,58
2014,Azlyn,F,100,58,0,58
2014,Bayla,F,100,58,0,58
2014,Breanne,F,100,58,0,58
2014,Caliana,F,100,58,0,58
2014,Callista,F,100,58,0,58
2014,Cassia,F,100,58,0,58
2014,Cathryn,F,100,58,0,58
2014,Christiano,M,100,0,58,58
2014,Claudio,M,100,0,58,58
2014,Coralee,F,100,58,0,58
2014,Damarcus,M,100,0,58,58
2014,Davonte,M,100,0,58,58
2014,Delainey,F,100,58,0,58
2014,Destiney,F,100,58,0,58
2014,Ellah,F,100,58,0,58
2014,Esha,F,100,58,0,58
2014,Esmae,F,100,58,0,58
2014,Fabio,M,100,0,58,58
2014,Genaro,M,100,0,58,58
2014,Geno,M,100,0,58,58
2014,Isreal,M,100,0,58,58
2014,Jaeda,F,100,58,0,58
2014,Jamilah,F,100,58,0,58
2014,Janay,F,100,58,0,58
2014,Jelena,F,100,58,0,58
2014,Jerrell,M,100,0,58,58
2014,Justina,F,100,58,0,58
2014,Kaiyah,F,100,58,0,58
2014,Kamaya,F,100,58,0,58
2014,Khyree,M,100,0,58,58
2014,Kimberley,F,100,58,0,58
2014,Kinzie,F,100,58,0,58
2014,Lakin,F,57,33,25,58
2014,Lex,M,100,0,58,58
2014,Leylah,F,100,58,0,58
2014,Lisbeth,F,100,58,0,58
2014,Lyanna,F,100,58,0,58
2014,Mahi,F,100,58,0,58
2014,Mahki,M,100,0,58,58
2014,Makynzie,F,100,58,0,58
2014,Malaika,F,100,58,0,58
2014,Marlen,F,100,58,0,58
2014,Maylen,F,100,58,0,58
2014,Monserrath,F,100,58,0,58
2014,Patton,M,88,7,51,58
2014,Prudence,F,100,58,0,58
2014,Riaan,M,100,0,58,58
2014,Ronen,M,100,0,58,58
2014,Shaquille,M,100,0,58,58
2014,Sir,M,100,0,58,58
2014,Sultan,M,100,0,58,58
2014,Vedant,M,100,0,58,58
2014,Vikram,M,100,0,58,58
2014,Xyla,F,100,58,0,58
2014,Yarel,F,64,37,21,58
2014,Yocheved,F,100,58,0,58
2014,Ysabella,F,100,58,0,58
2014,Zamarion,M,100,0,58,58
2014,Anali,F,100,57,0,57
2014,Arik,M,100,0,57,57
2014,Aseel,F,81,46,11,57
2014,Aubrei,F,100,57,0,57
2014,Augustin,M,100,0,57,57
2014,Avrie,F,100,57,0,57
2014,Ayelen,F,100,57,0,57
2014,Azaan,M,100,0,57,57
2014,Baleigh,F,100,57,0,57
2014,Bobbi,F,100,57,0,57
2014,Bostyn,F,72,41,16,57
2014,Cheryl,F,100,57,0,57
2014,Clair,F,100,57,0,57
2014,Domingo,M,100,0,57,57
2014,Elani,F,100,57,0,57
2014,Estefani,F,100,57,0,57
2014,Eyad,M,100,0,57,57
2014,Finleigh,F,100,57,0,57
2014,Fitzgerald,M,100,0,57,57
2014,Havyn,F,100,57,0,57
2014,Hermione,F,100,57,0,57
2014,Inaaya,F,100,57,0,57
2014,Iona,F,100,57,0,57
2014,Jailah,F,100,57,0,57
2014,Jazlene,F,100,57,0,57
2014,Jhene,F,100,57,0,57
2014,Jia,F,100,57,0,57
2014,Jonatan,M,100,0,57,57
2014,Joselynn,F,100,57,0,57
2014,Kalayah,F,100,57,0,57
2014,Kambria,F,100,57,0,57
2014,Kemani,F,61,35,22,57
2014,Kiah,F,100,57,0,57
2014,Lilee,F,100,57,0,57
2014,Lisette,F,100,57,0,57
2014,Lyriq,F,84,48,9,57
2014,Maddalyn,F,100,57,0,57
2014,Mali,F,91,52,5,57
2014,Maliha,F,100,57,0,57
2014,Mckynlee,F,100,57,0,57
2014,Mea,F,100,57,0,57
2014,Nikolaos,M,100,0,57,57
2014,Ozzy,M,100,0,57,57
2014,Safia,F,100,57,0,57
2014,Saleem,M,100,0,57,57
2014,Sanjay,M,100,0,57,57
2014,Sury,F,100,57,0,57
2014,Swara,F,100,57,0,57
2014,Tytan,M,100,0,57,57
2014,Woodrow,M,100,0,57,57
2014,Abe,M,100,0,56,56
2014,Aeryn,F,100,56,0,56
2014,Amarii,M,59,23,33,56
2014,Ara,F,88,49,7,56
2014,Arayah,F,100,56,0,56
2014,Avory,F,62,35,21,56
2014,Aysia,F,100,56,0,56
2014,Bianka,F,100,56,0,56
2014,Brandyn,M,100,0,56,56
2014,Brynlie,F,100,56,0,56
2014,Candy,F,100,56,0,56
2014,Catarina,F,100,56,0,56
2014,Citlaly,F,100,56,0,56
2014,Dagny,F,100,56,0,56
2014,Daren,M,100,0,56,56
2014,Darianna,F,100,56,0,56
2014,Dayna,F,100,56,0,56
2014,Dmitri,M,100,0,56,56
2014,Dusty,M,75,14,42,56
2014,Eiden,M,100,0,56,56
2014,Ellena,F,100,56,0,56
2014,Eloy,M,100,0,56,56
2014,Emersen,F,80,45,11,56
2014,Fahad,M,100,0,56,56
2014,Hindy,F,100,56,0,56
2014,Hollyn,F,100,56,0,56
2014,Honesti,F,100,56,0,56
2014,Ily,F,100,56,0,56
2014,Ivie,F,100,56,0,56
2014,Jaidon,M,100,0,56,56
2014,Javeon,M,100,0,56,56
2014,Jibril,M,100,0,56,56
2014,Kaliana,F,100,56,0,56
2014,Kalista,F,100,56,0,56
2014,Kamrynn,F,100,56,0,56
2014,Karah,F,100,56,0,56
2014,Katalaya,F,100,56,0,56
2014,Kendric,M,100,0,56,56
2014,Keshav,M,100,0,56,56
2014,Kevyn,M,91,5,51,56
2014,Kharter,M,82,10,46,56
2014,Kiernan,M,75,14,42,56
2014,Koi,M,61,22,34,56
2014,Laurie,F,100,56,0,56
2014,Laynee,F,100,56,0,56
2014,Leeann,F,100,56,0,56
2014,Locklyn,F,91,51,5,56
2014,Maddisyn,F,100,56,0,56
2014,Madelin,F,100,56,0,56
2014,Madelyne,F,100,56,0,56
2014,Madysen,F,100,56,0,56
2014,Maira,F,100,56,0,56
2014,Mayleen,F,100,56,0,56
2014,Naftali,M,100,0,56,56
2014,Osmar,M,100,0,56,56
2014,Parth,M,100,0,56,56
2014,Roen,M,100,0,56,56
2014,Salina,F,100,56,0,56
2014,Tylor,M,91,5,51,56
2014,Abbott,M,85,8,47,55
2014,Addysen,F,100,55,0,55
2014,Adi,M,51,27,28,55
2014,Adonai,M,80,11,44,55
2014,Aicha,F,100,55,0,55
2014,Alaa,F,91,50,5,55
2014,Aliyanna,F,100,55,0,55
2014,Ambar,F,100,55,0,55
2014,Ameliah,F,100,55,0,55
2014,Ameya,F,91,50,5,55
2014,Amilya,F,100,55,0,55
2014,Arina,F,100,55,0,55
2014,Arius,M,100,0,55,55
2014,Ayoub,M,100,0,55,55
2014,Azucena,F,100,55,0,55
2014,Bricen,M,100,0,55,55
2014,Cesia,F,100,55,0,55
2014,Ciana,F,100,55,0,55
2014,Daron,M,100,0,55,55
2014,Dietrich,M,100,0,55,55
2014,Edson,M,100,0,55,55
2014,Elvira,F,100,55,0,55
2014,Emmagrace,F,100,55,0,55
2014,Eros,M,100,0,55,55
2014,Faiga,F,100,55,0,55
2014,Fulton,M,100,0,55,55
2014,Giavonna,F,100,55,0,55
2014,Griselda,F,100,55,0,55
2014,Jafet,M,100,0,55,55
2014,Janely,F,100,55,0,55
2014,Jariah,F,89,49,6,55
2014,Jarred,M,100,0,55,55
2014,Javien,M,100,0,55,55
2014,Jaxston,M,100,0,55,55
2014,Jessenia,F,100,55,0,55
2014,Jocelin,F,100,55,0,55
2014,Kamiah,F,100,55,0,55
2014,Kanyon,M,100,0,55,55
2014,Kekoa,M,100,0,55,55
2014,Kidus,M,100,0,55,55
2014,Krystian,M,91,5,50,55
2014,Ladarius,M,100,0,55,55
2014,Lariah,F,100,55,0,55
2014,Leeanna,F,100,55,0,55
2014,Madina,F,100,55,0,55
2014,Mai,F,100,55,0,55
2014,Mariama,F,100,55,0,55
2014,Mayzie,F,100,55,0,55
2014,Oaklie,F,100,55,0,55
2014,Parris,F,71,39,16,55
2014,Pax,M,91,5,50,55
2014,Pryce,M,100,0,55,55
2014,Renae,F,100,55,0,55
2014,Rhodes,M,87,7,48,55
2014,Saeed,M,100,0,55,55
2014,Sagan,M,67,18,37,55
2014,Shelton,M,100,0,55,55
2014,Shulem,M,100,0,55,55
2014,Sven,M,100,0,55,55
2014,Tammy,F,100,55,0,55
2014,Taran,M,87,7,48,55
2014,Trenten,M,100,0,55,55
2014,Yovani,M,100,0,55,55
2014,Zenobia,F,100,55,0,55
2014,Zymir,M,100,0,55,55
2014,Aadi,M,100,0,54,54
2014,Alexys,F,100,54,0,54
2014,Andromeda,F,100,54,0,54
2014,Angeles,F,100,54,0,54
2014,Arriana,F,100,54,0,54
2014,Asael,M,100,0,54,54
2014,Ayomide,M,61,21,33,54
2014,Aziel,M,100,0,54,54
2014,Blane,M,100,0,54,54
2014,Boris,M,100,0,54,54
2014,Brison,M,100,0,54,54
2014,Constanza,F,100,54,0,54
2014,Croix,M,100,0,54,54
2014,Cypress,F,54,29,25,54
2014,Dayla,F,100,54,0,54
2014,Devontae,M,100,0,54,54
2014,Ellamae,F,100,54,0,54
2014,Elliotte,F,100,54,0,54
2014,Emaline,F,100,54,0,54
2014,Embry,F,72,39,15,54
2014,Evyn,F,78,42,12,54
2014,Hendrick,M,100,0,54,54
2014,Isra,F,100,54,0,54
2014,Jalil,M,100,0,54,54
2014,Jamichael,M,100,0,54,54
2014,Jamier,M,100,0,54,54
2014,Jarell,M,100,0,54,54
2014,Jayliana,F,100,54,0,54
2014,Jemima,F,100,54,0,54
2014,Kalie,F,100,54,0,54
2014,Karime,F,100,54,0,54
2014,Karon,M,100,0,54,54
2014,Katana,F,100,54,0,54
2014,Kaydee,F,100,54,0,54
2014,Kaylan,F,69,37,17,54
2014,Keilan,M,100,0,54,54
2014,Kellyn,F,80,43,11,54
2014,Kylynn,F,100,54,0,54
2014,Kynsley,F,100,54,0,54
2014,Kynzie,F,100,54,0,54
2014,Lavinia,F,100,54,0,54
2014,Leviticus,M,100,0,54,54
2014,Lyndsey,F,100,54,0,54
2014,Mahir,M,100,0,54,54
2014,Martez,M,100,0,54,54
2014,Maureen,F,100,54,0,54
2014,Mayer,M,100,0,54,54
2014,Minh,M,85,8,46,54
2014,Naeem,M,100,0,54,54
2014,Nihal,M,76,13,41,54
2014,Praise,F,69,37,17,54
2014,Rahma,F,100,54,0,54
2014,Railynn,F,100,54,0,54
2014,Rashaad,M,100,0,54,54
2014,Raylon,M,100,0,54,54
2014,Reef,M,100,0,54,54
2014,Reeve,M,76,13,41,54
2014,Roxie,F,100,54,0,54
2014,Siobhan,F,100,54,0,54
2014,Solana,F,100,54,0,54
2014,Stefano,M,100,0,54,54
2014,Taegan,F,70,38,16,54
2014,Theodor,M,100,0,54,54
2014,Tylin,M,87,7,47,54
2014,Zacharias,M,100,0,54,54
2014,Zakiya,F,100,54,0,54
2014,Zamya,F,100,54,0,54
2014,Zaylin,M,67,18,36,54
2014,Zuria,F,100,54,0,54
2014,Abelardo,M,100,0,53,53
2014,Aleczander,M,100,0,53,53
2014,Aleeza,F,100,53,0,53
2014,Alexandros,M,100,0,53,53
2014,Amaury,M,100,0,53,53
2014,Analicia,F,100,53,0,53
2014,Angeli,F,100,53,0,53
2014,Aren,M,100,0,53,53
2014,Asiah,F,60,32,21,53
2014,Becky,F,100,53,0,53
2014,Brailey,F,100,53,0,53
2014,Cadyn,M,64,19,34,53
2014,Caidyn,M,81,10,43,53
2014,Cambri,F,100,53,0,53
2014,Carlin,M,55,24,29,53
2014,Christianna,F,100,53,0,53
2014,Debra,F,100,53,0,53
2014,Dia,F,100,53,0,53
2014,Dinah,F,100,53,0,53
2014,Eshan,M,100,0,53,53
2014,Gene,M,100,0,53,53
2014,Giovonni,M,100,0,53,53
2014,Hanley,M,60,21,32,53
2014,Harlen,M,83,9,44,53
2014,Hawkins,M,100,0,53,53
2014,Iyonna,F,100,53,0,53
2014,Jaciel,M,100,0,53,53
2014,Janell,F,100,53,0,53
2014,Jashawn,M,100,0,53,53
2014,Jozie,F,100,53,0,53
2014,Khloie,F,100,53,0,53
2014,Levy,M,91,5,48,53
2014,Liesl,F,100,53,0,53
2014,Maddilynn,F,100,53,0,53
2014,Matheo,M,100,0,53,53
2014,Meira,F,100,53,0,53
2014,Montrell,M,100,0,53,53
2014,Neela,F,100,53,0,53
2014,Railyn,F,100,53,0,53
2014,Ranger,M,100,0,53,53
2014,Rayah,F,100,53,0,53
2014,Romelo,M,100,0,53,53
2014,Ryver,M,55,24,29,53
2014,Sapphira,F,100,53,0,53
2014,Sena,F,87,46,7,53
2014,Sirena,F,100,53,0,53
2014,Sunnie,F,100,53,0,53
2014,Tiernan,M,91,5,48,53
2014,Von,M,100,0,53,53
2014,Yuvraj,M,100,0,53,53
2014,Zada,F,100,53,0,53
2014,Zamora,F,100,53,0,53
2014,Zeppelin,M,79,11,42,53
2014,Abbigale,F,100,52,0,52
2014,Abdallah,M,100,0,52,52
2014,Adora,F,100,52,0,52
2014,Aine,F,100,52,0,52
2014,Aleeya,F,100,52,0,52
2014,Amaziah,M,83,9,43,52
2014,Amna,F,100,52,0,52
2014,Amyrah,F,100,52,0,52
2014,Andersen,M,75,13,39,52
2014,Artem,M,100,0,52,52
2014,Cashmere,M,54,24,28,52
2014,Catelyn,F,100,52,0,52
2014,Cavan,M,100,0,52,52
2014,Chantal,F,100,52,0,52
2014,Christen,F,60,31,21,52
2014,Darsh,M,100,0,52,52
2014,Demani,M,81,10,42,52
2014,Demetria,F,100,52,0,52
2014,Deontae,M,100,0,52,52
2014,Dru,F,50,26,26,52
2014,Emilynn,F,100,52,0,52
2014,Eoin,M,100,0,52,52
2014,Eyan,M,100,0,52,52
2014,Genessis,F,100,52,0,52
2014,Gisel,F,100,52,0,52
2014,Hadlie,F,100,52,0,52
2014,Harlyn,F,79,41,11,52
2014,Jakiyah,F,100,52,0,52
2014,Jarrod,M,100,0,52,52
2014,Javan,M,100,0,52,52
2014,Jayvien,M,100,0,52,52
2014,Jena,F,100,52,0,52
2014,Jill,F,100,52,0,52
2014,Josette,F,100,52,0,52
2014,Kaleo,M,100,0,52,52
2014,Kezia,F,100,52,0,52
2014,Koltin,M,100,0,52,52
2014,Leonora,F,100,52,0,52
2014,Lisandro,M,100,0,52,52
2014,Lundyn,F,100,52,0,52
2014,Mackayla,F,100,52,0,52
2014,Maeson,M,83,9,43,52
2014,Maple,F,100,52,0,52
2014,Marvel,F,54,28,24,52
2014,Mathieu,M,100,0,52,52
2014,Mordecai,M,100,0,52,52
2014,Nadiya,F,100,52,0,52
2014,Nana,M,62,20,32,52
2014,Nava,F,100,52,0,52
2014,Neely,F,100,52,0,52
2014,Niamh,F,100,52,0,52
2014,Niles,M,100,0,52,52
2014,Odette,F,100,52,0,52
2014,Orson,M,100,0,52,52
2014,Portia,F,100,52,0,52
2014,Reggie,M,100,0,52,52
2014,Renato,M,100,0,52,52
2014,Ryah,F,100,52,0,52
2014,Sanjana,F,100,52,0,52
2014,Stratton,M,100,0,52,52
2014,Surya,M,85,8,44,52
2014,Sydnie,F,100,52,0,52
2014,Tarik,M,100,0,52,52
2014,Tillie,F,100,52,0,52
2014,Torrance,M,73,14,38,52
2014,Trae,M,100,0,52,52
2014,Vesper,F,100,52,0,52
2014,Ziyad,M,100,0,52,52
2014,Adelie,F,100,51,0,51
2014,Adia,F,100,51,0,51
2014,Adlee,F,100,51,0,51
2014,Advay,M,100,0,51,51
2014,Aeden,M,100,0,51,51
2014,Alain,M,100,0,51,51
2014,Alen,M,100,0,51,51
2014,Arav,M,100,0,51,51
2014,Aulani,F,100,51,0,51
2014,Ayat,F,100,51,0,51
2014,Azariyah,F,100,51,0,51
2014,Aziah,F,61,31,20,51
2014,Bayley,F,90,46,5,51
2014,Bliss,F,100,51,0,51
2014,Bram,M,100,0,51,51
2014,Braylie,F,100,51,0,51
2014,Britany,F,100,51,0,51
2014,Calum,M,100,0,51,51
2014,Chaise,M,78,11,40,51
2014,Coco,F,100,51,0,51
2014,Coralyn,F,100,51,0,51
2014,Declyn,M,59,21,30,51
2014,Deondre,M,100,0,51,51
2014,Dezirae,F,100,51,0,51
2014,Emaleigh,F,100,51,0,51
2014,Emelie,F,100,51,0,51
2014,Emmelyn,F,100,51,0,51
2014,Empress,F,100,51,0,51
2014,Eugenia,F,100,51,0,51
2014,Francisca,F,100,51,0,51
2014,Geovani,M,100,0,51,51
2014,Grayce,F,100,51,0,51
2014,Haylen,F,88,45,6,51
2014,Hellen,F,100,51,0,51
2014,Holley,F,100,51,0,51
2014,Holt,M,100,0,51,51
2014,Illiana,F,100,51,0,51
2014,Jacy,F,80,41,10,51
2014,Jaylinn,F,100,51,0,51
2014,Jaythan,M,100,0,51,51
2014,Joell,M,100,0,51,51
2014,Jorja,F,100,51,0,51
2014,Jourdan,F,53,27,24,51
2014,Kailen,M,80,10,41,51
2014,Kamrin,M,86,7,44,51
2014,Karisma,F,100,51,0,51
2014,Kasandra,F,100,51,0,51
2014,Keisha,F,100,51,0,51
2014,Kelli,F,100,51,0,51
2014,Keyli,F,100,51,0,51
2014,Kiaan,M,100,0,51,51
2014,Leevi,M,100,0,51,51
2014,Luigi,M,100,0,51,51
2014,Lulu,F,100,51,0,51
2014,Macon,M,84,8,43,51
2014,Maddyn,F,100,51,0,51
2014,Malayna,F,100,51,0,51
2014,Mamadou,M,100,0,51,51
2014,Marisela,F,100,51,0,51
2014,Markayla,F,100,51,0,51
2014,Marty,M,90,5,46,51
2014,Mihir,M,100,0,51,51
2014,Miliana,F,100,51,0,51
2014,Naliyah,F,100,51,0,51
2014,Navi,F,76,39,12,51
2014,Nicola,F,65,33,18,51
2014,Owyn,M,90,5,46,51
2014,Polly,F,100,51,0,51
2014,Riggs,M,100,0,51,51
2014,Rodrick,M,100,0,51,51
2014,Sedona,F,100,51,0,51
2014,Silver,F,69,35,16,51
2014,Simcha,M,100,0,51,51
2014,Skylin,F,86,44,7,51
2014,Tamiyah,F,100,51,0,51
2014,Terri,F,100,51,0,51
2014,Thane,M,100,0,51,51
2014,Thayer,M,100,0,51,51
2014,Tommie,M,86,7,44,51
2014,Townes,M,100,0,51,51
2014,Trysten,M,90,5,46,51
2014,Tyasia,F,100,51,0,51
2014,Wilfredo,M,100,0,51,51
2014,Zena,F,100,51,0,51
2014,Abiel,M,100,0,50,50
2014,Adrielle,F,100,50,0,50
2014,Adyan,M,100,0,50,50
2014,Airam,F,80,40,10,50
2014,Alix,F,64,32,18,50
2014,Alynna,F,100,50,0,50
2014,Amaiya,F,100,50,0,50
2014,Anora,F,100,50,0,50
2014,Auburn,F,88,44,6,50
2014,Ayala,F,100,50,0,50
2014,Baruch,M,100,0,50,50
2014,Blayden,M,100,0,50,50
2014,Bralyn,M,74,13,37,50
2014,Bralynn,F,76,38,12,50
2014,Brithany,F,100,50,0,50
2014,Caia,F,100,50,0,50
2014,Carrigan,F,100,50,0,50
2014,Chloie,F,100,50,0,50
2014,Clarice,F,100,50,0,50
2014,Codi,F,72,36,14,50
2014,Daveon,M,100,0,50,50
2014,Davien,M,100,0,50,50
2014,Decklan,M,100,0,50,50
2014,Ebenezer,M,88,6,44,50
2014,Effie,F,100,50,0,50
2014,Elizabella,F,100,50,0,50
2014,Ellisyn,F,100,50,0,50
2014,Eriel,F,78,39,11,50
2014,Evelynne,F,100,50,0,50
2014,Greenlee,F,100,50,0,50
2014,Haydee,F,100,50,0,50
2014,Haydn,M,84,8,42,50
2014,Jadelyn,F,100,50,0,50
2014,Jaykob,M,100,0,50,50
2014,Jayshawn,M,100,0,50,50
2014,Kaleigha,F,100,50,0,50
2014,Kaycen,M,90,5,45,50
2014,Kenzy,F,100,50,0,50
2014,Khaleb,M,100,0,50,50
2014,Khaliyah,F,100,50,0,50
2014,Kip,M,100,0,50,50
2014,Laniah,F,100,50,0,50
2014,Leeah,F,100,50,0,50
2014,Loreal,F,100,50,0,50
2014,Matheus,M,100,0,50,50
2014,Miangel,F,100,50,0,50
2014,Nalayah,F,100,50,0,50
2014,Ozias,M,100,0,50,50
2014,Paxtyn,F,56,28,22,50
2014,Polina,F,100,50,0,50
2014,Prestyn,M,70,15,35,50
2014,Raghav,M,100,0,50,50
2014,Randolph,M,100,0,50,50
2014,Rosella,F,100,50,0,50
2014,Sammie,F,54,27,23,50
2014,Sicily,F,100,50,0,50
2014,Takoda,M,82,9,41,50
2014,Tamya,F,100,50,0,50
2014,Vaida,F,100,50,0,50
2014,Varun,M,100,0,50,50
2014,Waleed,M,100,0,50,50
2014,Zarek,M,100,0,50,50
2014,Zyanna,F,100,50,0,50
2014,Addy,F,100,49,0,49
2014,Adrina,F,100,49,0,49
2014,Advaith,M,100,0,49,49
2014,Ailin,F,100,49,0,49
2014,Alizae,F,100,49,0,49
2014,Alizah,F,100,49,0,49
2014,Allyssa,F,100,49,0,49
2014,Aman,M,100,0,49,49
2014,Amaryllis,F,100,49,0,49
2014,Arisha,F,100,49,0,49
2014,Atom,M,100,0,49,49
2014,Augusta,F,100,49,0,49
2014,Bayron,M,100,0,49,49
2014,Bentleigh,F,100,49,0,49
2014,Blakeley,F,100,49,0,49
2014,Blakelyn,F,100,49,0,49
2014,Breon,M,90,5,44,49
2014,Bronwyn,F,100,49,0,49
2014,Bushra,F,100,49,0,49
2014,Cambry,F,100,49,0,49
2014,Carlisle,M,71,14,35,49
2014,Ciera,F,100,49,0,49
2014,Delila,F,100,49,0,49
2014,Ethaniel,M,100,0,49,49
2014,Falyn,F,100,49,0,49
2014,Fares,M,100,0,49,49
2014,Haisley,F,100,49,0,49
2014,Hennessy,F,100,49,0,49
2014,Indira,F,100,49,0,49
2014,Janiel,M,100,0,49,49
2014,Jaxten,M,100,0,49,49
2014,Jaymes,M,100,0,49,49
2014,Jenavieve,F,100,49,0,49
2014,Jewels,F,100,49,0,49
2014,Jourdyn,F,84,41,8,49
2014,Juliann,F,86,42,7,49
2014,Julieth,F,100,49,0,49
2014,Kacy,F,86,42,7,49
2014,Kalin,M,63,18,31,49
2014,Kassie,F,100,49,0,49
2014,Kaycie,F,100,49,0,49
2014,Keyan,M,100,0,49,49
2014,Kolter,M,100,0,49,49
2014,Konstantinos,M,100,0,49,49
2014,Kristiana,F,100,49,0,49
2014,Kysen,M,100,0,49,49
2014,Leilanie,F,100,49,0,49
2014,Lipa,M,100,0,49,49
2014,Lynnlee,F,100,49,0,49
2014,Maleek,M,100,0,49,49
2014,Maliki,M,100,0,49,49
2014,Mathis,M,100,0,49,49
2014,Mei,F,100,49,0,49
2014,Mica,F,57,28,21,49
2014,Monika,F,100,49,0,49
2014,Nawal,F,100,49,0,49
2014,Nivea,F,100,49,0,49
2014,Nyle,M,100,0,49,49
2014,Orianna,F,100,49,0,49
2014,Rainey,F,90,44,5,49
2014,Raizel,F,100,49,0,49
2014,Rhianna,F,100,49,0,49
2014,Rosetta,F,100,49,0,49
2014,Rozlynn,F,100,49,0,49
2014,Saxon,M,90,5,44,49
2014,Shreyas,M,100,0,49,49
2014,Sima,F,100,49,0,49
2014,Soliana,F,100,49,0,49
2014,Taleen,F,100,49,0,49
2014,Tanisha,F,100,49,0,49
2014,Tierra,F,100,49,0,49
2014,Truitt,M,100,0,49,49
2014,Vaishnavi,F,100,49,0,49
2014,Ziggy,M,88,6,43,49
2014,Abdurrahman,M,100,0,48,48
2014,Abilene,F,100,48,0,48
2014,Addisen,F,100,48,0,48
2014,Adham,M,100,0,48,48
2014,Aerial,F,100,48,0,48
2014,Ameen,M,100,0,48,48
2014,Angelyn,F,100,48,0,48
2014,Anja,F,100,48,0,48
2014,Antoni,M,100,0,48,48
2014,Armon,M,100,0,48,48
2014,Ashtin,M,75,12,36,48
2014,Aslan,M,88,6,42,48
2014,Avry,F,67,32,16,48
2014,Beautiful,F,100,48,0,48
2014,Breccan,M,100,0,48,48
2014,Brelynn,F,100,48,0,48
2014,Brihanna,F,100,48,0,48
2014,Briseyda,F,100,48,0,48
2014,Brynne,F,100,48,0,48
2014,Brystal,F,100,48,0,48
2014,Cathy,F,100,48,0,48
2014,Daemon,M,100,0,48,48
2014,Darrel,M,100,0,48,48
2014,Dontrell,M,100,0,48,48
2014,Dylon,M,100,0,48,48
2014,Eivin,M,100,0,48,48
2014,Emori,F,83,40,8,48
2014,Emy,F,100,48,0,48
2014,Franky,M,100,0,48,48
2014,Gabby,F,100,48,0,48
2014,Gaby,F,100,48,0,48
2014,Haziel,M,100,0,48,48
2014,Honey,F,100,48,0,48
2014,Jacee,F,100,48,0,48
2014,Jaelah,F,100,48,0,48
2014,Jalia,F,100,48,0,48
2014,Javin,M,100,0,48,48
2014,Jaylanie,F,100,48,0,48
2014,Jeancarlo,M,100,0,48,48
2014,Jeremyah,M,100,0,48,48
2014,Julisa,F,100,48,0,48
2014,Katherin,F,100,48,0,48
2014,Kelley,F,81,39,9,48
2014,Kelson,M,100,0,48,48
2014,Khole,F,88,42,6,48
2014,Kierstyn,F,100,48,0,48
2014,Landrie,F,100,48,0,48
2014,Lou,M,56,21,27,48
2014,Makenzy,F,100,48,0,48
2014,Makhai,M,100,0,48,48
2014,Mavrick,M,100,0,48,48
2014,Maxen,M,100,0,48,48
2014,Michele,F,100,48,0,48
2014,Minnie,F,100,48,0,48
2014,Naisha,F,100,48,0,48
2014,Naythan,M,100,0,48,48
2014,Nirvana,F,100,48,0,48
2014,Paislie,F,100,48,0,48
2014,Pavel,M,100,0,48,48
2014,Perrin,M,69,15,33,48
2014,Queenie,F,100,48,0,48
2014,Raymundo,M,100,0,48,48
2014,Rikki,F,100,48,0,48
2014,Roosevelt,M,100,0,48,48
2014,Roya,F,100,48,0,48
2014,Ryken,M,100,0,48,48
2014,Ryne,M,100,0,48,48
2014,Salomon,M,100,0,48,48
2014,Saray,F,100,48,0,48
2014,Scotland,F,75,36,12,48
2014,Seneca,F,58,28,20,48
2014,Seren,F,100,48,0,48
2014,Sereniti,F,100,48,0,48
2014,Stockton,M,100,0,48,48
2014,Taylon,M,83,8,40,48
2014,Tayson,M,100,0,48,48
2014,Vander,M,100,0,48,48
2014,Viraj,M,100,0,48,48
2014,Winslow,F,60,29,19,48
2014,Wrigley,M,56,21,27,48
2014,Yelena,F,100,48,0,48
2014,Zakariah,M,81,9,39,48
2014,Ziyon,M,85,7,41,48
2014,Adaya,F,100,47,0,47
2014,Adisyn,F,100,47,0,47
2014,Aleida,F,100,47,0,47
2014,Amairani,F,100,47,0,47
2014,Amberlyn,F,100,47,0,47
2014,Amoni,F,83,39,8,47
2014,Arwa,F,100,47,0,47
2014,Bennie,M,85,7,40,47
2014,Bobbie,F,87,41,6,47
2014,Booker,M,100,0,47,47
2014,Brando,M,100,0,47,47
2014,Brinleigh,F,100,47,0,47
2014,Brionna,F,100,47,0,47
2014,Carmyn,F,100,47,0,47
2014,Chloey,F,100,47,0,47
2014,Chyanne,F,100,47,0,47
2014,Cortland,M,89,5,42,47
2014,Cutter,M,100,0,47,47
2014,Daila,F,100,47,0,47
2014,Deagan,M,100,0,47,47
2014,Deklin,M,100,0,47,47
2014,Denton,M,100,0,47,47
2014,Eesa,M,100,0,47,47
2014,Erich,M,100,0,47,47
2014,Eviana,F,100,47,0,47
2014,Geovany,M,100,0,47,47
2014,Gio,M,100,0,47,47
2014,Gissel,F,100,47,0,47
2014,Grettel,F,100,47,0,47
2014,Hanson,M,100,0,47,47
2014,Hubert,M,100,0,47,47
2014,Hudsyn,M,53,22,25,47
2014,Jaelin,M,55,21,26,47
2014,Jahaziel,M,100,0,47,47
2014,Jameer,M,100,0,47,47
2014,Jansen,M,87,6,41,47
2014,Javonte,M,100,0,47,47
2014,Jayceion,M,100,0,47,47
2014,Jaydah,F,100,47,0,47
2014,Jensyn,F,70,33,14,47
2014,Joao,M,100,0,47,47
2014,Jolynn,F,100,47,0,47
2014,Kaela,F,100,47,0,47
2014,Kamia,F,100,47,0,47
2014,Kassidi,F,100,47,0,47
2014,Kelan,M,100,0,47,47
2014,Khylie,F,100,47,0,47
2014,Kruze,M,100,0,47,47
2014,Lanna,F,100,47,0,47
2014,Lariyah,F,100,47,0,47
2014,Loghan,F,55,26,21,47
2014,Luana,F,100,47,0,47
2014,Maddyson,F,100,47,0,47
2014,Maris,F,100,47,0,47
2014,Marius,M,100,0,47,47
2014,Mayleigh,F,100,47,0,47
2014,Mehki,M,100,0,47,47
2014,Morrigan,F,100,47,0,47
2014,Musab,M,100,0,47,47
2014,Nashla,F,100,47,0,47
2014,Neko,M,70,14,33,47
2014,Nicolle,F,100,47,0,47
2014,Nikolaus,M,100,0,47,47
2014,Novella,F,100,47,0,47
2014,Oaklyn,F,81,38,9,47
2014,Orrin,M,100,0,47,47
2014,Pandora,F,100,47,0,47
2014,Perseus,M,100,0,47,47
2014,Raziel,M,100,0,47,47
2014,Reaghan,F,100,47,0,47
2014,Romel,M,100,0,47,47
2014,Roslynn,F,100,47,0,47
2014,Rudolph,M,100,0,47,47
2014,Rustin,M,100,0,47,47
2014,Samarah,F,100,47,0,47
2014,Stefanie,F,100,47,0,47
2014,Taven,M,100,0,47,47
2014,Teague,M,100,0,47,47
2014,Tinleigh,F,100,47,0,47
2014,Tracey,F,83,39,8,47
2014,Truly,F,100,47,0,47
2014,Witten,M,100,0,47,47
2014,Wolf,M,100,0,47,47
2014,Yazmine,F,100,47,0,47
2014,Yohanna,F,100,47,0,47
2014,Yoselyn,F,100,47,0,47
2014,Zahraa,F,100,47,0,47
2014,Zailey,F,100,47,0,47
2014,Zaliyah,F,100,47,0,47
2014,Aarnav,M,100,0,46,46
2014,Aashi,F,100,46,0,46
2014,Adryan,M,100,0,46,46
2014,Ajani,M,85,7,39,46
2014,Alaska,F,100,46,0,46
2014,Alecia,F,100,46,0,46
2014,Alizabeth,F,100,46,0,46
2014,Alysha,F,100,46,0,46
2014,Amberlee,F,100,46,0,46
2014,Ambrielle,F,100,46,0,46
2014,Amire,M,87,6,40,46
2014,Anari,F,100,46,0,46
2014,Anyah,F,100,46,0,46
2014,Arantxa,F,100,46,0,46
2014,Archibald,M,100,0,46,46
2014,Arlie,F,63,29,17,46
2014,Aryia,F,100,46,0,46
2014,Ashlin,F,100,46,0,46
2014,Aurianna,F,100,46,0,46
2014,Avielle,F,100,46,0,46
2014,Ayda,F,100,46,0,46
2014,Becca,F,100,46,0,46
2014,Bill,M,100,0,46,46
2014,Breyden,M,100,0,46,46
2014,Briza,F,100,46,0,46
2014,Brodi,M,85,7,39,46
2014,Bryon,M,100,0,46,46
2014,Caison,M,100,0,46,46
2014,Caleah,F,100,46,0,46
2014,Calin,M,89,5,41,46
2014,Camelia,F,100,46,0,46
2014,Caris,F,100,46,0,46
2014,Casyn,M,74,12,34,46
2014,Cherry,F,100,46,0,46
2014,Cj,M,100,0,46,46
2014,Danthony,M,100,0,46,46
2014,Dawsyn,F,70,32,14,46
2014,Daysha,F,100,46,0,46
2014,Delano,M,100,0,46,46
2014,Eshaan,M,100,0,46,46
2014,Evey,F,100,46,0,46
2014,Gracin,M,76,11,35,46
2014,Gretta,F,100,46,0,46
2014,Haris,M,100,0,46,46
2014,Jacky,M,83,8,38,46
2014,Jadelynn,F,100,46,0,46
2014,Jaidan,M,89,5,41,46
2014,Janya,F,100,46,0,46
2014,Jasiyah,F,78,36,10,46
2014,Jermani,F,83,38,8,46
2014,Jerrick,M,100,0,46,46
2014,Jesslynn,F,100,46,0,46
2014,Johnluke,M,100,0,46,46
2014,Josiyah,M,100,0,46,46
2014,Julietta,F,100,46,0,46
2014,Kahlia,F,100,46,0,46
2014,Kaito,M,100,0,46,46
2014,Kayce,F,70,32,14,46
2014,Kaylea,F,100,46,0,46
2014,Kenslie,F,100,46,0,46
2014,Kynlie,F,100,46,0,46
2014,Lavender,F,100,46,0,46
2014,Lavon,M,100,0,46,46
2014,Leobardo,M,100,0,46,46
2014,Leya,F,100,46,0,46
2014,Maeleigh,F,100,46,0,46
2014,Maeva,F,100,46,0,46
2014,Mckenzi,F,100,46,0,46
2014,Mikail,M,100,0,46,46
2014,Minerva,F,100,46,0,46
2014,Myiah,F,100,46,0,46
2014,Mykayla,F,100,46,0,46
2014,Nayely,F,100,46,0,46
2014,Neftali,M,89,5,41,46
2014,October,F,100,46,0,46
2014,Odalys,F,100,46,0,46
2014,Quran,M,100,0,46,46
2014,Rahaf,F,100,46,0,46
2014,Reema,F,100,46,0,46
2014,Roma,F,89,41,5,46
2014,Roshan,M,100,0,46,46
2014,Sahar,F,100,46,0,46
2014,Sahir,M,100,0,46,46
2014,Sania,F,100,46,0,46
2014,Shaylin,F,100,46,0,46
2014,Shelly,F,100,46,0,46
2014,Solara,F,100,46,0,46
2014,Stewart,M,100,0,46,46
2014,Talitha,F,100,46,0,46
2014,Trevion,M,100,0,46,46
2014,Xitlaly,F,100,46,0,46
2014,Yanelis,F,100,46,0,46
2014,Yasmina,F,100,46,0,46
2014,Zacchaeus,M,100,0,46,46
2014,Zak,M,100,0,46,46
2014,Zamira,F,100,46,0,46
2014,Zaydin,M,100,0,46,46
2014,Zaylie,F,100,46,0,46
2014,Zyir,M,100,0,46,46
2014,Abhiram,M,100,0,45,45
2014,Abigael,F,100,45,0,45
2014,Abisai,M,71,13,32,45
2014,Able,M,100,0,45,45
2014,Adem,M,100,0,45,45
2014,Alaysha,F,100,45,0,45
2014,Aleksandar,M,100,0,45,45
2014,Angelika,F,100,45,0,45
2014,Arlyn,F,78,35,10,45
2014,Aundrea,F,100,45,0,45
2014,Bayne,M,100,0,45,45
2014,Bennet,M,100,0,45,45
2014,Braydan,M,100,0,45,45
2014,Braydin,M,100,0,45,45
2014,Brylen,M,100,0,45,45
2014,Brynnley,F,100,45,0,45
2014,Calie,F,100,45,0,45
2014,Calix,M,100,0,45,45
2014,Cattaleya,F,100,45,0,45
2014,Chet,M,100,0,45,45
2014,Chrissy,F,100,45,0,45
2014,Conan,M,100,0,45,45
2014,Cornell,M,100,0,45,45
2014,Darya,F,100,45,0,45
2014,Delani,F,100,45,0,45
2014,Deonna,F,100,45,0,45
2014,Dequan,M,100,0,45,45
2014,Donavon,M,100,0,45,45
2014,Eastin,M,100,0,45,45
2014,Elder,M,100,0,45,45
2014,Elisheva,F,100,45,0,45
2014,Eloisa,F,100,45,0,45
2014,Emmylou,F,100,45,0,45
2014,Emorie,F,100,45,0,45
2014,Enya,F,100,45,0,45
2014,Evans,M,87,6,39,45
2014,Gryffin,M,100,0,45,45
2014,Gurnoor,F,69,31,14,45
2014,Helaina,F,100,45,0,45
2014,Jaceion,M,100,0,45,45
2014,Jaleigh,F,100,45,0,45
2014,Jarren,M,100,0,45,45
2014,Jasir,M,100,0,45,45
2014,Jaylie,F,100,45,0,45
2014,Jaymie,F,82,37,8,45
2014,Jeslyn,F,100,45,0,45
2014,Jizelle,F,100,45,0,45
2014,Jomar,M,100,0,45,45
2014,Kadynce,F,100,45,0,45
2014,Kalliope,F,100,45,0,45
2014,Kamaria,F,100,45,0,45
2014,Kavon,M,100,0,45,45
2014,Keiran,M,80,9,36,45
2014,Keyonna,F,100,45,0,45
2014,Kilee,F,100,45,0,45
2014,Kodie,F,62,28,17,45
2014,Kolbi,F,80,36,9,45
2014,Kyaire,M,100,0,45,45
2014,Kyzer,M,100,0,45,45
2014,Lacee,F,100,45,0,45
2014,Lamarcus,M,100,0,45,45
2014,Mackenzi,F,100,45,0,45
2014,Makaylee,F,100,45,0,45
2014,Mena,F,89,40,5,45
2014,Merlin,M,73,12,33,45
2014,Montez,M,100,0,45,45
2014,Nabil,M,100,0,45,45
2014,Natan,M,100,0,45,45
2014,Nayelli,F,100,45,0,45
2014,Nithya,F,100,45,0,45
2014,Nitya,F,100,45,0,45
2014,Niylah,F,100,45,0,45
2014,Norberto,M,100,0,45,45
2014,Oluwadarasimi,F,64,29,16,45
2014,Phoenyx,F,76,34,11,45
2014,Price,M,100,0,45,45
2014,Rawan,F,100,45,0,45
2014,Rosy,F,100,45,0,45
2014,Sachin,M,100,0,45,45
2014,Salim,M,100,0,45,45
2014,Sanya,F,100,45,0,45
2014,Sianna,F,100,45,0,45
2014,Suzette,F,100,45,0,45
2014,Tavon,M,100,0,45,45
2014,Tejas,M,100,0,45,45
2014,Toryn,M,62,17,28,45
2014,Trinitee,F,100,45,0,45
2014,Una,F,100,45,0,45
2014,Xzander,M,100,0,45,45
2014,Zaara,F,100,45,0,45
2014,Zaylah,F,100,45,0,45
2014,Ziyah,F,89,40,5,45
2014,Zophia,F,100,45,0,45
2014,Abrar,F,66,29,15,44
2014,Abubakar,M,100,0,44,44
2014,Adelyne,F,100,44,0,44
2014,Ailey,F,100,44,0,44
2014,Alaura,F,100,44,0,44
2014,Alder,M,100,0,44,44
2014,Amaan,M,100,0,44,44
2014,Amado,M,100,0,44,44
2014,Annalia,F,100,44,0,44
2014,Arlin,M,55,20,24,44
2014,Avyanna,F,100,44,0,44
2014,Aziz,M,100,0,44,44
2014,Azra,F,100,44,0,44
2014,Beth,F,100,44,0,44
2014,Brendyn,M,100,0,44,44
2014,Bret,M,100,0,44,44
2014,Charlette,F,100,44,0,44
2014,Cyril,M,100,0,44,44
2014,Dajuan,M,100,0,44,44
2014,Deena,F,100,44,0,44
2014,Demir,M,100,0,44,44
2014,Demitri,M,100,0,44,44
2014,Dena,F,100,44,0,44
2014,Devany,F,100,44,0,44
2014,Eren,M,100,0,44,44
2014,Frederic,M,100,0,44,44
2014,Freedom,F,66,29,15,44
2014,Gennesis,F,100,44,0,44
2014,Habiba,F,100,44,0,44
2014,Hatcher,M,100,0,44,44
2014,Hilda,F,100,44,0,44
2014,Isacc,M,100,0,44,44
2014,Jacorey,M,100,0,44,44
2014,Jahsiah,M,100,0,44,44
2014,Jayana,F,100,44,0,44
2014,Jayvin,M,100,0,44,44
2014,Johannes,M,100,0,44,44
2014,Jorel,M,100,0,44,44
2014,Jory,M,59,18,26,44
2014,Kallan,M,100,0,44,44
2014,Kamal,M,100,0,44,44
2014,Karyme,F,100,44,0,44
2014,Khushi,F,100,44,0,44
2014,Kimberlynn,F,100,44,0,44
2014,Kullen,M,100,0,44,44
2014,Liem,M,100,0,44,44
2014,Makaela,F,100,44,0,44
2014,Marcia,F,100,44,0,44
2014,Marquan,M,100,0,44,44
2014,Maryanne,F,100,44,0,44
2014,Mckynzie,F,100,44,0,44
2014,Mercer,M,64,16,28,44
2014,Mervin,M,100,0,44,44
2014,Nalah,F,100,44,0,44
2014,Nevan,M,100,0,44,44
2014,Nidhi,F,100,44,0,44
2014,Ofelia,F,100,44,0,44
2014,Pari,F,100,44,0,44
2014,Parks,M,100,0,44,44
2014,Raelynne,F,100,44,0,44
2014,Rasheed,M,100,0,44,44
2014,Rashid,M,100,0,44,44
2014,Rayanna,F,100,44,0,44
2014,Rhema,F,100,44,0,44
2014,Rhythm,M,61,17,27,44
2014,Saron,F,100,44,0,44
2014,Shanell,F,100,44,0,44
2014,Shelbie,F,100,44,0,44
2014,Shemar,M,100,0,44,44
2014,Skai,F,86,38,6,44
2014,Soham,M,100,0,44,44
2014,Sohan,M,100,0,44,44
2014,Sunshine,F,100,44,0,44
2014,Tahir,M,100,0,44,44
2014,Talayah,F,100,44,0,44
2014,Taylyn,F,100,44,0,44
2014,Venice,F,100,44,0,44
2014,Yitzchak,M,100,0,44,44
2014,Zaila,F,100,44,0,44
2014,Zaki,M,100,0,44,44
2014,Zayleigh,F,100,44,0,44
2014,Zeynep,F,100,44,0,44
2014,Zyra,F,100,44,0,44
2014,Aarushi,F,100,43,0,43
2014,Acadia,F,100,43,0,43
2014,Adalene,F,100,43,0,43
2014,Ahaan,M,100,0,43,43
2014,Aizah,F,100,43,0,43
2014,Akram,M,100,0,43,43
2014,Alpha,M,100,0,43,43
2014,Alyah,F,100,43,0,43
2014,Amour,F,81,35,8,43
2014,Andraya,F,100,43,0,43
2014,Annalie,F,100,43,0,43
2014,Aramis,M,88,5,38,43
2014,Ashby,F,60,26,17,43
2014,Avin,M,100,0,43,43
2014,Avionna,F,100,43,0,43
2014,Benji,M,100,0,43,43
2014,Berklee,F,100,43,0,43
2014,Blima,F,100,43,0,43
2014,Caraline,F,100,43,0,43
2014,Chrisette,F,100,43,0,43
2014,Ciel,F,53,23,20,43
2014,Corvin,M,100,0,43,43
2014,Damiya,F,100,43,0,43
2014,Darrien,M,100,0,43,43
2014,Delany,F,100,43,0,43
2014,Deron,M,100,0,43,43
2014,Dimitrios,M,100,0,43,43
2014,Ekam,M,67,14,29,43
2014,Elio,M,100,0,43,43
2014,Elva,F,100,43,0,43
2014,Elyn,F,100,43,0,43
2014,Eman,F,100,43,0,43
2014,Erynn,F,100,43,0,43
2014,Eugenio,M,100,0,43,43
2014,Everlie,F,100,43,0,43
2014,Fausto,M,100,0,43,43
2014,Graeson,M,100,0,43,43
2014,Haily,F,100,43,0,43
2014,Hamzah,M,100,0,43,43
2014,Ina,F,100,43,0,43
2014,Ishika,F,100,43,0,43
2014,Jaliah,F,100,43,0,43
2014,Janey,F,100,43,0,43
2014,Japheth,M,100,0,43,43
2014,Jarek,M,100,0,43,43
2014,Jayonna,F,100,43,0,43
2014,Jeriel,M,100,0,43,43
2014,Jevon,M,100,0,43,43
2014,Joleen,F,100,43,0,43
2014,Jozlyn,F,100,43,0,43
2014,Kacper,M,100,0,43,43
2014,Kandice,F,100,43,0,43
2014,Kayliana,F,100,43,0,43
2014,Khayden,M,100,0,43,43
2014,Knight,M,100,0,43,43
2014,Kylon,M,100,0,43,43
2014,Lainee,F,100,43,0,43
2014,Lamarion,M,100,0,43,43
2014,Laramie,M,51,21,22,43
2014,Larson,M,88,5,38,43
2014,Leiah,F,100,43,0,43
2014,Leiana,F,100,43,0,43
2014,Leonna,F,100,43,0,43
2014,Londen,F,72,31,12,43
2014,Lucus,M,100,0,43,43
2014,Lumen,F,84,36,7,43
2014,Lysander,M,100,0,43,43
2014,Lyza,F,100,43,0,43
2014,Madelynne,F,100,43,0,43
2014,Mailen,F,100,43,0,43
2014,Maisey,F,100,43,0,43
2014,Maja,F,100,43,0,43
2014,Malorie,F,100,43,0,43
2014,Maribelle,F,100,43,0,43
2014,Marly,F,100,43,0,43
2014,Marquel,M,100,0,43,43
2014,Melodi,F,100,43,0,43
2014,Nasser,M,100,0,43,43
2014,Octavius,M,100,0,43,43
2014,Payslee,F,100,43,0,43
2014,Raena,F,100,43,0,43
2014,Rani,F,67,29,14,43
2014,Ranveer,M,100,0,43,43
2014,Rashard,M,100,0,43,43
2014,Rayce,M,100,0,43,43
2014,Raylene,F,100,43,0,43
2014,Rylinn,F,100,43,0,43
2014,Saniah,F,100,43,0,43
2014,Saraya,F,100,43,0,43
2014,Shivani,F,100,43,0,43
2014,Sholom,M,100,0,43,43
2014,Syler,M,100,0,43,43
2014,Tailyn,F,100,43,0,43
2014,Talin,M,86,6,37,43
2014,Tamari,F,72,31,12,43
2014,Taylan,M,67,14,29,43
2014,Tidus,M,100,0,43,43
2014,Timmy,M,100,0,43,43
2014,Vittoria,F,100,43,0,43
2014,Yulianna,F,100,43,0,43
2014,Zayah,F,100,43,0,43
2014,Ziah,F,84,36,7,43
2014,Ziya,F,100,43,0,43
2014,Adian,M,100,0,42,42
2014,Airabella,F,100,42,0,42
2014,Alahna,F,100,42,0,42
2014,Aleina,F,100,42,0,42
2014,Allister,M,86,6,36,42
2014,Amaiyah,F,100,42,0,42
2014,Ameir,M,100,0,42,42
2014,Amery,F,88,37,5,42
2014,Amory,F,60,25,17,42
2014,Amzie,F,100,42,0,42
2014,Arieanna,F,100,42,0,42
2014,Arron,M,100,0,42,42
2014,Avyan,M,100,0,42,42
2014,Bellarose,F,100,42,0,42
2014,Brexton,M,100,0,42,42
2014,Caedmon,M,100,0,42,42
2014,Camdon,M,100,0,42,42
2014,Camrynn,F,88,37,5,42
2014,Cing,F,100,42,0,42
2014,Claude,M,100,0,42,42
2014,Coralynn,F,100,42,0,42
2014,Corin,M,62,16,26,42
2014,Cross,M,100,0,42,42
2014,Cyan,F,81,34,8,42
2014,Dalis,F,100,42,0,42
2014,Dariyah,F,100,42,0,42
2014,Dasani,F,71,30,12,42
2014,December,F,100,42,0,42
2014,Dolores,F,100,42,0,42
2014,Draco,M,100,0,42,42
2014,Easten,M,100,0,42,42
2014,Evanna,F,100,42,0,42
2014,Evren,M,100,0,42,42
2014,Finlay,M,81,8,34,42
2014,Franchesca,F,100,42,0,42
2014,Gabriele,M,55,19,23,42
2014,Graceyn,F,100,42,0,42
2014,Haileigh,F,100,42,0,42
2014,Iden,M,100,0,42,42
2014,Ilya,M,74,11,31,42
2014,Imari,F,52,22,20,42
2014,Ivanka,F,100,42,0,42
2014,Jaedon,M,100,0,42,42
2014,Jaicee,F,100,42,0,42
2014,Jarod,M,100,0,42,42
2014,Jayci,F,100,42,0,42
2014,Jenicka,F,100,42,0,42
2014,Jonny,M,100,0,42,42
2014,Joscelyn,F,100,42,0,42
2014,Justyn,M,100,0,42,42
2014,Kaizen,M,100,0,42,42
2014,Kalee,F,100,42,0,42
2014,Kamar,M,100,0,42,42
2014,Kamea,F,100,42,0,42
2014,Keagen,M,100,0,42,42
2014,Kenlie,F,100,42,0,42
2014,Keya,F,100,42,0,42
2014,Kiarra,F,100,42,0,42
2014,Lenna,F,100,42,0,42
2014,Lino,M,100,0,42,42
2014,Logen,M,83,7,35,42
2014,Lyllian,F,100,42,0,42
2014,Marleny,F,100,42,0,42
2014,Michaelangelo,M,100,0,42,42
2014,Nolyn,M,88,5,37,42
2014,Ori,M,79,9,33,42
2014,Primrose,F,100,42,0,42
2014,Ramiyah,F,100,42,0,42
2014,Remmington,M,57,18,24,42
2014,Rhiley,F,71,30,12,42
2014,Rusty,M,100,0,42,42
2014,Rylyn,F,64,27,15,42
2014,Saleen,F,100,42,0,42
2014,Sampson,M,100,0,42,42
2014,Sheridan,F,86,36,6,42
2014,Skylan,F,55,23,19,42
2014,Stiles,M,100,0,42,42
2014,Subhan,M,100,0,42,42
2014,Thang,M,83,7,35,42
2014,Theseus,M,100,0,42,42
2014,Tova,F,100,42,0,42
2014,Trinidad,M,60,17,25,42
2014,Tuff,M,100,0,42,42
2014,Tyran,M,100,0,42,42
2014,Tyrin,M,100,0,42,42
2014,Uriyah,M,83,7,35,42
2014,Vianna,F,100,42,0,42
2014,Viggo,M,100,0,42,42
2014,Violett,F,100,42,0,42
2014,Xavien,M,100,0,42,42
2014,Xavior,M,100,0,42,42
2014,Xayden,M,100,0,42,42
2014,Yazaira,F,100,42,0,42
2014,Yeray,M,100,0,42,42
2014,Yohana,F,100,42,0,42
2014,Yurem,M,100,0,42,42
2014,Zoha,F,100,42,0,42
2014,Zori,F,100,42,0,42
2014,Aayla,F,100,41,0,41
2014,Acelyn,F,88,36,5,41
2014,Adalena,F,100,41,0,41
2014,Aeson,M,100,0,41,41
2014,Agastya,M,100,0,41,41
2014,Aisling,F,100,41,0,41
2014,Akemi,F,100,41,0,41
2014,Aleia,F,100,41,0,41
2014,Alizay,F,100,41,0,41
2014,Amadou,M,100,0,41,41
2014,Ames,M,100,0,41,41
2014,Amillia,F,100,41,0,41
2014,Analiese,F,100,41,0,41
2014,Andria,F,100,41,0,41
2014,Armand,M,100,0,41,41
2014,Ashlynne,F,100,41,0,41
2014,Aurielle,F,100,41,0,41
2014,Autum,F,100,41,0,41
2014,Avari,F,100,41,0,41
2014,Bela,F,88,36,5,41
2014,Birdie,F,100,41,0,41
2014,Bradleigh,F,100,41,0,41
2014,Braidyn,M,100,0,41,41
2014,Brecklyn,F,100,41,0,41
2014,Brenlee,F,100,41,0,41
2014,Camiyah,F,100,41,0,41
2014,Celena,F,100,41,0,41
2014,Chany,F,100,41,0,41
2014,Christofer,M,100,0,41,41
2014,Christos,M,100,0,41,41
2014,Clement,M,100,0,41,41
2014,Dashaun,M,100,0,41,41
2014,Denny,M,100,0,41,41
2014,Donny,M,100,0,41,41
2014,Ellyanna,F,100,41,0,41
2014,Esau,M,100,0,41,41
2014,Ezekial,M,100,0,41,41
2014,Fenix,M,85,6,35,41
2014,Fermin,M,100,0,41,41
2014,Ferris,M,100,0,41,41
2014,Gala,F,100,41,0,41
2014,Gamaliel,M,100,0,41,41
2014,Gisella,F,100,41,0,41
2014,Halley,F,100,41,0,41
2014,Jaeceon,M,100,0,41,41
2014,Jameis,M,100,0,41,41
2014,Jamin,M,100,0,41,41
2014,Jazlin,F,100,41,0,41
2014,Jiana,F,100,41,0,41
2014,Jin,M,85,6,35,41
2014,Joie,F,100,41,0,41
2014,Joslin,F,100,41,0,41
2014,Joyanna,F,100,41,0,41
2014,Kalleigh,F,100,41,0,41
2014,Kambry,F,100,41,0,41
2014,Kamyah,F,100,41,0,41
2014,Karlos,M,100,0,41,41
2014,Kashmir,F,54,22,19,41
2014,Keasia,F,100,41,0,41
2014,Keelyn,F,78,32,9,41
2014,Kennedie,F,100,41,0,41
2014,Khyler,M,85,6,35,41
2014,Kroy,M,100,0,41,41
2014,Lanae,F,100,41,0,41
2014,Lizzy,F,100,41,0,41
2014,Madaline,F,100,41,0,41
2014,Maegan,F,100,41,0,41
2014,Mailyn,F,100,41,0,41
2014,Manning,M,85,6,35,41
2014,Maribella,F,100,41,0,41
2014,Mateus,M,100,0,41,41
2014,Medina,F,100,41,0,41
2014,Meena,F,100,41,0,41
2014,Miko,M,73,11,30,41
2014,Mirella,F,100,41,0,41
2014,Monty,M,100,0,41,41
2014,Naim,M,100,0,41,41
2014,Nell,F,100,41,0,41
2014,Nery,M,85,6,35,41
2014,Neyland,M,100,0,41,41
2014,Nicky,F,63,26,15,41
2014,Pace,M,100,0,41,41
2014,Raj,M,100,0,41,41
2014,Rashaun,M,100,0,41,41
2014,Rhylie,F,100,41,0,41
2014,Riggin,M,100,0,41,41
2014,Rigo,M,100,0,41,41
2014,Safwan,M,100,0,41,41
2014,Shawna,F,100,41,0,41
2014,Shekinah,F,100,41,0,41
2014,Solange,F,100,41,0,41
2014,Sonora,F,100,41,0,41
2014,Sumayyah,F,100,41,0,41
2014,Sunday,F,100,41,0,41
2014,Syriah,F,100,41,0,41
2014,Tahari,F,73,30,11,41
2014,Tali,F,100,41,0,41
2014,Tamim,M,100,0,41,41
2014,Tennessee,F,56,23,18,41
2014,Theia,F,100,41,0,41
2014,Tyana,F,100,41,0,41
2014,Xylia,F,100,41,0,41
2014,Yasser,M,100,0,41,41
2014,Yatziry,F,100,41,0,41
2014,Aaditya,M,100,0,40,40
2014,Aalyiah,F,100,40,0,40
2014,Aashvi,F,100,40,0,40
2014,Abrahm,M,100,0,40,40
2014,Akshay,M,100,0,40,40
2014,Akshaya,F,100,40,0,40
2014,Alinna,F,100,40,0,40
2014,Amadeus,M,100,0,40,40
2014,Amena,F,100,40,0,40
2014,Amera,F,100,40,0,40
2014,Ammy,F,100,40,0,40
2014,Anilah,F,100,40,0,40
2014,Anjel,M,85,6,34,40
2014,Arjen,M,100,0,40,40
2014,Arlet,F,100,40,0,40
2014,Atlee,F,55,22,18,40
2014,Bray,M,100,0,40,40
2014,Breasia,F,100,40,0,40
2014,Brianny,F,100,40,0,40
2014,Buck,M,100,0,40,40
2014,Calia,F,100,40,0,40
2014,Cayleb,M,100,0,40,40
2014,Chidera,F,70,28,12,40
2014,Coda,M,88,5,35,40
2014,Cortney,M,55,18,22,40
2014,Corwin,M,100,0,40,40
2014,Courtland,M,100,0,40,40
2014,Cylis,M,100,0,40,40
2014,Damen,M,100,0,40,40
2014,Dameon,M,100,0,40,40
2014,Damia,F,100,40,0,40
2014,Decklyn,M,62,15,25,40
2014,Demonte,M,100,0,40,40
2014,Eleana,F,100,40,0,40
2014,Ellory,F,100,40,0,40
2014,Elyanna,F,100,40,0,40
2014,Erielle,F,100,40,0,40
2014,Evianna,F,100,40,0,40
2014,Fannie,F,100,40,0,40
2014,Gaius,M,100,0,40,40
2014,Gavino,M,100,0,40,40
2014,Georgie,F,88,35,5,40
2014,Gibran,M,100,0,40,40
2014,Gisela,F,100,40,0,40
2014,Hadrian,M,100,0,40,40
2014,Harlowe,F,100,40,0,40
2014,Harlynn,F,100,40,0,40
2014,Hershel,M,100,0,40,40
2014,Horace,M,100,0,40,40
2014,Ignatius,M,100,0,40,40
2014,Ilene,F,100,40,0,40
2014,Ilse,F,100,40,0,40
2014,Iver,M,100,0,40,40
2014,Jalon,M,100,0,40,40
2014,Jceon,M,100,0,40,40
2014,Jesenia,F,100,40,0,40
2014,Joleigh,F,100,40,0,40
2014,Josalyn,F,100,40,0,40
2014,Kaely,F,100,40,0,40
2014,Kaisyn,M,80,8,32,40
2014,Kam,M,100,0,40,40
2014,Kamara,F,100,40,0,40
2014,Kamauri,M,70,12,28,40
2014,Karaline,F,100,40,0,40
2014,Katelin,F,100,40,0,40
2014,Kavion,M,100,0,40,40
2014,Keeva,F,100,40,0,40
2014,Keilah,F,100,40,0,40
2014,Keisy,F,100,40,0,40
2014,Kendon,M,100,0,40,40
2014,Kenly,F,100,40,0,40
2014,Keri,F,100,40,0,40
2014,Keturah,F,100,40,0,40
2014,Kiarah,F,100,40,0,40
2014,Kristal,F,100,40,0,40
2014,Kyndle,F,85,34,6,40
2014,Kynley,F,100,40,0,40
2014,Leiland,M,100,0,40,40
2014,Liev,M,100,0,40,40
2014,Makaio,M,100,0,40,40
2014,Makari,M,88,5,35,40
2014,Malin,F,100,40,0,40
2014,Mckenzy,F,100,40,0,40
2014,Meela,F,100,40,0,40
2014,Miraya,F,100,40,0,40
2014,Mischa,F,100,40,0,40
2014,Murray,M,100,0,40,40
2014,Queena,F,100,40,0,40
2014,Raigan,F,100,40,0,40
2014,Ramir,M,100,0,40,40
2014,Rayland,M,100,0,40,40
2014,Rayvon,M,100,0,40,40
2014,Rhoda,F,100,40,0,40
2014,Rosaleigh,F,100,40,0,40
2014,Rye,M,78,9,31,40
2014,Rylann,F,78,31,9,40
2014,Senna,F,100,40,0,40
2014,Skyleigh,F,100,40,0,40
2014,Stefania,F,100,40,0,40
2014,Suleiman,M,100,0,40,40
2014,Tylar,F,62,25,15,40
2014,Zaryah,F,100,40,0,40
2014,Zeina,F,100,40,0,40
2014,Zuleika,F,100,40,0,40
2014,Aalia,F,100,39,0,39
2014,Abhay,M,100,0,39,39
2014,Adalyne,F,100,39,0,39
2014,Aedyn,M,85,6,33,39
2014,Ahtziri,F,100,39,0,39
2014,Alanie,F,100,39,0,39
2014,Annsley,F,100,39,0,39
2014,Arhaan,M,100,0,39,39
2014,Arnulfo,M,100,0,39,39
2014,Atharva,M,100,0,39,39
2014,Avyn,F,69,27,12,39
2014,Azaleah,F,100,39,0,39
2014,Azlan,M,100,0,39,39
2014,Azure,M,51,19,20,39
2014,Blakeleigh,F,100,39,0,39
2014,Braydyn,M,100,0,39,39
2014,Breana,F,100,39,0,39
2014,Carolynn,F,100,39,0,39
2014,Cincere,M,85,6,33,39
2014,Clancy,M,79,8,31,39
2014,Damarius,M,100,0,39,39
2014,Debbie,F,100,39,0,39
2014,Deen,M,100,0,39,39
2014,Edgardo,M,100,0,39,39
2014,Elianah,F,100,39,0,39
2014,Elienai,F,100,39,0,39
2014,Elvia,F,100,39,0,39
2014,Emileigh,F,100,39,0,39
2014,Emitt,M,100,0,39,39
2014,Emiyah,F,100,39,0,39
2014,Emmah,F,100,39,0,39
2014,Eriana,F,100,39,0,39
2014,Francine,F,100,39,0,39
2014,Fritz,M,100,0,39,39
2014,Garrick,M,100,0,39,39
2014,Haider,M,100,0,39,39
2014,Hawk,M,100,0,39,39
2014,Henna,F,100,39,0,39
2014,Imogene,F,100,39,0,39
2014,Ivonne,F,100,39,0,39
2014,Jahmari,M,100,0,39,39
2014,Jania,F,100,39,0,39
2014,Jaquelyn,F,100,39,0,39
2014,Jessalynn,F,100,39,0,39
2014,Joss,M,54,18,21,39
2014,Kalei,F,85,33,6,39
2014,Kalise,F,100,39,0,39
2014,Keshaun,M,100,0,39,39
2014,Keylee,F,100,39,0,39
2014,Kimaya,F,100,39,0,39
2014,Kingsten,M,100,0,39,39
2014,Kinsler,M,82,7,32,39
2014,Korah,F,100,39,0,39
2014,Kota,M,82,7,32,39
2014,Krishiv,M,100,0,39,39
2014,Kwame,M,100,0,39,39
2014,Landis,M,87,5,34,39
2014,Lebron,M,100,0,39,39
2014,Leelan,M,100,0,39,39
2014,Levin,M,100,0,39,39
2014,Lexis,F,100,39,0,39
2014,Liba,F,100,39,0,39
2014,Lyncoln,M,64,14,25,39
2014,Maddelyn,F,100,39,0,39
2014,Maher,M,100,0,39,39
2014,Maile,F,100,39,0,39
2014,Maksym,M,100,0,39,39
2014,Mallie,F,100,39,0,39
2014,Marlei,F,100,39,0,39
2014,Marwan,M,100,0,39,39
2014,Matix,M,100,0,39,39
2014,Maysa,F,100,39,0,39
2014,Melony,F,100,39,0,39
2014,Meryem,F,100,39,0,39
2014,Morgen,F,72,28,11,39
2014,Moussa,M,100,0,39,39
2014,Mykenzie,F,100,39,0,39
2014,Nallely,F,100,39,0,39
2014,Natalynn,F,100,39,0,39
2014,Neev,M,100,0,39,39
2014,Pearson,M,100,0,39,39
2014,Pessy,F,100,39,0,39
2014,Qasim,M,100,0,39,39
2014,Quinley,F,100,39,0,39
2014,Raelin,F,100,39,0,39
2014,Raevyn,F,100,39,0,39
2014,Rafaela,F,100,39,0,39
2014,Ramone,M,100,0,39,39
2014,Razan,F,100,39,0,39
2014,Reva,F,100,39,0,39
2014,Romell,M,100,0,39,39
2014,Rook,M,100,0,39,39
2014,Saria,F,100,39,0,39
2014,Seanna,F,100,39,0,39
2014,Shayaan,M,100,0,39,39
2014,Tremayne,M,100,0,39,39
2014,Trista,F,100,39,0,39
2014,Valarie,F,100,39,0,39
2014,Whitaker,M,87,5,34,39
2014,Wilber,M,100,0,39,39
2014,Zaelynn,F,100,39,0,39
2014,Zemira,F,100,39,0,39
2014,Zenaida,F,100,39,0,39
2014,Zyonna,F,100,39,0,39
2014,Adil,M,100,0,38,38
2014,Aidric,M,100,0,38,38
2014,Ainara,F,100,38,0,38
2014,Alaynna,F,100,38,0,38
2014,Allena,F,100,38,0,38
2014,Allyanna,F,100,38,0,38
2014,Alyssandra,F,100,38,0,38
2014,Ameenah,F,100,38,0,38
2014,Amellia,F,100,38,0,38
2014,Amori,F,55,21,17,38
2014,Anai,F,100,38,0,38
2014,Annagrace,F,100,38,0,38
2014,Arisbeth,F,100,38,0,38
2014,Ariyan,M,61,15,23,38
2014,Asaiah,M,100,0,38,38
2014,Asante,M,84,6,32,38
2014,Aurelius,M,100,0,38,38
2014,Bea,F,100,38,0,38
2014,Berlynn,F,100,38,0,38
2014,Bethanie,F,100,38,0,38
2014,Brenner,M,100,0,38,38
2014,Brier,M,58,16,22,38
2014,Brylin,M,58,16,22,38
2014,Caelynn,F,100,38,0,38
2014,Callaway,M,55,17,21,38
2014,Casandra,F,100,38,0,38
2014,Cassidee,F,100,38,0,38
2014,Colden,M,100,0,38,38
2014,Cort,M,100,0,38,38
2014,Cristhian,M,100,0,38,38
2014,Daliah,F,100,38,0,38
2014,Darrian,M,100,0,38,38
2014,Dayami,F,100,38,0,38
2014,Dayne,M,100,0,38,38
2014,Deaglan,M,100,0,38,38
2014,Dedrick,M,100,0,38,38
2014,Delina,F,100,38,0,38
2014,Delvin,M,100,0,38,38
2014,Deric,M,100,0,38,38
2014,Dino,M,100,0,38,38
2014,Domonic,M,100,0,38,38
2014,Dottie,F,100,38,0,38
2014,Dutch,M,100,0,38,38
2014,Eimy,F,100,38,0,38
2014,Elicia,F,100,38,0,38
2014,Elleigh,F,100,38,0,38
2014,Emeli,F,100,38,0,38
2014,Emonie,F,100,38,0,38
2014,Esabella,F,100,38,0,38
2014,Fabricio,M,100,0,38,38
2014,Finnick,M,100,0,38,38
2014,Fionna,F,100,38,0,38
2014,Genavieve,F,100,38,0,38
2014,Gianella,F,100,38,0,38
2014,Golden,M,61,15,23,38
2014,Graciella,F,100,38,0,38
2014,Gwenevere,F,100,38,0,38
2014,Irlanda,F,100,38,0,38
2014,Ixchel,F,100,38,0,38
2014,Jahleel,M,100,0,38,38
2014,Jaide,F,100,38,0,38
2014,Jalani,F,74,28,10,38
2014,Janel,F,100,38,0,38
2014,Jaxtyn,M,100,0,38,38
2014,Jerald,M,100,0,38,38
2014,Jeziah,M,100,0,38,38
2014,Jhonny,M,100,0,38,38
2014,Jiraiya,M,100,0,38,38
2014,Kailan,M,61,15,23,38
2014,Kaleesi,F,100,38,0,38
2014,Kalila,F,100,38,0,38
2014,Kamoni,F,61,23,15,38
2014,Kartier,M,87,5,33,38
2014,Kasper,M,100,0,38,38
2014,Katniss,F,100,38,0,38
2014,Kavi,M,100,0,38,38
2014,Keane,M,100,0,38,38
2014,Keona,F,100,38,0,38
2014,Keyanna,F,100,38,0,38
2014,Keyshawn,M,100,0,38,38
2014,Khalif,M,100,0,38,38
2014,Kinzleigh,F,100,38,0,38
2014,Kirill,M,100,0,38,38
2014,Kirin,M,76,9,29,38
2014,Konstantin,M,100,0,38,38
2014,Krislyn,F,100,38,0,38
2014,Lanaya,F,100,38,0,38
2014,Leni,F,100,38,0,38
2014,Liani,F,100,38,0,38
2014,Lior,M,74,10,28,38
2014,Liviana,F,100,38,0,38
2014,Llewyn,M,100,0,38,38
2014,Macayla,F,100,38,0,38
2014,Macsen,M,100,0,38,38
2014,Maelie,F,100,38,0,38
2014,Maram,F,100,38,0,38
2014,Maylie,F,100,38,0,38
2014,Mecca,F,68,26,12,38
2014,Medha,F,100,38,0,38
2014,Mela,F,100,38,0,38
2014,Miamor,F,100,38,0,38
2014,Micha,M,68,12,26,38
2014,Mikko,M,100,0,38,38
2014,Myasia,F,100,38,0,38
2014,Naevia,F,100,38,0,38
2014,Naimah,F,100,38,0,38
2014,Najee,M,100,0,38,38
2014,Nalaya,F,100,38,0,38
2014,Naomie,F,100,38,0,38
2014,Niyla,F,100,38,0,38
2014,Noura,F,100,38,0,38
2014,Oakland,M,76,9,29,38
2014,Oluwademilade,M,58,16,22,38
2014,Perri,F,100,38,0,38
2014,Phaedra,F,100,38,0,38
2014,Ram,M,100,0,38,38
2014,Ramya,F,100,38,0,38
2014,Ranya,F,100,38,0,38
2014,Rianna,F,100,38,0,38
2014,Rielle,F,100,38,0,38
2014,Rithvik,M,100,0,38,38
2014,Ryler,M,100,0,38,38
2014,Scottie,F,53,20,18,38
2014,Seerat,F,100,38,0,38
2014,Shaindel,F,100,38,0,38
2014,Shanelle,F,100,38,0,38
2014,Sherman,M,100,0,38,38
2014,Shianne,F,100,38,0,38
2014,Shreyan,M,100,0,38,38
2014,Siri,F,100,38,0,38
2014,Sommer,F,100,38,0,38
2014,Stryder,M,100,0,38,38
2014,Sutter,M,84,6,32,38
2014,Taliya,F,100,38,0,38
2014,Tamir,M,100,0,38,38
2014,Tamiya,F,100,38,0,38
2014,Theophilus,M,100,0,38,38
2014,Toren,M,100,0,38,38
2014,Travion,M,100,0,38,38
2014,Vita,F,100,38,0,38
2014,Waylan,M,100,0,38,38
2014,Weslee,M,100,0,38,38
2014,Whitlee,F,100,38,0,38
2014,Williams,M,100,0,38,38
2014,Yaiza,F,100,38,0,38
2014,Yessica,F,100,38,0,38
2014,Zaiya,F,100,38,0,38
2014,Zayra,F,100,38,0,38
2014,Zealand,M,87,5,33,38
2014,Zianna,F,100,38,0,38
2014,Zulema,F,100,38,0,38
2014,Aaliah,F,100,37,0,37
2014,Adalin,F,100,37,0,37
2014,Adien,M,100,0,37,37
2014,Akash,M,100,0,37,37
2014,Alara,F,100,37,0,37
2014,Aleana,F,100,37,0,37
2014,Alliana,F,100,37,0,37
2014,Ameria,F,100,37,0,37
2014,Anijah,F,100,37,0,37
2014,Arien,M,65,13,24,37
2014,Auri,F,100,37,0,37
2014,Auriana,F,100,37,0,37
2014,Auston,M,100,0,37,37
2014,Aveah,F,100,37,0,37
2014,Avneet,F,100,37,0,37
2014,Ayonna,F,100,37,0,37
2014,Blimy,F,100,37,0,37
2014,Braleigh,F,100,37,0,37
2014,Brannon,M,100,0,37,37
2014,Braysen,M,100,0,37,37
2014,Brekken,M,100,0,37,37
2014,Britta,F,100,37,0,37
2014,Cady,F,100,37,0,37
2014,Caylie,F,100,37,0,37
2014,Dannie,F,62,23,14,37
2014,Darron,M,100,0,37,37
2014,Dashel,M,100,0,37,37
2014,Devaughn,M,100,0,37,37
2014,Dillion,M,100,0,37,37
2014,Dilynn,F,100,37,0,37
2014,Dua,F,100,37,0,37
2014,Earnest,M,100,0,37,37
2014,Edrick,M,100,0,37,37
2014,Eliazar,M,100,0,37,37
2014,Ellaina,F,100,37,0,37
2014,Ellasyn,F,100,37,0,37
2014,Elliemae,F,100,37,0,37
2014,Emberlee,F,100,37,0,37
2014,Emili,F,100,37,0,37
2014,Eniyah,F,100,37,0,37
2014,Evette,F,100,37,0,37
2014,Exavier,M,100,0,37,37
2014,Gisell,F,100,37,0,37
2014,Gracee,F,100,37,0,37
2014,Granger,M,100,0,37,37
2014,Haneen,F,100,37,0,37
2014,Heber,M,100,0,37,37
2014,Hilario,M,100,0,37,37
2014,Hinda,F,100,37,0,37
2014,Humza,M,100,0,37,37
2014,Ianna,F,100,37,0,37
2014,Ilianna,F,100,37,0,37
2014,Jacquelin,F,100,37,0,37
2014,Jailene,F,100,37,0,37
2014,Jameel,M,100,0,37,37
2014,Jameir,M,100,0,37,37
2014,Jamileth,F,100,37,0,37
2014,Jamyah,F,100,37,0,37
2014,Javari,M,100,0,37,37
2014,Jayah,F,100,37,0,37
2014,Jayanna,F,100,37,0,37
2014,Jennings,M,76,9,28,37
2014,Jess,M,86,5,32,37
2014,Jhase,M,100,0,37,37
2014,Karder,M,81,7,30,37
2014,Karmin,F,100,37,0,37
2014,Kaylon,M,73,10,27,37
2014,Keniyah,F,100,37,0,37
2014,Kerrington,F,100,37,0,37
2014,Khaliah,F,100,37,0,37
2014,Kit,M,57,16,21,37
2014,Kyanna,F,100,37,0,37
2014,Kynsleigh,F,100,37,0,37
2014,Lander,M,100,0,37,37
2014,Lark,F,100,37,0,37
2014,Laykin,F,100,37,0,37
2014,Lexa,F,100,37,0,37
2014,Lilla,F,100,37,0,37
2014,Lochlyn,F,86,32,5,37
2014,Louella,F,100,37,0,37
2014,Lowell,M,100,0,37,37
2014,Lya,F,100,37,0,37
2014,Maddy,F,100,37,0,37
2014,Maha,F,100,37,0,37
2014,Maida,F,100,37,0,37
2014,Marah,F,100,37,0,37
2014,Matilyn,F,100,37,0,37
2014,Mikaylah,F,100,37,0,37
2014,Milagro,F,100,37,0,37
2014,Monae,F,100,37,0,37
2014,Muna,F,100,37,0,37
2014,Mycah,F,51,19,18,37
2014,Nicodemus,M,100,0,37,37
2014,Nosson,M,100,0,37,37
2014,Othniel,M,100,0,37,37
2014,Phebe,F,100,37,0,37
2014,Prynce,M,100,0,37,37
2014,Quade,M,100,0,37,37
2014,Raymon,M,100,0,37,37
2014,Reginae,F,100,37,0,37
2014,Riddick,M,100,0,37,37
2014,Rishabh,M,100,0,37,37
2014,Rogue,F,70,26,11,37
2014,Rue,F,84,31,6,37
2014,Sahib,M,100,0,37,37
2014,Saja,F,100,37,0,37
2014,Saud,M,100,0,37,37
2014,Sayler,F,100,37,0,37
2014,Shayden,M,73,10,27,37
2014,Shifra,F,100,37,0,37
2014,Shilo,M,54,17,20,37
2014,Silvana,F,100,37,0,37
2014,Sophya,F,100,37,0,37
2014,Suhani,F,100,37,0,37
2014,Tayton,M,100,0,37,37
2014,Tayvon,M,100,0,37,37
2014,Tj,M,100,0,37,37
2014,Trystin,M,100,0,37,37
2014,Tyleah,F,100,37,0,37
2014,Tymir,M,100,0,37,37
2014,Tyquan,M,100,0,37,37
2014,Wayde,M,100,0,37,37
2014,Wednesday,F,100,37,0,37
2014,Wilhelm,M,100,0,37,37
2014,Winona,F,100,37,0,37
2014,Yamil,M,100,0,37,37
2014,Yides,F,100,37,0,37
2014,Zahira,F,100,37,0,37
2014,Zya,F,100,37,0,37
2014,Aarin,M,83,6,30,36
2014,Adore,F,100,36,0,36
2014,Adric,M,100,0,36,36
2014,Adysen,F,100,36,0,36
2014,Ahlam,F,100,36,0,36
2014,Alastair,M,100,0,36,36
2014,Alethea,F,100,36,0,36
2014,Aletheia,F,100,36,0,36
2014,Alydia,F,100,36,0,36
2014,Amalie,F,100,36,0,36
2014,Anamarie,F,100,36,0,36
2014,Anh,F,69,25,11,36
2014,Anibal,M,100,0,36,36
2014,Arsema,F,100,36,0,36
2014,Asya,F,100,36,0,36
2014,Auna,F,100,36,0,36
2014,Averey,F,86,31,5,36
2014,Avie,F,100,36,0,36
2014,Aviv,M,58,15,21,36
2014,Ayrton,M,100,0,36,36
2014,Blossom,F,100,36,0,36
2014,Boe,M,100,0,36,36
2014,Brailee,F,100,36,0,36
2014,Breelynn,F,100,36,0,36
2014,Brodey,M,100,0,36,36
2014,Carey,M,58,15,21,36
2014,Daksh,M,100,0,36,36
2014,Danial,M,100,0,36,36
2014,Dayani,F,100,36,0,36
2014,Demiyah,F,100,36,0,36
2014,Demoni,M,75,9,27,36
2014,Desi,F,56,20,16,36
2014,Devonta,M,100,0,36,36
2014,Didier,M,100,0,36,36
2014,Dontay,M,100,0,36,36
2014,Elden,M,100,0,36,36
2014,Eleyna,F,100,36,0,36
2014,Elleanor,F,100,36,0,36
2014,Ellyn,F,100,36,0,36
2014,Emiko,F,100,36,0,36
2014,Emmalina,F,100,36,0,36
2014,Ena,F,100,36,0,36
2014,Eveline,F,100,36,0,36
2014,Gabryella,F,100,36,0,36
2014,Giovany,M,100,0,36,36
2014,Haddon,M,100,0,36,36
2014,Haydin,M,53,17,19,36
2014,Haydon,M,81,7,29,36
2014,Henderson,M,100,0,36,36
2014,Hero,F,56,20,16,36
2014,Holdyn,M,86,5,31,36
2014,Homero,M,100,0,36,36
2014,Hutson,M,100,0,36,36
2014,Ilaria,F,100,36,0,36
2014,Ishaq,M,100,0,36,36
2014,Izaya,M,100,0,36,36
2014,Iziah,M,100,0,36,36
2014,Jackelin,F,100,36,0,36
2014,Jakson,M,100,0,36,36
2014,Jalyssa,F,100,36,0,36
2014,Jamaria,F,100,36,0,36
2014,Jamisen,M,81,7,29,36
2014,Jarrell,M,100,0,36,36
2014,Jaxtin,M,100,0,36,36
2014,Jaydenn,M,83,6,30,36
2014,Jediah,M,100,0,36,36
2014,Jenifer,F,100,36,0,36
2014,Jeter,M,100,0,36,36
2014,Jeyden,M,100,0,36,36
2014,Joesph,M,100,0,36,36
2014,Joniel,M,100,0,36,36
2014,Jotham,M,100,0,36,36
2014,Joud,F,78,28,8,36
2014,Juliett,F,100,36,0,36
2014,Kadance,F,100,36,0,36
2014,Kaidance,F,100,36,0,36
2014,Kailer,M,86,5,31,36
2014,Kaleia,F,100,36,0,36
2014,Karizma,F,100,36,0,36
2014,Karver,M,100,0,36,36
2014,Kaydan,M,100,0,36,36
2014,Keanna,F,100,36,0,36
2014,Kennadie,F,100,36,0,36
2014,Keylan,M,100,0,36,36
2014,Kinnick,M,100,0,36,36
2014,Kynslie,F,100,36,0,36
2014,Lamia,F,100,36,0,36
2014,Lawton,M,100,0,36,36
2014,Leasia,F,100,36,0,36
2014,Lenin,M,100,0,36,36
2014,Lennix,F,53,19,17,36
2014,Leopoldo,M,100,0,36,36
2014,Lindley,F,100,36,0,36
2014,Lynnox,F,86,31,5,36
2014,Lyvia,F,100,36,0,36
2014,Maddax,M,100,0,36,36
2014,Mahayla,F,100,36,0,36
2014,Maiah,F,100,36,0,36
2014,Maleyah,F,100,36,0,36
2014,Maranda,F,100,36,0,36
2014,Marcelina,F,100,36,0,36
2014,Mariafernanda,F,100,36,0,36
2014,Mathilda,F,100,36,0,36
2014,Maylene,F,100,36,0,36
2014,Mazzy,F,100,36,0,36
2014,Meyah,F,100,36,0,36
2014,Michel,M,69,11,25,36
2014,Moxie,F,100,36,0,36
2014,Nakai,M,100,0,36,36
2014,Niccolo,M,100,0,36,36
2014,Olivea,F,100,36,0,36
2014,Pacey,F,56,20,16,36
2014,Peace,F,78,28,8,36
2014,Riana,F,100,36,0,36
2014,Roni,F,78,28,8,36
2014,Sakina,F,100,36,0,36
2014,Sheamus,M,100,0,36,36
2014,Shrey,M,100,0,36,36
2014,Skylor,M,58,15,21,36
2014,Slate,M,100,0,36,36
2014,Stefani,F,100,36,0,36
2014,Talaya,F,100,36,0,36
2014,Talha,M,100,0,36,36
2014,Thompson,M,100,0,36,36
2014,Torrey,M,78,8,28,36
2014,Trever,M,100,0,36,36
2014,Tynlee,F,100,36,0,36
2014,Usman,M,100,0,36,36
2014,Yonathan,M,100,0,36,36
2014,Yulia,F,100,36,0,36
2014,Yuvan,M,100,0,36,36
2014,Zamaya,F,100,36,0,36
2014,Ziad,M,100,0,36,36
2014,Zyriah,F,100,36,0,36
2014,Aaria,F,100,35,0,35
2014,Adira,F,100,35,0,35
2014,Aela,F,100,35,0,35
2014,Ailany,F,100,35,0,35
2014,Alexei,M,100,0,35,35
2014,Alexsander,M,100,0,35,35
2014,Aleyza,F,100,35,0,35
2014,Allee,F,100,35,0,35
2014,Amaira,F,100,35,0,35
2014,Amier,M,100,0,35,35
2014,Anyiah,F,100,35,0,35
2014,Arial,F,100,35,0,35
2014,Arieana,F,100,35,0,35
2014,Asmaa,F,100,35,0,35
2014,Atalia,F,100,35,0,35
2014,Atara,F,100,35,0,35
2014,Avaree,F,100,35,0,35
2014,Avelina,F,100,35,0,35
2014,Aydon,M,100,0,35,35
2014,Baltazar,M,100,0,35,35
2014,Banner,M,86,5,30,35
2014,Berlyn,F,100,35,0,35
2014,Blade,M,100,0,35,35
2014,Blue,F,54,19,16,35
2014,Bransen,M,100,0,35,35
2014,Briasia,F,100,35,0,35
2014,Bridgett,F,100,35,0,35
2014,Brylon,M,100,0,35,35
2014,Brylynn,F,100,35,0,35
2014,Carrick,M,100,0,35,35
2014,Chason,M,100,0,35,35
2014,Codie,F,51,18,17,35
2014,Collyn,M,69,11,24,35
2014,Daijah,F,100,35,0,35
2014,Damaya,F,100,35,0,35
2014,Daphnie,F,100,35,0,35
2014,Darell,M,100,0,35,35
2014,Darlyn,F,100,35,0,35
2014,Dayson,M,100,0,35,35
2014,Debanhi,F,100,35,0,35
2014,Demya,F,100,35,0,35
2014,Domani,M,100,0,35,35
2014,Donavin,M,100,0,35,35
2014,Ellora,F,100,35,0,35
2014,Elwood,M,100,0,35,35
2014,Emmalie,F,100,35,0,35
2014,Emri,F,100,35,0,35
2014,Enoc,M,100,0,35,35
2014,Esa,M,83,6,29,35
2014,Esmee,F,100,35,0,35
2014,Esty,F,100,35,0,35
2014,Fatma,F,100,35,0,35
2014,Garner,M,80,7,28,35
2014,Garry,M,100,0,35,35
2014,Genevie,F,100,35,0,35
2014,Hadasa,F,100,35,0,35
2014,Hallee,F,100,35,0,35
2014,Harmoney,F,100,35,0,35
2014,Hiro,M,100,0,35,35
2014,Inayah,F,100,35,0,35
2014,Izan,M,100,0,35,35
2014,Izrael,M,100,0,35,35
2014,Jacklynn,F,100,35,0,35
2014,Jadalynn,F,100,35,0,35
2014,Jahdiel,M,100,0,35,35
2014,Jailee,F,100,35,0,35
2014,Jaise,M,83,6,29,35
2014,Jamarian,M,100,0,35,35
2014,Jeffry,M,100,0,35,35
2014,Jerrod,M,100,0,35,35
2014,Johnmichael,M,100,0,35,35
2014,Josemanuel,M,100,0,35,35
2014,Juel,M,86,5,30,35
2014,Kalan,M,100,0,35,35
2014,Karmello,M,100,0,35,35
2014,Katalia,F,100,35,0,35
2014,Kaylinn,F,100,35,0,35
2014,Kelsea,F,100,35,0,35
2014,Kennadee,F,100,35,0,35
2014,Kenza,F,100,35,0,35
2014,Khloey,F,100,35,0,35
2014,Korina,F,100,35,0,35
2014,Lakelynn,F,100,35,0,35
2014,Langley,F,100,35,0,35
2014,Laurynn,F,100,35,0,35
2014,Layal,F,100,35,0,35
2014,Leighanna,F,100,35,0,35
2014,Livvy,F,100,35,0,35
2014,Luisangel,M,100,0,35,35
2014,Luqman,M,100,0,35,35
2014,Mailani,F,100,35,0,35
2014,Majd,M,100,0,35,35
2014,Makinlee,F,100,35,0,35
2014,Malachai,M,100,0,35,35
2014,Mattilyn,F,100,35,0,35
2014,Mattox,M,100,0,35,35
2014,Maxime,M,100,0,35,35
2014,Meklit,F,100,35,0,35
2014,Michaella,F,100,35,0,35
2014,Mirabel,F,100,35,0,35
2014,Monet,F,100,35,0,35
2014,Munira,F,100,35,0,35
2014,Myleigh,F,100,35,0,35
2014,Nohemi,F,100,35,0,35
2014,Norris,M,100,0,35,35
2014,Oaklynn,F,100,35,0,35
2014,Oceana,F,100,35,0,35
2014,Rainer,M,100,0,35,35
2014,Raygan,F,100,35,0,35
2014,Raygen,F,74,26,9,35
2014,Rayonna,F,100,35,0,35
2014,Ridwan,M,100,0,35,35
2014,Rishik,M,100,0,35,35
2014,Rony,M,100,0,35,35
2014,Ryla,F,100,35,0,35
2014,Salah,M,100,0,35,35
2014,Samanta,F,100,35,0,35
2014,Sandro,M,100,0,35,35
2014,Sayde,F,100,35,0,35
2014,Seeley,M,80,7,28,35
2014,September,F,100,35,0,35
2014,Skylie,F,100,35,0,35
2014,Steel,M,100,0,35,35
2014,Suhana,F,100,35,0,35
2014,Sylvan,M,100,0,35,35
2014,Tahira,F,100,35,0,35
2014,Talynn,F,100,35,0,35
2014,Tarek,M,100,0,35,35
2014,Tariah,F,100,35,0,35
2014,Tavian,M,100,0,35,35
2014,Terran,M,83,6,29,35
2014,Terron,M,100,0,35,35
2014,Tillman,M,100,0,35,35
2014,Torrence,M,83,6,29,35
2014,Trapper,M,100,0,35,35
2014,Trentin,M,100,0,35,35
2014,Valkyrie,F,100,35,0,35
2014,Verna,F,100,35,0,35
2014,Vihan,M,100,0,35,35
2014,Viridiana,F,100,35,0,35
2014,Vishnu,M,100,0,35,35
2014,Wilbert,M,100,0,35,35
2014,Willy,M,100,0,35,35
2014,Windsor,F,71,25,10,35
2014,Yajaira,F,100,35,0,35
2014,Yatzil,F,100,35,0,35
2014,Yunus,M,100,0,35,35
2014,Zaeden,M,100,0,35,35
2014,Zaidan,M,100,0,35,35
2014,Zari,F,100,35,0,35
2014,Zionna,F,100,35,0,35
2014,Zoi,F,100,35,0,35
2014,Adaly,F,100,34,0,34
2014,Adhvik,M,100,0,34,34
2014,Affan,M,100,0,34,34
2014,Aiko,F,100,34,0,34
2014,Akeelah,F,100,34,0,34
2014,Alainah,F,100,34,0,34
2014,Alany,F,100,34,0,34
2014,Alexsandra,F,100,34,0,34
2014,Alinah,F,100,34,0,34
2014,Anjelica,F,100,34,0,34
2014,Annah,F,100,34,0,34
2014,Annslee,F,100,34,0,34
2014,Antwone,M,100,0,34,34
2014,Arjan,M,100,0,34,34
2014,Aydrian,M,100,0,34,34
2014,Azura,F,100,34,0,34
2014,Bayan,F,100,34,0,34
2014,Baylin,M,56,15,19,34
2014,Brazil,F,79,27,7,34
2014,Breann,F,100,34,0,34
2014,Brenleigh,F,100,34,0,34
2014,Breonna,F,100,34,0,34
2014,Breslin,M,59,14,20,34
2014,Brynnleigh,F,100,34,0,34
2014,Caeli,F,100,34,0,34
2014,Camber,F,74,25,9,34
2014,China,F,100,34,0,34
2014,Christabel,F,100,34,0,34
2014,Christal,F,100,34,0,34
2014,Conway,M,100,0,34,34
2014,Copper,M,74,9,25,34
2014,Davontae,M,100,0,34,34
2014,Delphine,F,100,34,0,34
2014,Dionna,F,100,34,0,34
2014,Drea,F,100,34,0,34
2014,Eduard,M,100,0,34,34
2014,Elisia,F,100,34,0,34
2014,Ellieana,F,100,34,0,34
2014,Elsy,F,100,34,0,34
2014,Emiley,F,100,34,0,34
2014,Emina,F,100,34,0,34
2014,Espen,M,85,5,29,34
2014,Evah,F,100,34,0,34
2014,Farhan,M,100,0,34,34
2014,Garren,M,100,0,34,34
2014,Giancarlos,M,100,0,34,34
2014,Golda,F,100,34,0,34
2014,Haze,M,100,0,34,34
2014,Heavenlee,F,100,34,0,34
2014,Ilias,M,100,0,34,34
2014,Ivyanna,F,100,34,0,34
2014,Izzabelle,F,100,34,0,34
2014,Jak,M,100,0,34,34
2014,Jaliya,F,100,34,0,34
2014,Jamauri,M,100,0,34,34
2014,Januel,M,100,0,34,34
2014,Jayquan,M,100,0,34,34
2014,Jazzmine,F,100,34,0,34
2014,Jeanne,F,100,34,0,34
2014,Jessika,F,100,34,0,34
2014,Johnna,F,100,34,0,34
2014,Jovanna,F,100,34,0,34
2014,Kamdon,M,100,0,34,34
2014,Kandace,F,100,34,0,34
2014,Katai,M,100,0,34,34
2014,Kato,M,100,0,34,34
2014,Kaydyn,M,71,10,24,34
2014,Keigan,M,82,6,28,34
2014,Keylor,M,100,0,34,34
2014,Khalani,F,85,29,5,34
2014,Kiptyn,M,100,0,34,34
2014,Kloie,F,100,34,0,34
2014,Krislynn,F,100,34,0,34
2014,Kyleah,F,100,34,0,34
2014,Leeroy,M,100,0,34,34
2014,Leighla,F,100,34,0,34
2014,Lilianne,F,100,34,0,34
2014,Lleyton,M,100,0,34,34
2014,Lorna,F,100,34,0,34
2014,Makya,F,100,34,0,34
2014,Malana,F,100,34,0,34
2014,Maleia,F,100,34,0,34
2014,Marelyn,F,100,34,0,34
2014,Mars,M,100,0,34,34
2014,Maverik,M,100,0,34,34
2014,Maxemiliano,M,100,0,34,34
2014,Meher,F,100,34,0,34
2014,Mehmet,M,100,0,34,34
2014,Mercedez,F,100,34,0,34
2014,Merci,F,100,34,0,34
2014,Mikenzie,F,100,34,0,34
2014,Myia,F,100,34,0,34
2014,Myrah,F,100,34,0,34
2014,Myriam,F,100,34,0,34
2014,Najma,F,100,34,0,34
2014,Natalyn,F,100,34,0,34
2014,Naydelin,F,100,34,0,34
2014,Olamide,F,53,18,16,34
2014,Oliviah,F,100,34,0,34
2014,Passion,F,100,34,0,34
2014,Peri,F,100,34,0,34
2014,Quadir,M,100,0,34,34
2014,Raidyn,M,71,10,24,34
2014,Rayn,F,68,23,11,34
2014,Reza,M,100,0,34,34
2014,Rhian,F,100,34,0,34
2014,Rossi,F,82,28,6,34
2014,Rylea,F,100,34,0,34
2014,Sabir,M,100,0,34,34
2014,Sadee,F,100,34,0,34
2014,Samyra,F,100,34,0,34
2014,Sathvik,M,100,0,34,34
2014,Scotty,M,100,0,34,34
2014,Sela,F,100,34,0,34
2014,Shamiya,F,100,34,0,34
2014,Shaw,M,74,9,25,34
2014,Shivam,M,100,0,34,34
2014,Shmiel,M,100,0,34,34
2014,Sione,M,100,0,34,34
2014,Soledad,F,100,34,0,34
2014,Sufyan,M,100,0,34,34
2014,Treshawn,M,100,0,34,34
2014,Tryston,M,100,0,34,34
2014,Tymber,F,100,34,0,34
2014,Tziporah,F,100,34,0,34
2014,Vanity,F,100,34,0,34
2014,Vann,M,100,0,34,34
2014,Vanna,F,100,34,0,34
2014,Vy,F,100,34,0,34
2014,Willard,M,100,0,34,34
2014,Xenia,F,100,34,0,34
2014,Yared,M,85,5,29,34
2014,Yona,F,50,17,17,34
2014,Zaynah,F,100,34,0,34
2014,Zissy,F,100,34,0,34
2014,Aadyn,M,100,0,33,33
2014,Aalijah,M,64,12,21,33
2014,Aaralynn,F,100,33,0,33
2014,Aariyah,F,100,33,0,33
2014,Abimael,M,100,0,33,33
2014,Abree,F,100,33,0,33
2014,Adhrit,M,100,0,33,33
2014,Adonijah,M,100,0,33,33
2014,Advika,F,100,33,0,33
2014,Aerabella,F,100,33,0,33
2014,Akayla,F,100,33,0,33
2014,Alayjah,F,100,33,0,33
2014,Alexandru,M,100,0,33,33
2014,Alexie,F,100,33,0,33
2014,Alisia,F,100,33,0,33
2014,Andee,F,100,33,0,33
2014,Anden,M,100,0,33,33
2014,Andon,M,100,0,33,33
2014,Aniela,F,100,33,0,33
2014,Annasophia,F,100,33,0,33
2014,Arianni,F,100,33,0,33
2014,Arihanna,F,100,33,0,33
2014,Ariston,M,100,0,33,33
2014,Atziri,F,100,33,0,33
2014,Audie,M,61,13,20,33
2014,Aviel,M,100,0,33,33
2014,Bellah,F,100,33,0,33
2014,Bertha,F,100,33,0,33
2014,Binyomin,M,100,0,33,33
2014,Braya,F,100,33,0,33
2014,Brewer,M,100,0,33,33
2014,Briel,F,100,33,0,33
2014,Brittyn,F,100,33,0,33
2014,Brodee,M,100,0,33,33
2014,Brooklyne,F,100,33,0,33
2014,Brydon,M,100,0,33,33
2014,Buddy,M,100,0,33,33
2014,Cameren,M,100,0,33,33
2014,Carlyn,F,100,33,0,33
2014,Carnell,M,100,0,33,33
2014,Catelynn,F,100,33,0,33
2014,Chanse,M,100,0,33,33
2014,Cinthia,F,100,33,0,33
2014,Cloey,F,100,33,0,33
2014,Corie,F,79,26,7,33
2014,Daniyal,M,100,0,33,33
2014,Daphney,F,100,33,0,33
2014,Dejah,F,100,33,0,33
2014,Delyla,F,100,33,0,33
2014,Denym,F,52,17,16,33
2014,Derian,M,100,0,33,33
2014,Devansh,M,100,0,33,33
2014,Diem,F,76,25,8,33
2014,Dynasty,F,100,33,0,33
2014,Edric,M,100,0,33,33
2014,Edy,M,70,10,23,33
2014,Eesha,F,100,33,0,33
2014,Efraim,M,100,0,33,33
2014,Elizaveta,F,100,33,0,33
2014,Enrico,M,100,0,33,33
2014,Esdras,M,100,0,33,33
2014,Evamarie,F,100,33,0,33
2014,Fateh,M,100,0,33,33
2014,Fay,F,100,33,0,33
2014,Fraidy,F,100,33,0,33
2014,Freeman,M,100,0,33,33
2014,Frieda,F,100,33,0,33
2014,Graci,F,100,33,0,33
2014,Hamad,M,100,0,33,33
2014,Han,M,61,13,20,33
2014,Helene,F,100,33,0,33
2014,Hera,F,100,33,0,33
2014,Hershy,M,100,0,33,33
2014,Hudsen,M,100,0,33,33
2014,Ifeoluwa,F,70,23,10,33
2014,Izek,M,100,0,33,33
2014,Jabril,M,100,0,33,33
2014,Jaclynn,F,100,33,0,33
2014,Jaelle,F,100,33,0,33
2014,Jahsir,M,100,0,33,33
2014,Jakyla,F,100,33,0,33
2014,Jamieson,M,100,0,33,33
2014,Janis,F,100,33,0,33
2014,Jasean,M,100,0,33,33
2014,Jasmina,F,100,33,0,33
2014,Jasmyne,F,100,33,0,33
2014,Jatziri,F,100,33,0,33
2014,Jeremie,M,100,0,33,33
2014,Jezabel,F,100,33,0,33
2014,Joseangel,M,100,0,33,33
2014,Josslynn,F,100,33,0,33
2014,Jrue,M,76,8,25,33
2014,Junia,F,100,33,0,33
2014,Kady,F,100,33,0,33
2014,Kainen,M,100,0,33,33
2014,Kalem,M,100,0,33,33
2014,Kamri,F,100,33,0,33
2014,Kareena,F,100,33,0,33
2014,Kerem,M,100,0,33,33
2014,Kevion,M,100,0,33,33
2014,Khi,M,79,7,26,33
2014,Khristopher,M,100,0,33,33
2014,Kirah,F,100,33,0,33
2014,Kordell,M,100,0,33,33
2014,Kortez,M,100,0,33,33
2014,Krysta,F,100,33,0,33
2014,Kylea,F,100,33,0,33
2014,Lavell,M,100,0,33,33
2014,Leeana,F,100,33,0,33
2014,Lilya,F,100,33,0,33
2014,Lizabeth,F,100,33,0,33
2014,Loralie,F,100,33,0,33
2014,Loukas,M,100,0,33,33
2014,Lua,F,100,33,0,33
2014,Lynley,F,100,33,0,33
2014,Mahlon,M,100,0,33,33
2014,Makynzi,F,100,33,0,33
2014,Manal,F,100,33,0,33
2014,Mannat,F,100,33,0,33
2014,Maricruz,F,100,33,0,33
2014,Marykate,F,100,33,0,33
2014,Mckinleigh,F,100,33,0,33
2014,Mick,M,100,0,33,33
2014,Mikaila,F,100,33,0,33
2014,Moishe,M,100,0,33,33
2014,Natania,F,100,33,0,33
2014,Nevaeha,F,100,33,0,33
2014,Nicolo,M,100,0,33,33
2014,Noora,F,100,33,0,33
2014,Nura,F,100,33,0,33
2014,Octavian,M,100,0,33,33
2014,Ona,F,100,33,0,33
2014,Oumar,M,100,0,33,33
2014,Phenix,M,58,14,19,33
2014,Rakan,M,100,0,33,33
2014,Rayla,F,100,33,0,33
2014,Roczen,M,100,0,33,33
2014,Rorie,F,100,33,0,33
2014,Saisha,F,100,33,0,33
2014,Sarayu,F,100,33,0,33
2014,Sarenity,F,100,33,0,33
2014,Shantal,F,100,33,0,33
2014,Spirit,F,100,33,0,33
2014,Stacie,F,100,33,0,33
2014,Stanton,M,100,0,33,33
2014,Svea,F,100,33,0,33
2014,Tayten,M,82,6,27,33
2014,Teaghan,F,100,33,0,33
2014,Teigen,M,52,16,17,33
2014,Tiger,M,100,0,33,33
2014,Tobi,M,70,10,23,33
2014,Tula,F,100,33,0,33
2014,Twyla,F,100,33,0,33
2014,Veera,F,100,33,0,33
2014,Viana,F,100,33,0,33
2014,Vinny,M,100,0,33,33
2014,Wayland,M,100,0,33,33
2014,Wynne,F,100,33,0,33
2014,Yanet,F,100,33,0,33
2014,Yanira,F,100,33,0,33
2014,Yannick,M,100,0,33,33
2014,Yerik,M,100,0,33,33
2014,Yulisa,F,100,33,0,33
2014,Zavien,M,100,0,33,33
2014,Zeinab,F,100,33,0,33
2014,Zidan,M,100,0,33,33
2014,Aakash,M,100,0,32,32
2014,Abbi,F,100,32,0,32
2014,Acen,M,100,0,32,32
2014,Adithya,M,100,0,32,32
2014,Aerith,F,100,32,0,32
2014,Ahmet,M,100,0,32,32
2014,Alayiah,F,100,32,0,32
2014,Aleiah,F,100,32,0,32
2014,Altair,F,56,18,14,32
2014,Amilah,F,100,32,0,32
2014,Anabela,F,100,32,0,32
2014,Aneesh,M,100,0,32,32
2014,Angelee,F,100,32,0,32
2014,Angelic,F,100,32,0,32
2014,Annora,F,100,32,0,32
2014,Anwar,M,100,0,32,32
2014,Ariona,F,100,32,0,32
2014,Arohi,F,100,32,0,32
2014,Aryiah,F,100,32,0,32
2014,Aunna,F,100,32,0,32
2014,Avangeline,F,100,32,0,32
2014,Avika,F,100,32,0,32
2014,Azayla,F,100,32,0,32
2014,Binyamin,M,100,0,32,32
2014,Carma,F,100,32,0,32
2014,Carolyne,F,100,32,0,32
2014,Chapman,M,100,0,32,32
2014,Christin,F,50,16,16,32
2014,Clio,F,100,32,0,32
2014,Dalyla,F,100,32,0,32
2014,Danitza,F,100,32,0,32
2014,Danyelle,F,100,32,0,32
2014,Dariah,F,100,32,0,32
2014,Davyn,M,100,0,32,32
2014,Deandra,F,84,27,5,32
2014,Demond,M,100,0,32,32
2014,Deonta,M,100,0,32,32
2014,Deshon,M,100,0,32,32
2014,Dex,M,100,0,32,32
2014,Donatello,M,100,0,32,32
2014,Drayton,M,100,0,32,32
2014,Dylen,M,100,0,32,32
2014,Ekaterina,F,100,32,0,32
2014,Elanor,F,100,32,0,32
2014,Eliany,F,100,32,0,32
2014,Emran,M,100,0,32,32
2014,Erina,F,100,32,0,32
2014,Esaias,M,100,0,32,32
2014,Evalee,F,100,32,0,32
2014,Faithlyn,F,100,32,0,32
2014,Falynn,F,100,32,0,32
2014,Farid,M,100,0,32,32
2014,Farida,F,100,32,0,32
2014,Forever,F,100,32,0,32
2014,Gabrial,M,100,0,32,32
2014,Geronimo,M,100,0,32,32
2014,Gil,M,100,0,32,32
2014,Godric,M,100,0,32,32
2014,Hakim,M,100,0,32,32
2014,Hardy,M,100,0,32,32
2014,Hareem,F,100,32,0,32
2014,Hartlee,F,100,32,0,32
2014,Harun,M,100,0,32,32
2014,Henny,F,100,32,0,32
2014,Hersh,M,100,0,32,32
2014,Honest,M,53,15,17,32
2014,Horacio,M,100,0,32,32
2014,Iverson,M,100,0,32,32
2014,Jaasiel,M,100,0,32,32
2014,Janyah,F,100,32,0,32
2014,Jaquez,M,100,0,32,32
2014,Jaysean,M,100,0,32,32
2014,Jazz,M,62,12,20,32
2014,Jc,M,100,0,32,32
2014,Jerick,M,100,0,32,32
2014,Jese,M,100,0,32,32
2014,Joshuah,M,100,0,32,32
2014,Kaan,M,100,0,32,32
2014,Kacee,F,100,32,0,32
2014,Kaedence,F,100,32,0,32
2014,Kaidon,M,100,0,32,32
2014,Kaleena,F,100,32,0,32
2014,Kamyla,F,100,32,0,32
2014,Kapri,F,100,32,0,32
2014,Karalyn,F,100,32,0,32
2014,Karsynn,F,100,32,0,32
2014,Karthikeya,M,100,0,32,32
2014,Keara,F,100,32,0,32
2014,Kendalynn,F,100,32,0,32
2014,Kera,F,100,32,0,32
2014,Kiefer,M,100,0,32,32
2014,Kieren,M,81,6,26,32
2014,Kohl,M,100,0,32,32
2014,Kreed,M,100,0,32,32
2014,Kristel,F,100,32,0,32
2014,Kristoff,M,100,0,32,32
2014,Kush,M,100,0,32,32
2014,Ky,M,84,5,27,32
2014,Kyngston,M,100,0,32,32
2014,Kynli,F,100,32,0,32
2014,Lainie,F,100,32,0,32
2014,Lanah,F,100,32,0,32
2014,Larenzo,M,100,0,32,32
2014,Lazer,M,100,0,32,32
2014,Leonor,F,100,32,0,32
2014,Lucienne,F,100,32,0,32
2014,Lucile,F,100,32,0,32
2014,Luiz,M,100,0,32,32
2014,Macario,M,100,0,32,32
2014,Madisson,F,100,32,0,32
2014,Madix,M,100,0,32,32
2014,Mahnoor,F,100,32,0,32
2014,Maisyn,F,81,26,6,32
2014,Makoa,M,100,0,32,32
2014,Mariska,F,100,32,0,32
2014,Marnie,F,100,32,0,32
2014,Mazin,M,100,0,32,32
2014,Micayla,F,100,32,0,32
2014,Mikhael,M,100,0,32,32
2014,Nael,M,81,6,26,32
2014,Neema,F,100,32,0,32
2014,Nino,M,100,0,32,32
2014,November,F,100,32,0,32
2014,Nyelle,F,100,32,0,32
2014,Olen,M,100,0,32,32
2014,Oluwanifemi,M,56,14,18,32
2014,Oryan,M,100,0,32,32
2014,Raeann,F,100,32,0,32
2014,Robby,M,100,0,32,32
2014,Roisin,F,100,32,0,32
2014,Romi,F,84,27,5,32
2014,Rosaline,F,100,32,0,32
2014,Rozalyn,F,100,32,0,32
2014,Rubie,F,100,32,0,32
2014,Saint,M,100,0,32,32
2014,Salwa,F,100,32,0,32
2014,Sarena,F,100,32,0,32
2014,Savina,F,100,32,0,32
2014,Schuyler,F,53,17,15,32
2014,Sebastion,M,100,0,32,32
2014,Selvin,M,100,0,32,32
2014,Shana,F,100,32,0,32
2014,Shanel,F,100,32,0,32
2014,Srinika,F,100,32,0,32
2014,Stassi,F,100,32,0,32
2014,Talal,M,100,0,32,32
2014,Tariyah,F,100,32,0,32
2014,Taysom,M,100,0,32,32
2014,Torrin,M,84,5,27,32
2014,Tyshaun,M,100,0,32,32
2014,Vega,F,69,22,10,32
2014,Vivan,M,84,5,27,32
2014,Weldon,M,100,0,32,32
2014,Winry,F,100,32,0,32
2014,Yamir,M,100,0,32,32
2014,Yanis,M,75,8,24,32
2014,Yareth,M,84,5,27,32
2014,Yuridia,F,100,32,0,32
2014,Zamar,M,100,0,32,32
2014,Zylan,M,100,0,32,32
2014,Aadit,M,100,0,31,31
2014,Aamira,F,100,31,0,31
2014,Aariana,F,100,31,0,31
2014,Abdulmalik,M,100,0,31,31
2014,Abran,M,100,0,31,31
2014,Adalberto,M,100,0,31,31
2014,Adali,F,100,31,0,31
2014,Aime,F,100,31,0,31
2014,Aishwarya,F,100,31,0,31
2014,Akai,M,100,0,31,31
2014,Alanys,F,100,31,0,31
2014,Alexxa,F,100,31,0,31
2014,Alida,F,100,31,0,31
2014,Allanah,F,100,31,0,31
2014,Allisyn,F,100,31,0,31
2014,Amadeo,M,100,0,31,31
2014,Amila,F,100,31,0,31
2014,Amon,M,100,0,31,31
2014,Amyia,F,100,31,0,31
2014,Anand,M,100,0,31,31
2014,Angad,M,100,0,31,31
2014,Angelita,F,100,31,0,31
2014,Angelynn,F,100,31,0,31
2014,Annaly,F,100,31,0,31
2014,Antonino,M,100,0,31,31
2014,Arleigh,F,100,31,0,31
2014,Asad,M,100,0,31,31
2014,Ashar,M,100,0,31,31
2014,Audry,F,100,31,0,31
2014,Avila,F,100,31,0,31
2014,Axyl,M,100,0,31,31
2014,Blakelynn,F,100,31,0,31
2014,Branton,M,100,0,31,31
2014,Brayla,F,100,31,0,31
2014,Brigette,F,100,31,0,31
2014,Brilyn,F,84,26,5,31
2014,Broc,M,100,0,31,31
2014,Camora,F,100,31,0,31
2014,Ceasar,M,100,0,31,31
2014,Chadwick,M,100,0,31,31
2014,Charolette,F,100,31,0,31
2014,Chimamanda,F,100,31,0,31
2014,Christie,F,100,31,0,31
2014,Cyncere,M,68,10,21,31
2014,Daisha,F,100,31,0,31
2014,Dany,M,100,0,31,31
2014,Darielle,F,100,31,0,31
2014,Davidson,M,100,0,31,31
2014,Dayvion,M,100,0,31,31
2014,Dekker,M,100,0,31,31
2014,Deklen,M,100,0,31,31
2014,Demar,M,100,0,31,31
2014,Derin,M,61,12,19,31
2014,Devion,M,100,0,31,31
2014,Dez,M,100,0,31,31
2014,Dionte,M,100,0,31,31
2014,Divina,F,100,31,0,31
2014,Dmari,M,100,0,31,31
2014,Dmitry,M,100,0,31,31
2014,Domenick,M,100,0,31,31
2014,Eliab,M,100,0,31,31
2014,Eliud,M,100,0,31,31
2014,Eliya,F,71,22,9,31
2014,Elnathan,M,100,0,31,31
2014,Erian,F,55,17,14,31
2014,Escher,M,100,0,31,31
2014,Evy,F,100,31,0,31
2014,Gabino,M,100,0,31,31
2014,Gautham,M,100,0,31,31
2014,Giacomo,M,100,0,31,31
2014,Gracy,F,100,31,0,31
2014,Hadiya,F,100,31,0,31
2014,Halie,F,100,31,0,31
2014,Harini,F,100,31,0,31
2014,Heavyn,F,100,31,0,31
2014,Henlee,F,100,31,0,31
2014,Hogan,M,100,0,31,31
2014,Ibrahima,M,100,0,31,31
2014,Imaan,F,100,31,0,31
2014,Jaeliana,F,100,31,0,31
2014,Jahziel,M,84,5,26,31
2014,Jakayden,M,100,0,31,31
2014,Jakeem,M,100,0,31,31
2014,Jakhari,M,100,0,31,31
2014,Jancarlo,M,100,0,31,31
2014,Jaymee,F,100,31,0,31
2014,Jayon,M,100,0,31,31
2014,Jayren,M,100,0,31,31
2014,Josilyn,F,100,31,0,31
2014,Jovon,M,100,0,31,31
2014,Juliano,M,100,0,31,31
2014,Julieanna,F,100,31,0,31
2014,Kaeleigh,F,100,31,0,31
2014,Kaeli,F,100,31,0,31
2014,Kaileb,M,100,0,31,31
2014,Kaori,F,100,31,0,31
2014,Katalyna,F,100,31,0,31
2014,Kathia,F,100,31,0,31
2014,Kathrine,F,100,31,0,31
2014,Kayde,M,81,6,25,31
2014,Kaylor,F,52,16,15,31
2014,Keiden,M,100,0,31,31
2014,Kenli,F,100,31,0,31
2014,Kensey,F,100,31,0,31
2014,Keondre,M,100,0,31,31
2014,Khiry,M,100,0,31,31
2014,Kobie,M,58,13,18,31
2014,Korban,M,100,0,31,31
2014,Koy,M,100,0,31,31
2014,Kymari,M,71,9,22,31
2014,Kynnedy,F,100,31,0,31
2014,Kyri,F,71,22,9,31
2014,Lamiya,F,100,31,0,31
2014,Lejla,F,100,31,0,31
2014,Luiza,F,100,31,0,31
2014,Mahad,M,100,0,31,31
2014,Mahala,F,100,31,0,31
2014,Makylah,F,100,31,0,31
2014,Malillany,F,100,31,0,31
2014,Malone,F,61,19,12,31
2014,Marciano,M,100,0,31,31
2014,Mariely,F,100,31,0,31
2014,Martavious,M,100,0,31,31
2014,Martell,M,100,0,31,31
2014,Mavrik,M,100,0,31,31
2014,Maxximus,M,100,0,31,31
2014,Mayci,F,100,31,0,31
2014,Maylani,F,100,31,0,31
2014,Mikey,M,100,0,31,31
2014,Mykal,M,77,7,24,31
2014,Namir,M,100,0,31,31
2014,Nataliya,F,100,31,0,31
2014,Naylah,F,100,31,0,31
2014,Nessa,F,100,31,0,31
2014,Nizhoni,F,100,31,0,31
2014,Noreen,F,100,31,0,31
2014,Nuri,F,52,16,15,31
2014,Olympia,F,100,31,0,31
2014,Oswin,F,61,19,12,31
2014,Page,F,81,25,6,31
2014,Paisyn,F,100,31,0,31
2014,Paradise,F,100,31,0,31
2014,Paxson,M,100,0,31,31
2014,Payge,F,100,31,0,31
2014,Rainy,F,100,31,0,31
2014,Rajon,M,100,0,31,31
2014,Rand,M,58,13,18,31
2014,Reeva,F,100,31,0,31
2014,Renner,M,100,0,31,31
2014,Revan,M,100,0,31,31
2014,Reymundo,M,100,0,31,31
2014,Rhonda,F,100,31,0,31
2014,Rhyleigh,F,100,31,0,31
2014,Ricki,F,84,26,5,31
2014,Riggins,M,100,0,31,31
2014,Rivkah,F,100,31,0,31
2014,Rumaysa,F,100,31,0,31
2014,Samanvi,F,100,31,0,31
2014,Sameera,F,100,31,0,31
2014,Sammi,F,100,31,0,31
2014,Shamya,F,100,31,0,31
2014,Shaylyn,F,100,31,0,31
2014,Sheily,F,100,31,0,31
2014,Sidra,F,100,31,0,31
2014,Sophee,F,100,31,0,31
2014,Srihan,M,100,0,31,31
2014,Stevan,M,100,0,31,31
2014,Sully,M,77,7,24,31
2014,Sundus,F,100,31,0,31
2014,Taggart,M,100,0,31,31
2014,Tamryn,F,100,31,0,31
2014,Taron,M,100,0,31,31
2014,Tayshawn,M,100,0,31,31
2014,Tea,F,100,31,0,31
2014,Tehya,F,100,31,0,31
2014,Tinlee,F,100,31,0,31
2014,Torri,F,84,26,5,31
2014,Vaeda,F,100,31,0,31
2014,Vinh,M,100,0,31,31
2014,Walid,M,100,0,31,31
2014,Yoseph,M,100,0,31,31
2014,Yuki,F,74,23,8,31
2014,Yzabella,F,100,31,0,31
2014,Zackariah,M,100,0,31,31
2014,Zamiya,F,100,31,0,31
2014,Zanya,F,100,31,0,31
2014,Zeb,M,100,0,31,31
2014,Zuzanna,F,100,31,0,31
2014,Aaminah,F,100,30,0,30
2014,Aerilyn,F,100,30,0,30
2014,Ahron,M,100,0,30,30
2014,Ailee,F,100,30,0,30
2014,Airianna,F,100,30,0,30
2014,Ajah,F,100,30,0,30
2014,Alesia,F,100,30,0,30
2014,Aline,F,100,30,0,30
2014,Alleigh,F,100,30,0,30
2014,Alley,F,100,30,0,30
2014,Amanuel,M,100,0,30,30
2014,Amariyah,F,100,30,0,30
2014,Amias,M,100,0,30,30
2014,Anette,F,100,30,0,30
2014,Angelly,F,100,30,0,30
2014,Anmol,M,100,0,30,30
2014,Antione,M,100,0,30,30
2014,Anuhea,F,100,30,0,30
2014,Anusha,F,100,30,0,30
2014,Aolani,F,100,30,0,30
2014,Aran,M,100,0,30,30
2014,Arda,M,100,0,30,30
2014,Ariani,F,100,30,0,30
2014,Aristotle,M,100,0,30,30
2014,Ariyonna,F,100,30,0,30
2014,Arria,F,100,30,0,30
2014,Aubrii,F,100,30,0,30
2014,Auriella,F,100,30,0,30
2014,Avelynn,F,100,30,0,30
2014,Avenir,M,100,0,30,30
2014,Ayce,M,100,0,30,30
2014,Bryelle,F,100,30,0,30
2014,Brynli,F,100,30,0,30
2014,Camrin,M,83,5,25,30
2014,Canton,M,100,0,30,30
2014,Casimir,M,100,0,30,30
2014,Chantelle,F,100,30,0,30
2014,Charissa,F,100,30,0,30
2014,Cherokee,F,100,30,0,30
2014,Christain,M,100,0,30,30
2014,Christon,M,100,0,30,30
2014,Daelynn,F,100,30,0,30
2014,Dakarai,M,100,0,30,30
2014,Dalayza,F,100,30,0,30
2014,Darryn,M,80,6,24,30
2014,Deliah,F,100,30,0,30
2014,Derik,M,100,0,30,30
2014,Dimas,M,100,0,30,30
2014,Dodge,M,100,0,30,30
2014,Domanic,M,100,0,30,30
2014,Eamonn,M,100,0,30,30
2014,Elim,M,57,13,17,30
2014,Elimelech,M,100,0,30,30
2014,Elynn,F,100,30,0,30
2014,Evany,F,100,30,0,30
2014,Ezriel,M,100,0,30,30
2014,Faizan,M,100,0,30,30
2014,Fanny,F,100,30,0,30
2014,Fiorella,F,100,30,0,30
2014,Galilee,F,100,30,0,30
2014,Garen,M,100,0,30,30
2014,Garett,M,100,0,30,30
2014,Ginny,F,100,30,0,30
2014,Giuliano,M,100,0,30,30
2014,Glenda,F,100,30,0,30
2014,Gloriana,F,100,30,0,30
2014,Graycee,F,100,30,0,30
2014,Halia,F,100,30,0,30
2014,Harli,F,100,30,0,30
2014,Heily,F,100,30,0,30
2014,Holton,M,100,0,30,30
2014,Idan,M,100,0,30,30
2014,Isayah,M,100,0,30,30
2014,Ishanvi,F,100,30,0,30
2014,Ivyana,F,100,30,0,30
2014,Izik,M,100,0,30,30
2014,Jadah,F,100,30,0,30
2014,Jahiem,M,100,0,30,30
2014,Jakobie,M,100,0,30,30
2014,Jaleyah,F,100,30,0,30
2014,Jarely,F,100,30,0,30
2014,Jaretzy,F,100,30,0,30
2014,Jasey,F,100,30,0,30
2014,Jassiah,M,100,0,30,30
2014,Jaydee,M,57,13,17,30
2014,Jazlynne,F,100,30,0,30
2014,Jeannette,F,100,30,0,30
2014,Jenaya,F,100,30,0,30
2014,Jolina,F,100,30,0,30
2014,Joshlynn,F,100,30,0,30
2014,Journii,F,100,30,0,30
2014,Kaelan,M,73,8,22,30
2014,Kailin,F,73,22,8,30
2014,Kalum,M,100,0,30,30
2014,Kamyra,F,100,30,0,30
2014,Karolyn,F,100,30,0,30
2014,Kassidee,F,100,30,0,30
2014,Kassius,M,100,0,30,30
2014,Kaylanie,F,100,30,0,30
2014,Kayvon,M,100,0,30,30
2014,Keelin,F,60,18,12,30
2014,Keeton,M,100,0,30,30
2014,Kei,M,83,5,25,30
2014,Kelcie,F,100,30,0,30
2014,Kenzee,F,100,30,0,30
2014,Keston,M,100,0,30,30
2014,Keyra,F,100,30,0,30
2014,Khang,M,100,0,30,30
2014,Kherington,F,100,30,0,30
2014,Kilynn,F,100,30,0,30
2014,Klay,M,100,0,30,30
2014,Knoah,M,100,0,30,30
2014,Kolson,M,100,0,30,30
2014,Kristyn,F,100,30,0,30
2014,Lavina,F,100,30,0,30
2014,Linken,M,100,0,30,30
2014,Macen,M,100,0,30,30
2014,Madalynne,F,100,30,0,30
2014,Maddyx,M,70,9,21,30
2014,Madelaine,F,100,30,0,30
2014,Maebry,F,100,30,0,30
2014,Mahalia,F,100,30,0,30
2014,Mahira,F,100,30,0,30
2014,Malique,M,100,0,30,30
2014,Marigold,F,100,30,0,30
2014,Maryama,F,100,30,0,30
2014,Matthieu,M,100,0,30,30
2014,Maveric,M,100,0,30,30
2014,Maximilliano,M,100,0,30,30
2014,Mckinzie,F,100,30,0,30
2014,Mehdi,M,100,0,30,30
2014,Melrose,F,100,30,0,30
2014,Mesa,F,100,30,0,30
2014,Mily,F,100,30,0,30
2014,Mitchel,M,100,0,30,30
2014,Murad,M,100,0,30,30
2014,Muriel,F,100,30,0,30
2014,Naina,F,100,30,0,30
2014,Nalia,F,100,30,0,30
2014,Nara,F,100,30,0,30
2014,Naudia,F,100,30,0,30
2014,Niki,F,100,30,0,30
2014,Nubia,F,100,30,0,30
2014,Odysseus,M,100,0,30,30
2014,Oliva,F,100,30,0,30
2014,Paden,M,80,6,24,30
2014,Pinchas,M,100,0,30,30
2014,Posey,F,100,30,0,30
2014,Pressley,F,100,30,0,30
2014,Quaid,M,100,0,30,30
2014,Quenton,M,100,0,30,30
2014,Quest,M,100,0,30,30
2014,Raeya,F,100,30,0,30
2014,Rahul,M,100,0,30,30
2014,Railey,F,100,30,0,30
2014,Randal,M,100,0,30,30
2014,Rashel,F,100,30,0,30
2014,Rayann,F,100,30,0,30
2014,Reeves,M,80,6,24,30
2014,Ridhi,F,100,30,0,30
2014,Rohen,M,100,0,30,30
2014,Ronav,M,100,0,30,30
2014,Rueben,M,100,0,30,30
2014,Sachi,F,100,30,0,30
2014,Sadia,F,100,30,0,30
2014,Saharsh,M,100,0,30,30
2014,Saliyah,F,100,30,0,30
2014,Santhiago,M,100,0,30,30
2014,Shamari,F,57,17,13,30
2014,Shamir,M,100,0,30,30
2014,Shreeya,F,100,30,0,30
2014,Shyloh,F,73,22,8,30
2014,Siraj,M,100,0,30,30
2014,Sofi,F,100,30,0,30
2014,Summit,M,100,0,30,30
2014,Sunni,F,100,30,0,30
2014,Taim,M,100,0,30,30
2014,Tarun,M,100,0,30,30
2014,Tayah,F,100,30,0,30
2014,Taylah,F,100,30,0,30
2014,Thais,F,100,30,0,30
2014,Tramaine,M,100,0,30,30
2014,Tyrian,M,80,6,24,30
2014,Usher,M,100,0,30,30
2014,Valente,M,100,0,30,30
2014,Vinson,M,100,0,30,30
2014,Virat,M,100,0,30,30
2014,Viviane,F,100,30,0,30
2014,Xaria,F,100,30,0,30
2014,Yaniel,M,100,0,30,30
2014,Yanni,M,63,11,19,30
2014,Zayveon,M,100,0,30,30
2014,Zhane,F,63,19,11,30
2014,Zina,F,100,30,0,30
2014,Zurisadai,F,100,30,0,30
2014,Zury,F,100,30,0,30
2014,Abubakr,M,100,0,29,29
2014,Adarius,M,100,0,29,29
2014,Addilee,F,100,29,0,29
2014,Adelaine,F,100,29,0,29
2014,Adrionna,F,100,29,0,29
2014,Ailynn,F,100,29,0,29
2014,Alasdair,M,100,0,29,29
2014,Alayshia,F,100,29,0,29
2014,Aldon,M,100,0,29,29
2014,Aleaha,F,100,29,0,29
2014,Aleenah,F,100,29,0,29
2014,Alfonzo,M,100,0,29,29
2014,Allyana,F,100,29,0,29
2014,Alyiah,F,100,29,0,29
2014,Amarachi,F,100,29,0,29
2014,Amarianna,F,100,29,0,29
2014,Amran,F,83,24,5,29
2014,Aneesa,F,100,29,0,29
2014,Annamaria,F,100,29,0,29
2014,Aradhya,F,100,29,0,29
2014,Arilyn,F,100,29,0,29
2014,Athziri,F,100,29,0,29
2014,Aubryn,F,100,29,0,29
2014,Audrielle,F,100,29,0,29
2014,Avaline,F,100,29,0,29
2014,Ayansh,M,100,0,29,29
2014,Baine,M,100,0,29,29
2014,Bayler,M,66,10,19,29
2014,Braddock,M,100,0,29,29
2014,Braeleigh,F,100,29,0,29
2014,Brandan,M,100,0,29,29
2014,Breeze,F,72,21,8,29
2014,Caileigh,F,100,29,0,29
2014,Calee,F,100,29,0,29
2014,Calissa,F,100,29,0,29
2014,Carmel,F,72,21,8,29
2014,Cashel,M,100,0,29,29
2014,Caston,M,100,0,29,29
2014,Caydon,M,100,0,29,29
2014,Chantel,F,100,29,0,29
2014,Charm,F,100,29,0,29
2014,Chizaram,F,79,23,6,29
2014,Corinna,F,100,29,0,29
2014,Cozette,F,100,29,0,29
2014,Darey,M,100,0,29,29
2014,Darina,F,100,29,0,29
2014,Darling,F,100,29,0,29
2014,Darrick,M,100,0,29,29
2014,Daxten,M,100,0,29,29
2014,Dayvon,M,100,0,29,29
2014,Deante,M,100,0,29,29
2014,Deeksha,F,100,29,0,29
2014,Demetrio,M,100,0,29,29
2014,Derwin,M,100,0,29,29
2014,Destyn,M,69,9,20,29
2014,Dhriti,F,100,29,0,29
2014,Divinity,F,100,29,0,29
2014,Donta,M,100,0,29,29
2014,Doreen,F,100,29,0,29
2014,Drayson,M,100,0,29,29
2014,Dreya,F,100,29,0,29
2014,Ebrahim,M,100,0,29,29
2014,Edelyn,F,100,29,0,29
2014,Edwyn,M,100,0,29,29
2014,Eleena,F,100,29,0,29
2014,Eleora,F,100,29,0,29
2014,Ellamarie,F,100,29,0,29
2014,Enmanuel,M,100,0,29,29
2014,Evelyne,F,100,29,0,29
2014,Ezabella,F,100,29,0,29
2014,Ezana,M,100,0,29,29
2014,Fanta,F,100,29,0,29
2014,Favor,F,100,29,0,29
2014,Gabryel,M,100,0,29,29
2014,Georgette,F,100,29,0,29
2014,Gryphon,M,100,0,29,29
2014,Halston,M,55,13,16,29
2014,Heba,F,100,29,0,29
2014,Hillel,M,100,0,29,29
2014,Hisham,M,100,0,29,29
2014,Iann,M,100,0,29,29
2014,Idalia,F,100,29,0,29
2014,Izabellah,F,100,29,0,29
2014,Jacolby,M,100,0,29,29
2014,Jacquelynn,F,100,29,0,29
2014,Jailen,M,100,0,29,29
2014,Jakiya,F,100,29,0,29
2014,Jala,F,100,29,0,29
2014,Jamyla,F,100,29,0,29
2014,Janine,F,100,29,0,29
2014,Jarius,M,100,0,29,29
2014,Jaselle,F,100,29,0,29
2014,Jashaun,M,100,0,29,29
2014,Jaxiel,M,100,0,29,29
2014,Jayani,F,100,29,0,29
2014,Jeanelle,F,100,29,0,29
2014,Jennica,F,100,29,0,29
2014,Jewelz,F,76,22,7,29
2014,Jhon,M,100,0,29,29
2014,Justis,M,76,7,22,29
2014,Kaizley,F,100,29,0,29
2014,Kalib,M,100,0,29,29
2014,Kamori,F,69,20,9,29
2014,Kanoa,M,100,0,29,29
2014,Karlo,M,100,0,29,29
2014,Kashmere,M,52,14,15,29
2014,Kayci,F,100,29,0,29
2014,Keelie,F,100,29,0,29
2014,Keylen,M,62,11,18,29
2014,Koral,F,100,29,0,29
2014,Kyndra,F,100,29,0,29
2014,Laelah,F,100,29,0,29
2014,Lakayla,F,100,29,0,29
2014,Lakynn,F,100,29,0,29
2014,Laveah,F,100,29,0,29
2014,Leianna,F,100,29,0,29
2014,Livy,F,100,29,0,29
2014,Lliam,M,100,0,29,29
2014,Loryn,F,100,29,0,29
2014,Lyon,M,100,0,29,29
2014,Maesyn,F,76,22,7,29
2014,Mareli,F,100,29,0,29
2014,Meelah,F,100,29,0,29
2014,Meleah,F,100,29,0,29
2014,Menucha,F,100,29,0,29
2014,Meryl,F,100,29,0,29
2014,Meya,F,100,29,0,29
2014,Milliana,F,100,29,0,29
2014,Minka,F,100,29,0,29
2014,Nailea,F,100,29,0,29
2014,Nakayla,F,100,29,0,29
2014,Nassir,M,100,0,29,29
2014,Nayah,F,100,29,0,29
2014,Nevada,F,76,22,7,29
2014,Nicco,M,100,0,29,29
2014,Nicholai,M,100,0,29,29
2014,Nikolay,M,100,0,29,29
2014,Nishka,F,100,29,0,29
2014,Paysen,F,76,22,7,29
2014,Penina,F,100,29,0,29
2014,Pheonix,M,62,11,18,29
2014,Pranavi,F,100,29,0,29
2014,Quetzalli,F,100,29,0,29
2014,Racheal,F,100,29,0,29
2014,Rafaella,F,100,29,0,29
2014,Rajveer,M,100,0,29,29
2014,Rashaud,M,100,0,29,29
2014,Renatta,F,100,29,0,29
2014,Rickie,M,79,6,23,29
2014,Rigby,M,79,6,23,29
2014,Ritchie,M,100,0,29,29
2014,Romero,M,100,0,29,29
2014,Roran,M,100,0,29,29
2014,Roseanna,F,100,29,0,29
2014,Rubin,M,100,0,29,29
2014,Ryli,F,100,29,0,29
2014,Saba,F,83,24,5,29
2014,Safiyah,F,100,29,0,29
2014,Saketh,M,100,0,29,29
2014,Samyah,F,100,29,0,29
2014,Sayla,F,100,29,0,29
2014,Seraphine,F,100,29,0,29
2014,Shailene,F,100,29,0,29
2014,Suraya,F,100,29,0,29
2014,Taelor,F,100,29,0,29
2014,Taiden,M,100,0,29,29
2014,Takiyah,F,100,29,0,29
2014,Tasnim,F,100,29,0,29
2014,Thayne,M,100,0,29,29
2014,Tracen,M,100,0,29,29
2014,Trentyn,M,100,0,29,29
2014,Tzipora,F,100,29,0,29
2014,Vibha,F,100,29,0,29
2014,Vincente,M,100,0,29,29
2014,Walt,M,100,0,29,29
2014,Ward,M,100,0,29,29
2014,Waseem,M,100,0,29,29
2014,Whitten,M,83,5,24,29
2014,Yan,M,100,0,29,29
2014,Yelitza,F,100,29,0,29
2014,Zaelyn,F,52,15,14,29
2014,Zian,M,100,0,29,29
2014,Zunairah,F,100,29,0,29
2014,Zyasia,F,100,29,0,29
2014,Abbigayle,F,100,28,0,28
2014,Adama,F,50,14,14,28
2014,Adya,F,100,28,0,28
2014,Aero,M,61,11,17,28
2014,Ainsleigh,F,100,28,0,28
2014,Alanzo,M,100,0,28,28
2014,Albany,F,100,28,0,28
2014,Aleiyah,F,100,28,0,28
2014,Alias,M,100,0,28,28
2014,Alitza,F,100,28,0,28
2014,Alizee,F,100,28,0,28
2014,Amirra,F,100,28,0,28
2014,Amr,M,100,0,28,28
2014,Andreya,F,100,28,0,28
2014,Arsh,M,100,0,28,28
2014,Ashur,M,100,0,28,28
2014,Asim,M,100,0,28,28
2014,Atleigh,F,100,28,0,28
2014,Aubreanna,F,100,28,0,28
2014,Aviah,F,100,28,0,28
2014,Avree,F,100,28,0,28
2014,Avyukt,M,100,0,28,28
2014,Aylani,F,100,28,0,28
2014,Ayrabella,F,100,28,0,28
2014,Bauer,M,100,0,28,28
2014,Baya,F,100,28,0,28
2014,Benyamin,M,100,0,28,28
2014,Braven,M,100,0,28,28
2014,Breslyn,F,100,28,0,28
2014,Cary,M,75,7,21,28
2014,Cavin,M,100,0,28,28
2014,Champ,M,100,0,28,28
2014,Chelsy,F,100,28,0,28
2014,Consuelo,F,100,28,0,28
2014,Cordero,M,100,0,28,28
2014,Cove,M,79,6,22,28
2014,Creedence,M,57,12,16,28
2014,Daegan,M,82,5,23,28
2014,Danah,F,100,28,0,28
2014,Dariela,F,100,28,0,28
2014,Daryn,M,61,11,17,28
2014,Dastan,M,100,0,28,28
2014,Davy,M,68,9,19,28
2014,Dayron,M,100,0,28,28
2014,Deana,F,100,28,0,28
2014,Dejon,M,100,0,28,28
2014,Delta,F,100,28,0,28
2014,Derrion,M,100,0,28,28
2014,Eira,F,100,28,0,28
2014,Elianny,F,100,28,0,28
2014,Elijiah,M,100,0,28,28
2014,Elisabet,F,100,28,0,28
2014,Elysa,F,100,28,0,28
2014,Emeric,M,100,0,28,28
2014,Emmalynne,F,100,28,0,28
2014,Esma,F,100,28,0,28
2014,Essie,F,100,28,0,28
2014,Etienne,M,100,0,28,28
2014,Faustino,M,100,0,28,28
2014,Flavio,M,100,0,28,28
2014,Gerrit,M,100,0,28,28
2014,Hajar,F,100,28,0,28
2014,Harland,M,100,0,28,28
2014,Harlo,F,75,21,7,28
2014,Henleigh,F,100,28,0,28
2014,Hinley,F,100,28,0,28
2014,Homer,M,100,0,28,28
2014,Hutch,M,100,0,28,28
2014,Ihsan,M,100,0,28,28
2014,Ilia,F,75,21,7,28
2014,Isamar,F,100,28,0,28
2014,Itzabella,F,100,28,0,28
2014,Izael,M,100,0,28,28
2014,Jacksen,M,100,0,28,28
2014,Jacksyn,M,61,11,17,28
2014,Jacori,M,100,0,28,28
2014,Jaidah,F,100,28,0,28
2014,Jaiyana,F,100,28,0,28
2014,Janiece,F,100,28,0,28
2014,Jaryn,M,71,8,20,28
2014,Jaymeson,M,79,6,22,28
2014,Jazel,F,100,28,0,28
2014,Jibreel,M,100,0,28,28
2014,Jihad,M,100,0,28,28
2014,Jobe,M,100,0,28,28
2014,Jolin,F,57,16,12,28
2014,Juandiego,M,100,0,28,28
2014,Juanjose,M,100,0,28,28
2014,Jun,M,82,5,23,28
2014,Kaelee,F,100,28,0,28
2014,Kaimana,M,79,6,22,28
2014,Kaliya,F,100,28,0,28
2014,Karsin,M,79,6,22,28
2014,Keeleigh,F,100,28,0,28
2014,Keldon,M,100,0,28,28
2014,Kerri,F,100,28,0,28
2014,Kimiko,F,100,28,0,28
2014,Koah,M,100,0,28,28
2014,Kollins,F,79,22,6,28
2014,Krue,M,100,0,28,28
2014,Kynadee,F,100,28,0,28
2014,Kynzlie,F,100,28,0,28
2014,Lamees,F,100,28,0,28
2014,Lanyah,F,100,28,0,28
2014,Lareen,F,100,28,0,28
2014,Larkyn,F,100,28,0,28
2014,Larsen,M,75,7,21,28
2014,Layth,M,100,0,28,28
2014,Leeam,M,100,0,28,28
2014,Leelah,F,100,28,0,28
2014,Leilana,F,100,28,0,28
2014,Leonie,F,100,28,0,28
2014,Liliann,F,100,28,0,28
2014,Lorielle,F,100,28,0,28
2014,Madisynn,F,100,28,0,28
2014,Maisen,M,75,7,21,28
2014,Makel,M,100,0,28,28
2014,Makennah,F,100,28,0,28
2014,Malaina,F,100,28,0,28
2014,Malaiya,F,100,28,0,28
2014,Mana,F,71,20,8,28
2014,Markeith,M,100,0,28,28
2014,Maryelizabeth,F,100,28,0,28
2014,Masiyah,F,61,17,11,28
2014,Mckaylee,F,100,28,0,28
2014,Meila,F,100,28,0,28
2014,Mekayla,F,100,28,0,28
2014,Merari,F,100,28,0,28
2014,Mikell,M,100,0,28,28
2014,Milynn,F,100,28,0,28
2014,Mostafa,M,100,0,28,28
2014,Mouhamed,M,100,0,28,28
2014,Muad,M,100,0,28,28
2014,Neah,F,100,28,0,28
2014,Neala,F,100,28,0,28
2014,Neri,M,54,13,15,28
2014,Niara,F,100,28,0,28
2014,Nona,F,100,28,0,28
2014,Nyree,F,100,28,0,28
2014,Omega,M,57,12,16,28
2014,Omri,M,100,0,28,28
2014,Onna,F,100,28,0,28
2014,Oran,M,100,0,28,28
2014,Orla,F,100,28,0,28
2014,Paiton,F,100,28,0,28
2014,Perel,F,100,28,0,28
2014,Rachell,F,100,28,0,28
2014,Rahim,M,100,0,28,28
2014,Rakim,M,100,0,28,28
2014,Raneem,F,100,28,0,28
2014,Renesmae,F,100,28,0,28
2014,Rodger,M,100,0,28,28
2014,Sahas,M,100,0,28,28
2014,Saina,F,100,28,0,28
2014,Samone,F,100,28,0,28
2014,Sayra,F,100,28,0,28
2014,Severin,M,100,0,28,28
2014,Shakur,M,100,0,28,28
2014,Sharif,M,100,0,28,28
2014,Shaye,F,64,18,10,28
2014,Shivansh,M,100,0,28,28
2014,Siddhant,M,100,0,28,28
2014,Soha,F,100,28,0,28
2014,Suhayla,F,100,28,0,28
2014,Sumaiya,F,100,28,0,28
2014,Suzie,F,100,28,0,28
2014,Tafari,M,100,0,28,28
2014,Tavaris,M,100,0,28,28
2014,Taym,M,100,0,28,28
2014,Tehila,F,100,28,0,28
2014,Terell,M,100,0,28,28
2014,Tionna,F,100,28,0,28
2014,Tycen,M,100,0,28,28
2014,Tyriq,M,100,0,28,28
2014,Vaani,F,100,28,0,28
2014,Vanya,F,100,28,0,28
2014,Vidal,M,100,0,28,28
2014,Vinay,M,100,0,28,28
2014,Walden,M,100,0,28,28
2014,Wilfred,M,100,0,28,28
2014,Xzavian,M,100,0,28,28
2014,Yareni,F,100,28,0,28
2014,Yazleemar,F,100,28,0,28
2014,Yeimy,F,100,28,0,28
2014,Yeshaya,M,100,0,28,28
2014,Yonah,M,100,0,28,28
2014,Zamaria,F,100,28,0,28
2014,Zanna,F,100,28,0,28
2014,Zaydan,M,100,0,28,28
2014,Zaydon,M,100,0,28,28
2014,Adeena,F,100,27,0,27
2014,Adhya,F,100,27,0,27
2014,Aili,F,100,27,0,27
2014,Aira,F,100,27,0,27
2014,Aishah,F,100,27,0,27
2014,Aissatou,F,100,27,0,27
2014,Alaila,F,100,27,0,27
2014,Alenna,F,100,27,0,27
2014,Alexah,F,100,27,0,27
2014,Alexey,M,100,0,27,27
2014,Alicen,F,100,27,0,27
2014,Alphonso,M,100,0,27,27
2014,Alyx,F,78,21,6,27
2014,Amarri,M,59,11,16,27
2014,Amiel,M,81,5,22,27
2014,Amity,F,100,27,0,27
2014,Anabeth,F,100,27,0,27
2014,Anahy,F,100,27,0,27
2014,Angelli,F,100,27,0,27
2014,Anila,F,100,27,0,27
2014,Annalea,F,100,27,0,27
2014,Annamae,F,100,27,0,27
2014,Anvita,F,100,27,0,27
2014,Armonie,F,81,22,5,27
2014,Ascher,M,100,0,27,27
2014,Asiel,M,100,0,27,27
2014,Athen,M,100,0,27,27
2014,Auron,M,100,0,27,27
2014,Avagrace,F,100,27,0,27
2014,Averly,F,100,27,0,27
2014,Aylee,F,100,27,0,27
2014,Azaliah,F,100,27,0,27
2014,Azarias,M,100,0,27,27
2014,Azuri,F,100,27,0,27
2014,Bibiana,F,100,27,0,27
2014,Bless,M,59,11,16,27
2014,Braxtin,M,100,0,27,27
2014,Brelyn,F,100,27,0,27
2014,Brenten,M,100,0,27,27
2014,Brevyn,M,100,0,27,27
2014,Brodrick,M,100,0,27,27
2014,Bryceson,M,100,0,27,27
2014,Burhanuddin,M,100,0,27,27
2014,Burton,M,100,0,27,27
2014,Cadance,F,100,27,0,27
2014,Cage,M,100,0,27,27
2014,Callee,F,100,27,0,27
2014,Calloway,M,74,7,20,27
2014,Camarion,M,100,0,27,27
2014,Carston,M,100,0,27,27
2014,Cashius,M,100,0,27,27
2014,Cassiel,M,81,5,22,27
2014,Cathleen,F,100,27,0,27
2014,Cayman,M,78,6,21,27
2014,Chastity,F,100,27,0,27
2014,Chrislyn,F,100,27,0,27
2014,Chrislynn,F,100,27,0,27
2014,Christan,M,100,0,27,27
2014,Cloud,M,100,0,27,27
2014,Cobie,M,56,12,15,27
2014,Collyns,F,100,27,0,27
2014,Courtlyn,F,100,27,0,27
2014,Dalylah,F,100,27,0,27
2014,Darcie,F,100,27,0,27
2014,Dartagnan,M,100,0,27,27
2014,Daya,F,100,27,0,27
2014,Delana,F,100,27,0,27
2014,Demetris,M,100,0,27,27
2014,Demitrius,M,100,0,27,27
2014,Dereon,M,74,7,20,27
2014,Derrell,M,100,0,27,27
2014,Desteny,F,100,27,0,27
2014,Devine,F,78,21,6,27
2014,Dexton,M,100,0,27,27
2014,Dezire,F,100,27,0,27
2014,Dillinger,M,100,0,27,27
2014,Dirk,M,100,0,27,27
2014,Donell,M,100,0,27,27
2014,Dontavious,M,100,0,27,27
2014,Dorothea,F,100,27,0,27
2014,Dreyden,M,100,0,27,27
2014,Duaa,F,100,27,0,27
2014,Eathan,M,100,0,27,27
2014,Eleen,F,100,27,0,27
2014,Elexis,F,100,27,0,27
2014,Elma,F,100,27,0,27
2014,Emmajean,F,100,27,0,27
2014,Emmelia,F,100,27,0,27
2014,Emmilyn,F,100,27,0,27
2014,Envy,F,100,27,0,27
2014,Erickson,M,100,0,27,27
2014,Euan,M,100,0,27,27
2014,Evana,F,100,27,0,27
2014,Evee,F,100,27,0,27
2014,Eyden,M,100,0,27,27
2014,Fabrizio,M,100,0,27,27
2014,Gigi,F,100,27,0,27
2014,Graycie,F,100,27,0,27
2014,Greg,M,100,0,27,27
2014,Griffen,M,100,0,27,27
2014,Guiliana,F,100,27,0,27
2014,Hansen,M,100,0,27,27
2014,Harmonii,F,100,27,0,27
2014,Harnoor,F,81,22,5,27
2014,Hilton,M,78,6,21,27
2014,Hridhaan,M,100,0,27,27
2014,Idalie,F,100,27,0,27
2014,Illyana,F,100,27,0,27
2014,Iram,M,100,0,27,27
2014,Isak,M,100,0,27,27
2014,Ivyonna,F,100,27,0,27
2014,Jabez,M,100,0,27,27
2014,Jaia,F,100,27,0,27
2014,Jalena,F,100,27,0,27
2014,Jamell,M,100,0,27,27
2014,Janayah,F,100,27,0,27
2014,January,F,100,27,0,27
2014,Jayline,F,100,27,0,27
2014,Jaymar,M,100,0,27,27
2014,Jeanluc,M,100,0,27,27
2014,Jeb,M,100,0,27,27
2014,Jenae,F,100,27,0,27
2014,Jerzey,F,100,27,0,27
2014,Jlynn,F,100,27,0,27
2014,Johndavid,M,100,0,27,27
2014,Joycelyn,F,100,27,0,27
2014,Jozef,M,100,0,27,27
2014,Jozlynn,F,100,27,0,27
2014,Jr,M,100,0,27,27
2014,Kadeem,M,100,0,27,27
2014,Kadie,F,100,27,0,27
2014,Kailea,F,100,27,0,27
2014,Kalil,M,100,0,27,27
2014,Kamarie,F,74,20,7,27
2014,Karalynn,F,100,27,0,27
2014,Kaven,M,100,0,27,27
2014,Kaybree,F,100,27,0,27
2014,Kayceon,M,100,0,27,27
2014,Kean,M,100,0,27,27
2014,Keirra,F,100,27,0,27
2014,Kelani,F,70,19,8,27
2014,Kelsy,F,100,27,0,27
2014,Kemarion,M,100,0,27,27
2014,Kemoni,M,56,12,15,27
2014,Khaleah,F,100,27,0,27
2014,Kierstin,F,100,27,0,27
2014,Kristianna,F,100,27,0,27
2014,Kymir,M,100,0,27,27
2014,Kymora,F,100,27,0,27
2014,Kyndell,F,74,20,7,27
2014,Kyrell,M,100,0,27,27
2014,Laycee,F,100,27,0,27
2014,Leighann,F,100,27,0,27
2014,Linh,F,100,27,0,27
2014,Livi,F,100,27,0,27
2014,Livie,F,100,27,0,27
2014,Lujain,F,100,27,0,27
2014,Lukasz,M,100,0,27,27
2014,Lynleigh,F,100,27,0,27
2014,Mackynzie,F,100,27,0,27
2014,Maddalena,F,100,27,0,27
2014,Maddon,M,100,0,27,27
2014,Magdalen,F,100,27,0,27
2014,Mahathi,F,100,27,0,27
2014,Makenlee,F,100,27,0,27
2014,Manahil,F,100,27,0,27
2014,Manolo,M,100,0,27,27
2014,Manya,F,100,27,0,27
2014,Marilu,F,100,27,0,27
2014,Maryan,F,100,27,0,27
2014,Maximino,M,100,0,27,27
2014,Merek,M,100,0,27,27
2014,Michell,F,100,27,0,27
2014,Mihika,F,100,27,0,27
2014,Miliani,F,100,27,0,27
2014,Mirel,F,100,27,0,27
2014,Miri,F,100,27,0,27
2014,Mirna,F,100,27,0,27
2014,Neena,F,100,27,0,27
2014,Niang,F,100,27,0,27
2014,Nicklaus,M,100,0,27,27
2014,Niomi,F,100,27,0,27
2014,Novak,M,100,0,27,27
2014,Nydia,F,100,27,0,27
2014,Oak,M,100,0,27,27
2014,Oluwadamilola,F,74,20,7,27
2014,Ora,F,100,27,0,27
2014,Oswald,M,100,0,27,27
2014,Oz,M,100,0,27,27
2014,Paitynn,F,100,27,0,27
2014,Paytin,F,100,27,0,27
2014,Paytyn,F,100,27,0,27
2014,Pricilla,F,100,27,0,27
2014,Rees,M,81,5,22,27
2014,Remedy,F,100,27,0,27
2014,Renley,F,63,17,10,27
2014,Riona,F,100,27,0,27
2014,Risa,F,100,27,0,27
2014,Riyah,F,100,27,0,27
2014,Rumi,F,63,17,10,27
2014,Salena,F,100,27,0,27
2014,Sera,F,100,27,0,27
2014,Serah,F,100,27,0,27
2014,Shayleigh,F,100,27,0,27
2014,Shelbi,F,100,27,0,27
2014,Shourya,M,100,0,27,27
2014,Shriyan,M,100,0,27,27
2014,Shruti,F,100,27,0,27
2014,Sneha,F,100,27,0,27
2014,Sophiah,F,100,27,0,27
2014,Stephania,F,100,27,0,27
2014,Sudais,M,100,0,27,27
2014,Tallon,M,100,0,27,27
2014,Tanaya,F,100,27,0,27
2014,Taten,M,100,0,27,27
2014,Tej,M,100,0,27,27
2014,Teodor,M,100,0,27,27
2014,Thien,M,100,0,27,27
2014,Tito,M,100,0,27,27
2014,Tobyn,M,74,7,20,27
2014,Trina,F,100,27,0,27
2014,Vaibhav,M,100,0,27,27
2014,Veyda,F,100,27,0,27
2014,Vladislav,M,100,0,27,27
2014,Weslyn,F,70,19,8,27
2014,Xoe,F,100,27,0,27
2014,Yechezkel,M,100,0,27,27
2014,Zadyn,M,100,0,27,27
2014,Zahava,F,100,27,0,27
2014,Zayaan,M,100,0,27,27
2014,Zosia,F,100,27,0,27
2014,Aahan,M,100,0,26,26
2014,Aaira,F,100,26,0,26
2014,Aariv,M,100,0,26,26
2014,Aasiyah,F,100,26,0,26
2014,Aayansh,M,100,0,26,26
2014,Abbagail,F,100,26,0,26
2014,Abdelrahman,M,100,0,26,26
2014,Abdias,M,100,0,26,26
2014,Abdoulaye,M,100,0,26,26
2014,Abdulahi,M,100,0,26,26
2014,Adon,M,100,0,26,26
2014,Adrik,M,100,0,26,26
2014,Aerin,F,100,26,0,26
2014,Ahri,F,100,26,0,26
2014,Ahsan,M,100,0,26,26
2014,Ahsha,F,100,26,0,26
2014,Aishani,F,100,26,0,26
2014,Akasha,F,100,26,0,26
2014,Akil,M,100,0,26,26
2014,Aldair,M,100,0,26,26
2014,Aleister,M,100,0,26,26
2014,Alesha,F,100,26,0,26
2014,Alexzandria,F,100,26,0,26
2014,Alitzel,F,100,26,0,26
2014,Allyn,F,69,18,8,26
2014,Alphonse,M,100,0,26,26
2014,Amit,M,100,0,26,26
2014,Analynn,F,100,26,0,26
2014,Anishka,F,100,26,0,26
2014,Annastasia,F,100,26,0,26
2014,Aras,M,100,0,26,26
2014,Armen,M,100,0,26,26
2014,Arshan,M,100,0,26,26
2014,Arun,M,100,0,26,26
2014,Aryanah,F,100,26,0,26
2014,Asaph,M,100,0,26,26
2014,Ashely,F,100,26,0,26
2014,Auriel,F,73,19,7,26
2014,Aviya,F,100,26,0,26
2014,Avri,F,100,26,0,26
2014,Aziya,F,100,26,0,26
2014,Basya,F,100,26,0,26
2014,Beauregard,M,100,0,26,26
2014,Benzion,M,100,0,26,26
2014,Betsabe,F,100,26,0,26
2014,Blakley,F,100,26,0,26
2014,Blas,M,100,0,26,26
2014,Bogdan,M,100,0,26,26
2014,Boruch,M,100,0,26,26
2014,Boy,M,100,0,26,26
2014,Braedan,M,100,0,26,26
2014,Braycen,M,100,0,26,26
2014,Bruchy,F,100,26,0,26
2014,Brysin,M,100,0,26,26
2014,Cache,M,100,0,26,26
2014,Camry,F,69,18,8,26
2014,Captain,M,100,0,26,26
2014,Caron,M,100,0,26,26
2014,Caylen,F,100,26,0,26
2014,Celestina,F,100,26,0,26
2014,Chizara,F,100,26,0,26
2014,Clarisa,F,100,26,0,26
2014,Cleveland,M,100,0,26,26
2014,Conall,M,100,0,26,26
2014,Connell,M,100,0,26,26
2014,Cord,M,100,0,26,26
2014,Crispin,M,100,0,26,26
2014,Crixus,M,100,0,26,26
2014,Dade,M,100,0,26,26
2014,Daleiza,F,100,26,0,26
2014,Damonte,M,100,0,26,26
2014,Dariya,F,100,26,0,26
2014,Darvin,M,100,0,26,26
2014,Defne,F,100,26,0,26
2014,Derion,M,100,0,26,26
2014,Devynn,F,100,26,0,26
2014,Diondre,M,100,0,26,26
2014,Donato,M,100,0,26,26
2014,Dustyn,M,100,0,26,26
2014,Egan,M,100,0,26,26
2014,Eiliyah,F,100,26,0,26
2014,Elanna,F,100,26,0,26
2014,Elizah,F,100,26,0,26
2014,Ellarose,F,100,26,0,26
2014,Elleanna,F,100,26,0,26
2014,Eron,M,100,0,26,26
2014,Evangelia,F,100,26,0,26
2014,Florencia,F,100,26,0,26
2014,Gemini,F,73,19,7,26
2014,Genisis,F,100,26,0,26
2014,Germani,F,100,26,0,26
2014,Germany,F,81,21,5,26
2014,Gianmarco,M,100,0,26,26
2014,Gittel,F,100,26,0,26
2014,Goldy,F,100,26,0,26
2014,Gracelynne,F,100,26,0,26
2014,Graison,M,100,0,26,26
2014,Gwendolynn,F,100,26,0,26
2014,Hari,M,100,0,26,26
2014,Heiress,F,100,26,0,26
2014,Husna,F,100,26,0,26
2014,Ilah,F,100,26,0,26
2014,Indica,F,100,26,0,26
2014,Ishita,F,100,26,0,26
2014,Iven,M,100,0,26,26
2014,Jabriel,M,100,0,26,26
2014,Jacinta,F,100,26,0,26
2014,Jacinto,M,100,0,26,26
2014,Jacobe,M,100,0,26,26
2014,Jamyra,F,100,26,0,26
2014,Javeah,F,100,26,0,26
2014,Javontae,M,100,0,26,26
2014,Jebediah,M,100,0,26,26
2014,Jetson,M,100,0,26,26
2014,Joely,F,100,26,0,26
2014,Joesiah,M,100,0,26,26
2014,Jordann,F,73,19,7,26
2014,Joshlyn,F,100,26,0,26
2014,Jovian,M,100,0,26,26
2014,Julyssa,F,100,26,0,26
2014,Juna,F,100,26,0,26
2014,Jupiter,M,77,6,20,26
2014,Kaelani,F,100,26,0,26
2014,Kaiah,F,100,26,0,26
2014,Kalissa,F,100,26,0,26
2014,Kanaan,M,100,0,26,26
2014,Kashlyn,F,100,26,0,26
2014,Kayanna,F,100,26,0,26
2014,Kaytlin,F,100,26,0,26
2014,Kendrix,M,100,0,26,26
2014,Kenyan,M,100,0,26,26
2014,Kessler,M,100,0,26,26
2014,Khoi,M,77,6,20,26
2014,Khyla,F,100,26,0,26
2014,Kimball,M,81,5,21,26
2014,Klaus,M,100,0,26,26
2014,Kristi,F,100,26,0,26
2014,Kriti,F,100,26,0,26
2014,Kyre,M,77,6,20,26
2014,Laasya,F,100,26,0,26
2014,Laiya,F,100,26,0,26
2014,Lakai,M,77,6,20,26
2014,Laquan,M,100,0,26,26
2014,Latham,M,100,0,26,26
2014,Latoya,F,100,26,0,26
2014,Leeya,F,100,26,0,26
2014,Lesli,F,100,26,0,26
2014,Linsey,F,100,26,0,26
2014,Logyn,F,54,14,12,26
2014,Lyana,F,100,26,0,26
2014,Lynsey,F,100,26,0,26
2014,Maahi,F,100,26,0,26
2014,Maely,F,100,26,0,26
2014,Mahari,F,69,18,8,26
2014,Maizey,F,100,26,0,26
2014,Makyah,F,100,26,0,26
2014,Mallori,F,100,26,0,26
2014,Manasseh,M,100,0,26,26
2014,Marietta,F,100,26,0,26
2014,Marya,F,100,26,0,26
2014,Maryanna,F,100,26,0,26
2014,Marygrace,F,100,26,0,26
2014,Matan,M,100,0,26,26
2014,Maynor,M,100,0,26,26
2014,Meliah,F,100,26,0,26
2014,Melodee,F,100,26,0,26
2014,Mikal,M,81,5,21,26
2014,Mikyla,F,100,26,0,26
2014,Milaya,F,100,26,0,26
2014,Mireille,F,100,26,0,26
2014,Mishika,F,100,26,0,26
2014,Mulan,F,100,26,0,26
2014,Mykell,M,100,0,26,26
2014,Nabila,F,100,26,0,26
2014,Nadiyah,F,100,26,0,26
2014,Naftuli,M,100,0,26,26
2014,Nahom,M,100,0,26,26
2014,Nakiyah,F,100,26,0,26
2014,Nayelis,F,100,26,0,26
2014,Nisha,F,100,26,0,26
2014,Nylee,F,100,26,0,26
2014,Nyssa,F,100,26,0,26
2014,Oumou,F,100,26,0,26
2014,Quintus,M,100,0,26,26
2014,Quorra,F,100,26,0,26
2014,Raedyn,F,65,17,9,26
2014,Rayanne,F,100,26,0,26
2014,Rayhan,M,100,0,26,26
2014,Reanna,F,100,26,0,26
2014,Reyaansh,M,100,0,26,26
2014,Rhyker,M,100,0,26,26
2014,Richmond,M,100,0,26,26
2014,Rida,F,100,26,0,26
2014,Rinoa,F,100,26,0,26
2014,Roselin,F,100,26,0,26
2014,Ruthann,F,100,26,0,26
2014,Sander,M,100,0,26,26
2014,Scarleth,F,100,26,0,26
2014,Scottlyn,F,100,26,0,26
2014,Sedrick,M,100,0,26,26
2014,Sevastian,M,100,0,26,26
2014,Shrihan,M,100,0,26,26
2014,Shylee,F,100,26,0,26
2014,Skyelar,F,81,21,5,26
2014,Sonali,F,100,26,0,26
2014,Swayzie,F,100,26,0,26
2014,Tajh,M,100,0,26,26
2014,Tatiyana,F,100,26,0,26
2014,Taylar,F,100,26,0,26
2014,Teal,F,81,21,5,26
2014,Tempest,F,100,26,0,26
2014,Thad,M,100,0,26,26
2014,Thaddaeus,M,100,0,26,26
2014,Tiffani,F,100,26,0,26
2014,Timur,M,100,0,26,26
2014,Torrie,F,73,19,7,26
2014,Treshaun,M,100,0,26,26
2014,Tyden,M,100,0,26,26
2014,Tyrel,M,100,0,26,26
2014,Uri,M,100,0,26,26
2014,Vansh,M,100,0,26,26
2014,Vivek,M,100,0,26,26
2014,Wylder,M,100,0,26,26
2014,Xadrian,M,100,0,26,26
2014,Yamile,F,100,26,0,26
2014,Yaneth,F,100,26,0,26
2014,Yashvi,F,100,26,0,26
2014,Yaslin,F,100,26,0,26
2014,Yug,M,100,0,26,26
2014,Yumi,F,100,26,0,26
2014,Zahari,F,65,17,9,26
2014,Zakhi,M,100,0,26,26
2014,Zebulon,M,100,0,26,26
2014,Ziaire,M,100,0,26,26
2014,Zuleyma,F,100,26,0,26
2014,Aadhav,M,100,0,25,25
2014,Aarika,F,100,25,0,25
2014,Aaryav,M,100,0,25,25
2014,Abigal,F,100,25,0,25
2014,Abir,M,100,0,25,25
2014,Adelaida,F,100,25,0,25
2014,Adonay,M,100,0,25,25
2014,Ahmani,F,76,19,6,25
2014,Ahmya,F,100,25,0,25
2014,Airi,F,100,25,0,25
2014,Alauna,F,100,25,0,25
2014,Aleea,F,100,25,0,25
2014,Alesana,F,100,25,0,25
2014,Alika,F,60,15,10,25
2014,Allysson,F,100,25,0,25
2014,Alvina,F,100,25,0,25
2014,Amelya,F,100,25,0,25
2014,Amer,M,100,0,25,25
2014,Anberlin,F,100,25,0,25
2014,Anelise,F,100,25,0,25
2014,Annali,F,100,25,0,25
2014,Annaliyah,F,100,25,0,25
2014,Anoushka,F,100,25,0,25
2014,Anvika,F,100,25,0,25
2014,Anwita,F,100,25,0,25
2014,Ariam,F,100,25,0,25
2014,Ariany,F,100,25,0,25
2014,Arsenio,M,100,0,25,25
2014,Aubreyana,F,100,25,0,25
2014,Aubriee,F,100,25,0,25
2014,Austynn,F,100,25,0,25
2014,Avarose,F,100,25,0,25
2014,Aveyah,F,100,25,0,25
2014,Avigayil,F,100,25,0,25
2014,Bashir,M,100,0,25,25
2014,Becket,M,100,0,25,25
2014,Bergen,M,52,12,13,25
2014,Bladimir,M,100,0,25,25
2014,Bodi,M,100,0,25,25
2014,Boubacar,M,100,0,25,25
2014,Braelee,F,100,25,0,25
2014,Branch,M,100,0,25,25
2014,Broxton,M,100,0,25,25
2014,Cameran,M,56,11,14,25
2014,Camiya,F,100,25,0,25
2014,Charlton,M,100,0,25,25
2014,Cornelia,F,100,25,0,25
2014,Coulter,M,100,0,25,25
2014,Daris,M,100,0,25,25
2014,Daxtyn,M,100,0,25,25
2014,Daymon,M,100,0,25,25
2014,Deema,F,100,25,0,25
2014,Deshun,M,100,0,25,25
2014,Dhyan,M,100,0,25,25
2014,Drexel,M,100,0,25,25
2014,Dyani,F,100,25,0,25
2014,Edvin,M,100,0,25,25
2014,Elanie,F,100,25,0,25
2014,Elektra,F,100,25,0,25
2014,Elowen,F,100,25,0,25
2014,Emalie,F,100,25,0,25
2014,Emilly,F,100,25,0,25
2014,Emmily,F,100,25,0,25
2014,Emre,M,100,0,25,25
2014,Enos,M,100,0,25,25
2014,Ericson,M,100,0,25,25
2014,Ernie,M,100,0,25,25
2014,Etty,F,100,25,0,25
2014,Eulalia,F,100,25,0,25
2014,Fatou,F,100,25,0,25
2014,Findley,M,72,7,18,25
2014,Gimena,F,100,25,0,25
2014,Gionna,F,100,25,0,25
2014,Hadyn,F,60,15,10,25
2014,Harman,M,80,5,20,25
2014,Harmon,M,100,0,25,25
2014,Havanna,F,100,25,0,25
2014,Hayat,F,100,25,0,25
2014,Hayli,F,100,25,0,25
2014,Haytham,M,100,0,25,25
2014,Hayzel,F,100,25,0,25
2014,Hazael,M,100,0,25,25
2014,Hunner,M,100,0,25,25
2014,Hurley,M,76,6,19,25
2014,Ilyanna,F,100,25,0,25
2014,Inioluwa,F,60,15,10,25
2014,Israa,F,100,25,0,25
2014,Jaaziel,M,100,0,25,25
2014,Jaeger,M,100,0,25,25
2014,Jaevion,M,100,0,25,25
2014,Jahkai,M,100,0,25,25
2014,Jahmere,M,100,0,25,25
2014,Jakaiden,M,100,0,25,25
2014,Jakarri,M,100,0,25,25
2014,Jalaysia,F,100,25,0,25
2014,Jassiel,M,100,0,25,25
2014,Javaris,M,100,0,25,25
2014,Jazariah,F,100,25,0,25
2014,Jeevan,M,100,0,25,25
2014,Jehu,M,100,0,25,25
2014,Jenika,F,100,25,0,25
2014,Jens,M,100,0,25,25
2014,Jezebel,F,100,25,0,25
2014,Jianni,M,72,7,18,25
2014,Jiovani,M,100,0,25,25
2014,Jona,M,56,11,14,25
2014,Josmar,M,100,0,25,25
2014,Joya,F,100,25,0,25
2014,Juaquin,M,100,0,25,25
2014,Kaedon,M,100,0,25,25
2014,Kainan,M,100,0,25,25
2014,Kaizer,M,100,0,25,25
2014,Kalianna,F,100,25,0,25
2014,Kalyssa,F,100,25,0,25
2014,Kansas,F,100,25,0,25
2014,Karin,F,100,25,0,25
2014,Kariyah,F,100,25,0,25
2014,Karys,F,100,25,0,25
2014,Kawhi,M,100,0,25,25
2014,Kaylana,F,100,25,0,25
2014,Keithan,M,100,0,25,25
2014,Kepler,M,100,0,25,25
2014,Keyana,F,100,25,0,25
2014,Khaden,M,100,0,25,25
2014,Khamani,F,52,13,12,25
2014,Kiani,F,100,25,0,25
2014,Kingslee,M,56,11,14,25
2014,Kinnley,F,100,25,0,25
2014,Kinslie,F,100,25,0,25
2014,Klynn,F,100,25,0,25
2014,Kutter,M,100,0,25,25
2014,Kyley,F,100,25,0,25
2014,Kynzleigh,F,100,25,0,25
2014,Kyrian,M,100,0,25,25
2014,Leilanni,F,100,25,0,25
2014,Linkoln,M,100,0,25,25
2014,Lucan,M,100,0,25,25
2014,Lyndi,F,100,25,0,25
2014,Mackenzy,F,100,25,0,25
2014,Maddalynn,F,100,25,0,25
2014,Madeleyn,F,100,25,0,25
2014,Mairead,F,100,25,0,25
2014,Makaya,F,100,25,0,25
2014,Makeda,F,100,25,0,25
2014,Makenzee,F,100,25,0,25
2014,Makinzie,F,100,25,0,25
2014,Malakye,M,100,0,25,25
2014,Malayia,F,100,25,0,25
2014,Malcom,M,100,0,25,25
2014,Mamie,F,100,25,0,25
2014,Marcie,F,100,25,0,25
2014,Marcy,F,100,25,0,25
2014,Markos,M,100,0,25,25
2014,Marleen,F,100,25,0,25
2014,Marvens,M,100,0,25,25
2014,Maryana,F,100,25,0,25
2014,Marybeth,F,100,25,0,25
2014,Mattilynn,F,100,25,0,25
2014,Mattix,M,100,0,25,25
2014,Mayli,F,100,25,0,25
2014,Maylynn,F,100,25,0,25
2014,Mckenlee,F,100,25,0,25
2014,Meliyah,F,100,25,0,25
2014,Mellanie,F,100,25,0,25
2014,Melonie,F,100,25,0,25
2014,Merit,M,64,9,16,25
2014,Milyn,F,100,25,0,25
2014,Mimi,F,100,25,0,25
2014,Minna,F,100,25,0,25
2014,Mishka,F,100,25,0,25
2014,Moksh,M,100,0,25,25
2014,Muhsin,M,100,0,25,25
2014,Nabeel,M,100,0,25,25
2014,Nadiah,F,100,25,0,25
2014,Nadir,M,100,0,25,25
2014,Naleah,F,100,25,0,25
2014,Nataley,F,100,25,0,25
2014,Nataliah,F,100,25,0,25
2014,Nautica,F,100,25,0,25
2014,Nevayah,F,100,25,0,25
2014,Nicol,F,100,25,0,25
2014,Nicoli,M,100,0,25,25
2014,Nisa,F,100,25,0,25
2014,Ojas,M,100,0,25,25
2014,Orly,F,100,25,0,25
2014,Parsa,M,100,0,25,25
2014,Patrice,F,72,18,7,25
2014,Paulino,M,100,0,25,25
2014,Paw,F,100,25,0,25
2014,Pietro,M,100,0,25,25
2014,Pria,F,100,25,0,25
2014,Race,M,100,0,25,25
2014,Raegen,F,100,25,0,25
2014,Raider,M,100,0,25,25
2014,Rashon,M,100,0,25,25
2014,Reet,F,100,25,0,25
2014,Reiley,F,72,18,7,25
2014,Reyli,M,100,0,25,25
2014,Rhylen,M,72,7,18,25
2014,Ritvik,M,100,0,25,25
2014,Ronit,M,100,0,25,25
2014,Roper,M,100,0,25,25
2014,Rosina,F,100,25,0,25
2014,Rowynn,F,100,25,0,25
2014,Sallie,F,100,25,0,25
2014,Samayah,F,100,25,0,25
2014,Sammuel,M,100,0,25,25
2014,Sarayah,F,100,25,0,25
2014,Sarim,M,100,0,25,25
2014,Savvy,F,100,25,0,25
2014,Sayge,F,68,17,8,25
2014,Shiann,F,100,25,0,25
2014,Sid,M,100,0,25,25
2014,Sidharth,M,100,0,25,25
2014,Skilynn,F,100,25,0,25
2014,Solei,F,100,25,0,25
2014,Srishti,F,100,25,0,25
2014,Syon,M,100,0,25,25
2014,Tayshaun,M,100,0,25,25
2014,Tayven,M,100,0,25,25
2014,Terryn,F,80,20,5,25
2014,Thelma,F,100,25,0,25
2014,Timofey,M,100,0,25,25
2014,Tobey,M,100,0,25,25
2014,Tonya,F,100,25,0,25
2014,Torian,M,80,5,20,25
2014,Tycho,M,100,0,25,25
2014,Tyon,M,100,0,25,25
2014,Tyreek,M,100,0,25,25
2014,Ulisses,M,100,0,25,25
2014,Viraaj,M,100,0,25,25
2014,Vlad,M,100,0,25,25
2014,Whitman,M,100,0,25,25
2014,Yahye,M,100,0,25,25
2014,Yancy,F,56,14,11,25
2014,Yanelly,F,100,25,0,25
2014,Yanuel,M,100,0,25,25
2014,Yarelis,F,100,25,0,25
2014,Yazeed,M,100,0,25,25
2014,Yoana,F,100,25,0,25
2014,Yocelyn,F,100,25,0,25
2014,Zacharia,M,100,0,25,25
2014,Zair,M,100,0,25,25
2014,Zalen,M,100,0,25,25
2014,Zaylan,M,100,0,25,25
2014,Zayvian,M,100,0,25,25
2014,Zedekiah,M,100,0,25,25
2014,Zelie,F,100,25,0,25
2014,Zeno,M,100,0,25,25
2014,Ziona,F,100,25,0,25
2014,Aaleah,F,100,24,0,24
2014,Aamiyah,F,100,24,0,24
2014,Aaric,M,100,0,24,24
2014,Aashna,F,100,24,0,24
2014,Abbygale,F,100,24,0,24
2014,Aberdeen,F,100,24,0,24
2014,Abri,F,100,24,0,24
2014,Aceson,M,100,0,24,24
2014,Adaeze,F,100,24,0,24
2014,Adalaide,F,100,24,0,24
2014,Adelise,F,100,24,0,24
2014,Advait,M,100,0,24,24
2014,Aiya,F,100,24,0,24
2014,Alanni,F,100,24,0,24
2014,Aleigh,F,100,24,0,24
2014,Alesandra,F,100,24,0,24
2014,Alexiana,F,100,24,0,24
2014,Alyssah,F,100,24,0,24
2014,Amalya,F,100,24,0,24
2014,Amaru,M,100,0,24,24
2014,Amayrani,F,100,24,0,24
2014,Ambria,F,100,24,0,24
2014,Amirrah,F,100,24,0,24
2014,Amogh,M,100,0,24,24
2014,Amri,F,100,24,0,24
2014,Anagha,F,100,24,0,24
2014,Analiz,F,100,24,0,24
2014,Analyse,F,100,24,0,24
2014,Anapaula,F,100,24,0,24
2014,Andrez,M,100,0,24,24
2014,Anel,F,100,24,0,24
2014,Angelin,F,100,24,0,24
2014,Anica,F,100,24,0,24
2014,Annelyse,F,100,24,0,24
2014,Anniyah,F,100,24,0,24
2014,Antonina,F,100,24,0,24
2014,Ariza,F,100,24,0,24
2014,Arlett,F,100,24,0,24
2014,Armanii,F,75,18,6,24
2014,Arsen,M,100,0,24,24
2014,Artin,M,100,0,24,24
2014,Arwyn,F,100,24,0,24
2014,Ashland,F,67,16,8,24
2014,Ashna,F,100,24,0,24
2014,Aurea,F,100,24,0,24
2014,Aurie,F,100,24,0,24
2014,Avant,M,100,0,24,24
2014,Avinash,M,100,0,24,24
2014,Avleen,F,100,24,0,24
2014,Ayven,M,75,6,18,24
2014,Azelia,F,100,24,0,24
2014,Badr,M,100,0,24,24
2014,Bensen,M,100,0,24,24
2014,Betsaida,F,100,24,0,24
2014,Betzy,F,100,24,0,24
2014,Blain,M,100,0,24,24
2014,Bodee,M,79,5,19,24
2014,Bodey,M,100,0,24,24
2014,Breah,F,100,24,0,24
2014,Brevin,M,100,0,24,24
2014,Brittish,F,100,24,0,24
2014,Caisen,M,100,0,24,24
2014,Caley,F,100,24,0,24
2014,Calianna,F,100,24,0,24
2014,Calise,F,100,24,0,24
2014,Carder,M,100,0,24,24
2014,Carlota,F,100,24,0,24
2014,Carlynn,F,100,24,0,24
2014,Caydance,F,100,24,0,24
2014,Cayenne,F,71,17,7,24
2014,Chrystal,F,100,24,0,24
2014,Ciro,M,100,0,24,24
2014,Cobi,M,75,6,18,24
2014,Conlan,M,100,0,24,24
2014,Curran,M,100,0,24,24
2014,Daira,F,100,24,0,24
2014,Daleisa,F,100,24,0,24
2014,Damonie,M,62,9,15,24
2014,Danyla,F,100,24,0,24
2014,Darious,M,100,0,24,24
2014,Darlin,F,100,24,0,24
2014,Davionna,F,100,24,0,24
2014,Daysi,F,100,24,0,24
2014,Deirdre,F,100,24,0,24
2014,Delmar,M,100,0,24,24
2014,Delton,M,100,0,24,24
2014,Derrek,M,100,0,24,24
2014,Destyni,F,100,24,0,24
2014,Dhilan,M,100,0,24,24
2014,Dre,M,100,0,24,24
2014,Dyana,F,100,24,0,24
2014,Eevee,F,100,24,0,24
2014,Eiley,F,100,24,0,24
2014,Elaysia,F,100,24,0,24
2014,Ellana,F,100,24,0,24
2014,Ellowyn,F,100,24,0,24
2014,Ellyson,F,100,24,0,24
2014,Elowyn,F,100,24,0,24
2014,Eoghan,M,100,0,24,24
2014,Erabella,F,100,24,0,24
2014,Faiza,F,100,24,0,24
2014,Finneas,M,100,0,24,24
2014,Gaspar,M,100,0,24,24
2014,Geo,M,100,0,24,24
2014,Giannah,F,100,24,0,24
2014,Gwenivere,F,100,24,0,24
2014,Hali,F,100,24,0,24
2014,Hani,M,75,6,18,24
2014,Harleyquinn,F,100,24,0,24
2014,Harlin,M,79,5,19,24
2014,Harlym,F,100,24,0,24
2014,Haydyn,F,67,16,8,24
2014,Hays,M,100,0,24,24
2014,Ilhan,F,71,17,7,24
2014,Ilijah,M,100,0,24,24
2014,Imelda,F,100,24,0,24
2014,Inga,F,100,24,0,24
2014,Iviona,F,100,24,0,24
2014,Jaelen,M,100,0,24,24
2014,Jaire,M,100,0,24,24
2014,Jaison,M,100,0,24,24
2014,Janella,F,100,24,0,24
2014,Jarett,M,100,0,24,24
2014,Jaylenne,F,100,24,0,24
2014,Jeilyn,F,100,24,0,24
2014,Jemimah,F,100,24,0,24
2014,Jenner,M,79,5,19,24
2014,Jerel,M,100,0,24,24
2014,Jerson,M,100,0,24,24
2014,Jerzie,F,100,24,0,24
2014,Jian,M,79,5,19,24
2014,Jo,F,75,18,6,24
2014,Johny,M,100,0,24,24
2014,Jori,F,100,24,0,24
2014,Judge,M,100,0,24,24
2014,Jyaire,M,100,0,24,24
2014,Kabella,F,100,24,0,24
2014,Kadrian,M,100,0,24,24
2014,Kaeleb,M,100,0,24,24
2014,Kaeley,F,100,24,0,24
2014,Kaidynce,F,100,24,0,24
2014,Kallee,F,100,24,0,24
2014,Kamber,F,100,24,0,24
2014,Kameren,M,100,0,24,24
2014,Kamira,F,100,24,0,24
2014,Kamry,F,100,24,0,24
2014,Kaston,M,100,0,24,24
2014,Kawika,M,100,0,24,24
2014,Kaysin,M,100,0,24,24
2014,Kenedi,F,100,24,0,24
2014,Keyara,F,100,24,0,24
2014,Keyden,M,100,0,24,24
2014,Keyton,M,100,0,24,24
2014,Khyrie,M,75,6,18,24
2014,Kloee,F,100,24,0,24
2014,Knoxx,M,100,0,24,24
2014,Kohlton,M,100,0,24,24
2014,Kolston,M,100,0,24,24
2014,Koralyn,F,100,24,0,24
2014,Kortney,F,100,24,0,24
2014,Kyland,M,100,0,24,24
2014,Laisha,F,100,24,0,24
2014,Lamonte,M,100,0,24,24
2014,Lavern,M,100,0,24,24
2014,Lelia,F,100,24,0,24
2014,Lenix,F,62,15,9,24
2014,Lennyn,F,71,17,7,24
2014,Lenyx,F,75,18,6,24
2014,Leviathan,M,100,0,24,24
2014,Lilyrose,F,100,24,0,24
2014,Lita,F,100,24,0,24
2014,Lochlann,M,100,0,24,24
2014,Lylian,F,100,24,0,24
2014,Macoy,M,100,0,24,24
2014,Magdalyn,F,100,24,0,24
2014,Maila,F,100,24,0,24
2014,Majid,M,100,0,24,24
2014,Makala,F,100,24,0,24
2014,Maki,M,79,5,19,24
2014,Malayla,F,100,24,0,24
2014,Malaysha,F,100,24,0,24
2014,Maleena,F,100,24,0,24
2014,Marylin,F,100,24,0,24
2014,Marylou,F,100,24,0,24
2014,Matvey,M,100,0,24,24
2014,Maybree,F,100,24,0,24
2014,Mckenzee,F,100,24,0,24
2014,Meaghan,F,100,24,0,24
2014,Mehar,F,79,19,5,24
2014,Melah,F,100,24,0,24
2014,Mianna,F,100,24,0,24
2014,Michela,F,100,24,0,24
2014,Miking,M,100,0,24,24
2014,Mileah,F,100,24,0,24
2014,Milli,F,100,24,0,24
2014,Miral,F,100,24,0,24
2014,Miyana,F,100,24,0,24
2014,Mizuki,F,75,18,6,24
2014,Monzerrat,F,100,24,0,24
2014,Mubarak,M,100,0,24,24
2014,Myranda,F,100,24,0,24
2014,Myson,M,100,0,24,24
2014,Nakoa,M,100,0,24,24
2014,Nandini,F,100,24,0,24
2014,Navid,M,100,0,24,24
2014,Niklas,M,100,0,24,24
2014,Nikoli,M,100,0,24,24
2014,Nikolina,F,100,24,0,24
2014,Nima,F,62,15,9,24
2014,Nizar,M,100,0,24,24
2014,Nomar,M,100,0,24,24
2014,Novaleigh,F,100,24,0,24
2014,Oluwasemilore,F,54,13,11,24
2014,Osbaldo,M,100,0,24,24
2014,Parisa,F,100,24,0,24
2014,Parnika,F,100,24,0,24
2014,Parrish,M,62,9,15,24
2014,Paxon,M,100,0,24,24
2014,Payzlee,F,100,24,0,24
2014,Quetzaly,F,100,24,0,24
2014,Quinlynn,F,100,24,0,24
2014,Quinnlyn,F,100,24,0,24
2014,Raegyn,F,100,24,0,24
2014,Ragan,F,67,16,8,24
2014,Rakeem,M,100,0,24,24
2014,Ramy,M,100,0,24,24
2014,Ramzi,M,100,0,24,24
2014,Rawley,M,100,0,24,24
2014,Rayana,F,100,24,0,24
2014,Renezmae,F,100,24,0,24
2014,Rima,F,100,24,0,24
2014,Riva,F,100,24,0,24
2014,Rivan,M,100,0,24,24
2014,Rondell,M,100,0,24,24
2014,Roque,M,100,0,24,24
2014,Rune,M,79,5,19,24
2014,Rutledge,M,100,0,24,24
2014,Saffron,F,100,24,0,24
2014,Saori,F,100,24,0,24
2014,Satvik,M,100,0,24,24
2014,Sehaj,F,71,17,7,24
2014,Sekou,M,100,0,24,24
2014,Shamiyah,F,100,24,0,24
2014,Shanley,F,100,24,0,24
2014,Shariyah,F,100,24,0,24
2014,Shlome,M,100,0,24,24
2014,Siana,F,100,24,0,24
2014,Siham,F,100,24,0,24
2014,Sion,M,100,0,24,24
2014,Sirius,M,100,0,24,24
2014,Skarlet,F,100,24,0,24
2014,Skyelynn,F,100,24,0,24
2014,Skylen,F,54,13,11,24
2014,Sonam,F,79,19,5,24
2014,Sophi,F,100,24,0,24
2014,Suhaib,M,100,0,24,24
2014,Taitum,F,67,16,8,24
2014,Tavares,M,100,0,24,24
2014,Tavia,F,100,24,0,24
2014,Tensley,F,100,24,0,24
2014,Tobiah,M,100,0,24,24
2014,Trigger,M,100,0,24,24
2014,Trustin,M,100,0,24,24
2014,Tyreese,M,100,0,24,24
2014,Tzivia,F,100,24,0,24
2014,Urban,M,100,0,24,24
2014,Vedanth,M,100,0,24,24
2014,Verena,F,100,24,0,24
2014,Wali,M,100,0,24,24
2014,Waylin,M,100,0,24,24
2014,Xane,M,100,0,24,24
2014,Xia,F,100,24,0,24
2014,Xzavion,M,100,0,24,24
2014,Yamilex,F,100,24,0,24
2014,Yassine,M,100,0,24,24
2014,Yossi,M,100,0,24,24
2014,Yuritzi,F,100,24,0,24
2014,Yuvaan,M,100,0,24,24
2014,Zadkiel,M,100,0,24,24
2014,Zadok,M,100,0,24,24
2014,Zailyn,F,58,14,10,24
2014,Zamirah,F,100,24,0,24
2014,Zaylon,M,100,0,24,24
2014,Zayyan,M,100,0,24,24
2014,Abrahim,M,100,0,23,23
2014,Adabella,F,100,23,0,23
2014,Adrain,M,100,0,23,23
2014,Adryanna,F,100,23,0,23
2014,Aidin,M,100,0,23,23
2014,Alahni,F,100,23,0,23
2014,Alazne,F,100,23,0,23
2014,Aleksa,F,100,23,0,23
2014,Alin,F,70,16,7,23
2014,Alonah,F,100,23,0,23
2014,Alysse,F,100,23,0,23
2014,Amel,F,61,14,9,23
2014,Ameliya,F,100,23,0,23
2014,Amilliana,F,100,23,0,23
2014,Anabia,F,100,23,0,23
2014,Anaia,F,100,23,0,23
2014,Anara,F,100,23,0,23
2014,Anastasiya,F,100,23,0,23
2014,Antwain,M,100,0,23,23
2014,Araina,F,100,23,0,23
2014,Arcangel,M,100,0,23,23
2014,Areej,F,100,23,0,23
2014,Arilynn,F,100,23,0,23
2014,Arrington,F,52,12,11,23
2014,Artemio,M,100,0,23,23
2014,Aster,F,100,23,0,23
2014,Atalie,F,100,23,0,23
2014,Aubre,F,100,23,0,23
2014,Avik,M,100,0,23,23
2014,Avital,F,100,23,0,23
2014,Azaylia,F,100,23,0,23
2014,Azel,M,74,6,17,23
2014,Bain,M,100,0,23,23
2014,Barbie,F,100,23,0,23
2014,Barret,M,100,0,23,23
2014,Basma,F,100,23,0,23
2014,Berkleigh,F,100,23,0,23
2014,Blessin,F,100,23,0,23
2014,Bosco,M,100,0,23,23
2014,Bransyn,M,100,0,23,23
2014,Breeanna,F,100,23,0,23
2014,Brinnley,F,100,23,0,23
2014,Britt,F,52,12,11,23
2014,Bruin,M,100,0,23,23
2014,Caelen,M,100,0,23,23
2014,Cainan,M,100,0,23,23
2014,Caliah,F,100,23,0,23
2014,Cana,F,100,23,0,23
2014,Cass,M,100,0,23,23
2014,Catharine,F,100,23,0,23
2014,Caydin,M,100,0,23,23
2014,Ceanna,F,100,23,0,23
2014,Champion,M,100,0,23,23
2014,Chanler,M,65,8,15,23
2014,Cheskel,M,100,0,23,23
2014,Cheyann,F,100,23,0,23
2014,Chidubem,M,100,0,23,23
2014,Chioma,F,100,23,0,23
2014,Christ,M,100,0,23,23
2014,Christyn,F,100,23,0,23
2014,Cordae,M,100,0,23,23
2014,Corinthian,M,100,0,23,23
2014,Corra,F,100,23,0,23
2014,Creek,M,100,0,23,23
2014,Cristiana,F,100,23,0,23
2014,Dasean,M,100,0,23,23
2014,Daviana,F,100,23,0,23
2014,Daymian,M,100,0,23,23
2014,Dayra,F,100,23,0,23
2014,Dekari,M,100,0,23,23
2014,Destinie,F,100,23,0,23
2014,Dionne,F,100,23,0,23
2014,Dolly,F,100,23,0,23
2014,Drue,F,61,14,9,23
2014,Ehan,M,100,0,23,23
2014,Eleonora,F,100,23,0,23
2014,Elida,F,100,23,0,23
2014,Ellanor,F,100,23,0,23
2014,Ellieanna,F,100,23,0,23
2014,Elspeth,F,100,23,0,23
2014,Erion,M,74,6,17,23
2014,Esiah,M,100,0,23,23
2014,Evolette,F,100,23,0,23
2014,Exodus,M,74,6,17,23
2014,Ezmae,F,100,23,0,23
2014,Ferdinand,M,100,0,23,23
2014,Filiberto,M,100,0,23,23
2014,Findlay,M,78,5,18,23
2014,Fionn,M,100,0,23,23
2014,Francheska,F,100,23,0,23
2014,Gaetano,M,100,0,23,23
2014,Galia,F,100,23,0,23
2014,Gautam,M,100,0,23,23
2014,Georgianna,F,100,23,0,23
2014,Getsemani,F,100,23,0,23
2014,Giabella,F,100,23,0,23
2014,Gladis,F,100,23,0,23
2014,Graylin,F,52,12,11,23
2014,Gwendalyn,F,100,23,0,23
2014,Gweneth,F,100,23,0,23
2014,Hafsah,F,100,23,0,23
2014,Hailyn,F,100,23,0,23
2014,Hailynn,F,100,23,0,23
2014,Halee,F,100,23,0,23
2014,Halina,F,100,23,0,23
2014,Hashir,M,100,0,23,23
2014,Helios,M,100,0,23,23
2014,Hesston,M,100,0,23,23
2014,Huy,M,100,0,23,23
2014,Indya,F,100,23,0,23
2014,Inessa,F,100,23,0,23
2014,Irena,F,100,23,0,23
2014,Ishana,F,100,23,0,23
2014,Ivee,F,100,23,0,23
2014,Iyannah,F,100,23,0,23
2014,Jadan,M,100,0,23,23
2014,Jadarius,M,100,0,23,23
2014,Jamani,M,52,11,12,23
2014,Jameria,F,100,23,0,23
2014,Jamey,M,57,10,13,23
2014,Jamon,M,100,0,23,23
2014,Janina,F,100,23,0,23
2014,Javi,M,100,0,23,23
2014,Jaye,F,57,13,10,23
2014,Jaylianna,F,100,23,0,23
2014,Jayvier,M,100,0,23,23
2014,Jeanine,F,100,23,0,23
2014,Jeimy,F,100,23,0,23
2014,Jencarlo,M,100,0,23,23
2014,Jermany,F,74,17,6,23
2014,Jerrica,F,100,23,0,23
2014,Jerron,M,100,0,23,23
2014,Jerzee,F,100,23,0,23
2014,Jezreel,M,70,7,16,23
2014,Joab,M,100,0,23,23
2014,Joanie,F,100,23,0,23
2014,Jonna,F,100,23,0,23
2014,Josemaria,M,100,0,23,23
2014,Jossiah,M,100,0,23,23
2014,Kairos,M,100,0,23,23
2014,Kamdin,M,100,0,23,23
2014,Karston,M,100,0,23,23
2014,Kasin,M,100,0,23,23
2014,Katty,F,100,23,0,23
2014,Kelise,F,100,23,0,23
2014,Kelyn,F,57,13,10,23
2014,Kendarius,M,100,0,23,23
2014,Keniel,M,100,0,23,23
2014,Kentley,F,70,16,7,23
2014,Kenyatta,M,74,6,17,23
2014,Kenzli,F,100,23,0,23
2014,Keontae,M,100,0,23,23
2014,Khyren,M,100,0,23,23
2014,Kia,F,100,23,0,23
2014,Kimari,M,57,10,13,23
2014,Kimbella,F,100,23,0,23
2014,Kingstin,M,100,0,23,23
2014,Kinzlie,F,100,23,0,23
2014,Klaudia,F,100,23,0,23
2014,Kofi,M,100,0,23,23
2014,Koraline,F,100,23,0,23
2014,Koree,F,70,16,7,23
2014,Kourtlyn,F,100,23,0,23
2014,Kyia,F,100,23,0,23
2014,Laia,F,100,23,0,23
2014,Laiah,F,100,23,0,23
2014,Lakely,F,100,23,0,23
2014,Lakshmi,F,100,23,0,23
2014,Lamari,M,70,7,16,23
2014,Lashay,F,100,23,0,23
2014,Launa,F,100,23,0,23
2014,Lavelle,M,100,0,23,23
2014,Lazar,M,100,0,23,23
2014,Leina,F,100,23,0,23
2014,Lelan,M,100,0,23,23
2014,Lexton,M,100,0,23,23
2014,Linkyn,M,100,0,23,23
2014,Logann,F,100,23,0,23
2014,Loic,M,100,0,23,23
2014,Lorali,F,100,23,0,23
2014,Lovina,F,100,23,0,23
2014,Lukah,M,100,0,23,23
2014,Lyna,F,100,23,0,23
2014,Lyrical,F,100,23,0,23
2014,Mackenzee,F,100,23,0,23
2014,Madilynne,F,100,23,0,23
2014,Maelle,F,100,23,0,23
2014,Maika,F,74,17,6,23
2014,Makana,M,65,8,15,23
2014,Malayshia,F,100,23,0,23
2014,Manav,M,100,0,23,23
2014,Manraj,M,100,0,23,23
2014,Marlaina,F,100,23,0,23
2014,Maryella,F,100,23,0,23
2014,Maryellen,F,100,23,0,23
2014,Matai,M,100,0,23,23
2014,Maybelle,F,100,23,0,23
2014,Meeka,F,100,23,0,23
2014,Meenakshi,F,100,23,0,23
2014,Mendy,M,100,0,23,23
2014,Mert,M,100,0,23,23
2014,Meylin,F,100,23,0,23
2014,Miana,F,100,23,0,23
2014,Mikai,M,100,0,23,23
2014,Mikeal,M,100,0,23,23
2014,Millan,M,78,5,18,23
2014,Morghan,F,100,23,0,23
2014,Muhamed,M,100,0,23,23
2014,Myanna,F,100,23,0,23
2014,Myriah,F,100,23,0,23
2014,Nahlia,F,100,23,0,23
2014,Naiomi,F,100,23,0,23
2014,Nami,F,100,23,0,23
2014,Natilee,F,100,23,0,23
2014,Nawaf,M,100,0,23,23
2014,Nayan,M,100,0,23,23
2014,Naysa,F,100,23,0,23
2014,Neiko,M,100,0,23,23
2014,Neila,F,100,23,0,23
2014,Nijah,M,57,10,13,23
2014,Ole,M,100,0,23,23
2014,Oluwatobi,M,78,5,18,23
2014,Owais,M,100,0,23,23
2014,Padraig,M,100,0,23,23
2014,Pau,M,100,0,23,23
2014,Paxten,M,74,6,17,23
2014,Perl,F,100,23,0,23
2014,Peyson,M,61,9,14,23
2014,Philippe,M,100,0,23,23
2014,Platon,M,100,0,23,23
2014,Prescott,M,100,0,23,23
2014,Radha,F,100,23,0,23
2014,Rafi,M,100,0,23,23
2014,Ramiya,F,100,23,0,23
2014,Randell,M,100,0,23,23
2014,Raziya,F,100,23,0,23
2014,Remie,F,100,23,0,23
2014,Reuven,M,100,0,23,23
2014,Riddhi,F,100,23,0,23
2014,Rishab,M,100,0,23,23
2014,Rosabelle,F,100,23,0,23
2014,Rosaly,F,100,23,0,23
2014,Rosaria,F,100,23,0,23
2014,Rosslyn,F,100,23,0,23
2014,Rowland,M,100,0,23,23
2014,Sakari,F,65,15,8,23
2014,Samy,M,100,0,23,23
2014,Santina,F,100,23,0,23
2014,Saydi,F,100,23,0,23
2014,Saydie,F,100,23,0,23
2014,Selin,F,100,23,0,23
2014,Seraphim,F,61,14,9,23
2014,Shanice,F,100,23,0,23
2014,Shanna,F,100,23,0,23
2014,Shariah,F,100,23,0,23
2014,Shauna,F,100,23,0,23
2014,Shealyn,F,100,23,0,23
2014,Shiva,M,65,8,15,23
2014,Shiven,M,100,0,23,23
2014,Shon,M,100,0,23,23
2014,Shraga,M,100,0,23,23
2014,Siara,F,100,23,0,23
2014,Skilar,F,100,23,0,23
2014,Sofiah,F,100,23,0,23
2014,Sophy,F,100,23,0,23
2014,Sriram,M,100,0,23,23
2014,Stori,F,100,23,0,23
2014,Sunjai,F,100,23,0,23
2014,Tabatha,F,100,23,0,23
2014,Tahirah,F,100,23,0,23
2014,Talaysia,F,100,23,0,23
2014,Tayveon,M,100,0,23,23
2014,Temiloluwa,F,70,16,7,23
2014,Tigerlily,F,100,23,0,23
2014,Treveon,M,100,0,23,23
2014,Treyvion,M,100,0,23,23
2014,Turki,M,100,0,23,23
2014,Tydus,M,100,0,23,23
2014,Tylon,M,100,0,23,23
2014,Tyonna,F,100,23,0,23
2014,Ursula,F,100,23,0,23
2014,Wilbur,M,100,0,23,23
2014,Wynston,M,100,0,23,23
2014,Yamin,M,100,0,23,23
2014,Yannis,M,57,10,13,23
2014,Yashika,F,100,23,0,23
2014,Yazlyn,F,100,23,0,23
2014,Yocelin,F,100,23,0,23
2014,Ysabel,F,100,23,0,23
2014,Yusif,M,100,0,23,23
2014,Zacarias,M,100,0,23,23
2014,Zakir,M,100,0,23,23
2014,Zanyah,F,100,23,0,23
2014,Zarion,M,100,0,23,23
2014,Zarya,F,100,23,0,23
2014,Zaven,M,100,0,23,23
2014,Zeena,F,100,23,0,23
2014,Zidane,M,100,0,23,23
2014,Zulay,F,100,23,0,23
2014,Aarion,M,77,5,17,22
2014,Abria,F,100,22,0,22
2014,Adelin,F,100,22,0,22
2014,Adilee,F,100,22,0,22
2014,Adreanna,F,100,22,0,22
2014,Aiken,M,100,0,22,22
2014,Alaiah,F,100,22,0,22
2014,Alaylah,F,100,22,0,22
2014,Aleem,M,100,0,22,22
2014,Alethia,F,100,22,0,22
2014,Alexiah,F,100,22,0,22
2014,Alishba,F,100,22,0,22
2014,Alivea,F,100,22,0,22
2014,Aliyanah,F,100,22,0,22
2014,Amaar,M,100,0,22,22
2014,Amador,M,100,0,22,22
2014,Amine,M,100,0,22,22
2014,Amiri,M,68,7,15,22
2014,Amorie,F,100,22,0,22
2014,Analyn,F,100,22,0,22
2014,Andrick,M,100,0,22,22
2014,Angelise,F,100,22,0,22
2014,Angello,M,100,0,22,22
2014,Annarose,F,100,22,0,22
2014,Anouk,F,100,22,0,22
2014,Anvitha,F,100,22,0,22
2014,Anyeli,F,100,22,0,22
2014,Anyia,F,100,22,0,22
2014,Arnoldo,M,100,0,22,22
2014,Aryella,F,100,22,0,22
2014,Asani,F,77,17,5,22
2014,Atarah,F,100,22,0,22
2014,Aubriel,F,100,22,0,22
2014,Aundre,M,100,0,22,22
2014,Averiana,F,100,22,0,22
2014,Avrum,M,100,0,22,22
2014,Avyaan,M,100,0,22,22
2014,Ayham,M,100,0,22,22
2014,Ayson,M,100,0,22,22
2014,Azara,F,100,22,0,22
2014,Bakari,M,100,0,22,22
2014,Becker,M,100,0,22,22
2014,Beyonce,F,100,22,0,22
2014,Blu,M,55,10,12,22
2014,Bretton,M,100,0,22,22
2014,Breya,F,100,22,0,22
2014,Briannah,F,100,22,0,22
2014,Briston,M,100,0,22,22
2014,Brittan,F,64,14,8,22
2014,Calina,F,100,22,0,22
2014,Calyx,M,64,8,14,22
2014,Camia,F,100,22,0,22
2014,Candelaria,F,100,22,0,22
2014,Caprice,F,100,22,0,22
2014,Catori,F,100,22,0,22
2014,Cerys,F,100,22,0,22
2014,Chavy,F,100,22,0,22
2014,Cheston,M,100,0,22,22
2014,Chisom,F,100,22,0,22
2014,Christelle,F,100,22,0,22
2014,Chrystian,M,100,0,22,22
2014,Clarabelle,F,100,22,0,22
2014,Coltan,M,100,0,22,22
2014,Colvin,M,100,0,22,22
2014,Cotton,M,100,0,22,22
2014,Crosley,M,73,6,16,22
2014,Curren,M,100,0,22,22
2014,Cyra,F,100,22,0,22
2014,Dailen,M,100,0,22,22
2014,Daisey,F,100,22,0,22
2014,Daniil,M,100,0,22,22
2014,Dannika,F,100,22,0,22
2014,Danyel,M,77,5,17,22
2014,Davey,M,77,5,17,22
2014,Davianna,F,100,22,0,22
2014,Dea,F,100,22,0,22
2014,Delonte,M,100,0,22,22
2014,Denzell,M,100,0,22,22
2014,Deziyah,F,100,22,0,22
2014,Dierks,M,100,0,22,22
2014,Diezel,M,100,0,22,22
2014,Dontez,M,100,0,22,22
2014,Dorcas,F,100,22,0,22
2014,Dublin,M,77,5,17,22
2014,Dulcemaria,F,100,22,0,22
2014,Eddison,M,100,0,22,22
2014,Elara,F,100,22,0,22
2014,Eliannah,F,100,22,0,22
2014,Elza,F,100,22,0,22
2014,Embree,F,100,22,0,22
2014,Era,F,100,22,0,22
2014,Erasmo,M,100,0,22,22
2014,Eston,M,100,0,22,22
2014,Evelia,F,100,22,0,22
2014,Fintan,M,100,0,22,22
2014,Firas,M,100,0,22,22
2014,Gershon,M,100,0,22,22
2014,Gioia,F,100,22,0,22
2014,Gwendolen,F,100,22,0,22
2014,Hal,M,100,0,22,22
2014,Harlei,F,100,22,0,22
2014,Haru,M,59,9,13,22
2014,Haruto,M,100,0,22,22
2014,Hashem,M,100,0,22,22
2014,Havilah,F,100,22,0,22
2014,Hawken,M,100,0,22,22
2014,Heavenleigh,F,100,22,0,22
2014,Ikhlas,F,100,22,0,22
2014,Ireoluwa,F,73,16,6,22
2014,Isabellah,F,100,22,0,22
2014,Jacory,M,100,0,22,22
2014,Jadeveon,M,100,0,22,22
2014,Jaelon,M,100,0,22,22
2014,Jahi,M,100,0,22,22
2014,Jajuan,M,100,0,22,22
2014,Jamarius,M,100,0,22,22
2014,Jamoni,M,68,7,15,22
2014,Janasia,F,100,22,0,22
2014,Janiylah,F,100,22,0,22
2014,Janyiah,F,100,22,0,22
2014,Jaretzi,F,100,22,0,22
2014,Jayko,M,100,0,22,22
2014,Jayley,F,100,22,0,22
2014,Jayron,M,100,0,22,22
2014,Jayseon,M,100,0,22,22
2014,Jayvyn,M,100,0,22,22
2014,Jazaria,F,100,22,0,22
2014,Jazmarie,F,100,22,0,22
2014,Jazzmyn,F,100,22,0,22
2014,Jeana,F,100,22,0,22
2014,Jeanna,F,100,22,0,22
2014,Jenica,F,100,22,0,22
2014,Jennalee,F,100,22,0,22
2014,Jennyfer,F,100,22,0,22
2014,Jettson,M,100,0,22,22
2014,Jeziel,M,100,0,22,22
2014,Joachim,M,100,0,22,22
2014,Josemiguel,M,100,0,22,22
2014,Kaavya,F,100,22,0,22
2014,Kadee,F,100,22,0,22
2014,Kaesen,M,100,0,22,22
2014,Kail,M,100,0,22,22
2014,Kaileen,F,100,22,0,22
2014,Kalilah,F,100,22,0,22
2014,Kanai,M,73,6,16,22
2014,Kanye,M,100,0,22,22
2014,Kasia,F,100,22,0,22
2014,Kasim,M,100,0,22,22
2014,Kaveon,M,100,0,22,22
2014,Kayana,F,100,22,0,22
2014,Kayonna,F,100,22,0,22
2014,Kayvion,M,100,0,22,22
2014,Keilly,F,100,22,0,22
2014,Kelin,M,64,8,14,22
2014,Kemiyah,F,100,22,0,22
2014,Khaliq,M,100,0,22,22
2014,Kharma,F,100,22,0,22
2014,Kiari,F,77,17,5,22
2014,Klaira,F,100,22,0,22
2014,Kodiak,M,100,0,22,22
2014,Kona,M,64,8,14,22
2014,Krystina,F,100,22,0,22
2014,Kyliegh,F,100,22,0,22
2014,Lamaya,F,100,22,0,22
2014,Langdon,M,100,0,22,22
2014,Lauro,M,100,0,22,22
2014,Layana,F,100,22,0,22
2014,Layten,M,77,5,17,22
2014,Leala,F,100,22,0,22
2014,Lean,M,73,6,16,22
2014,Legion,M,100,0,22,22
2014,Leidy,F,100,22,0,22
2014,Lelani,F,100,22,0,22
2014,Leta,F,100,22,0,22
2014,Liliya,F,100,22,0,22
2014,Lillyonna,F,100,22,0,22
2014,Lizandro,M,100,0,22,22
2014,Lyliana,F,100,22,0,22
2014,Lynnea,F,100,22,0,22
2014,Mable,F,100,22,0,22
2014,Mackson,M,100,0,22,22
2014,Mahina,F,100,22,0,22
2014,Majestic,F,50,11,11,22
2014,Maks,M,100,0,22,22
2014,Maleya,F,100,22,0,22
2014,Malick,M,100,0,22,22
2014,Maniyah,F,100,22,0,22
2014,Mannix,M,100,0,22,22
2014,Marcial,M,100,0,22,22
2014,Markis,M,100,0,22,22
2014,Marsha,F,100,22,0,22
2014,Masai,M,100,0,22,22
2014,Masson,M,100,0,22,22
2014,Mateen,M,100,0,22,22
2014,Mattea,F,100,22,0,22
2014,Maximillion,M,100,0,22,22
2014,Mccall,F,73,16,6,22
2014,Meia,F,100,22,0,22
2014,Melaina,F,100,22,0,22
2014,Menashe,M,100,0,22,22
2014,Mera,F,100,22,0,22
2014,Merrik,M,100,0,22,22
2014,Michayla,F,100,22,0,22
2014,Mickayla,F,100,22,0,22
2014,Mikaella,F,100,22,0,22
2014,Mithra,F,100,22,0,22
2014,Miyanna,F,100,22,0,22
2014,Mollee,F,100,22,0,22
2014,Mosiah,M,100,0,22,22
2014,Mumtaz,F,100,22,0,22
2014,Mychal,M,100,0,22,22
2014,Nabiha,F,100,22,0,22
2014,Naseem,M,100,0,22,22
2014,Navia,F,100,22,0,22
2014,Navin,M,100,0,22,22
2014,Nhi,F,100,22,0,22
2014,Nicolina,F,100,22,0,22
2014,Nihira,F,100,22,0,22
2014,Nikayla,F,100,22,0,22
2014,Nikos,M,100,0,22,22
2014,Nils,M,100,0,22,22
2014,Noemy,F,100,22,0,22
2014,Noland,M,100,0,22,22
2014,Nylan,M,100,0,22,22
2014,Nyra,F,100,22,0,22
2014,Odelia,F,100,22,0,22
2014,Odyssey,F,100,22,0,22
2014,Olaf,M,100,0,22,22
2014,Oliviana,F,100,22,0,22
2014,Omere,M,100,0,22,22
2014,Ousman,M,100,0,22,22
2014,Paeton,F,77,17,5,22
2014,Paiden,M,59,9,13,22
2014,Panagiotis,M,100,0,22,22
2014,Pasquale,M,100,0,22,22
2014,Patryk,M,100,0,22,22
2014,Paz,F,68,15,7,22
2014,Peggy,F,100,22,0,22
2014,Pharrell,M,100,0,22,22
2014,Prentiss,M,77,5,17,22
2014,Promyse,F,100,22,0,22
2014,Raeanna,F,100,22,0,22
2014,Ramiah,F,100,22,0,22
2014,Reena,F,100,22,0,22
2014,Renad,F,100,22,0,22
2014,Retaj,F,100,22,0,22
2014,Reynolds,F,50,11,11,22
2014,Rhilynn,F,100,22,0,22
2014,Rhyann,F,100,22,0,22
2014,Riann,F,100,22,0,22
2014,Richelle,F,100,22,0,22
2014,Rigel,M,100,0,22,22
2014,Riku,M,100,0,22,22
2014,Risha,F,100,22,0,22
2014,Rishika,F,100,22,0,22
2014,Rocko,M,100,0,22,22
2014,Rohit,M,100,0,22,22
2014,Ronak,M,100,0,22,22
2014,Rosita,F,100,22,0,22
2014,Ruchy,F,100,22,0,22
2014,Rut,F,100,22,0,22
2014,Ruvim,M,100,0,22,22
2014,Saachi,F,100,22,0,22
2014,Sadey,F,100,22,0,22
2014,Sahaj,M,100,0,22,22
2014,Saphire,F,100,22,0,22
2014,Shahd,F,100,22,0,22
2014,Shalynn,F,100,22,0,22
2014,Shaniah,F,100,22,0,22
2014,Sharanya,F,100,22,0,22
2014,Sheryl,F,100,22,0,22
2014,Shloimy,M,100,0,22,22
2014,Siddhartha,M,100,0,22,22
2014,Siyona,F,100,22,0,22
2014,Sofya,F,100,22,0,22
2014,Soloman,M,100,0,22,22
2014,Sorin,M,100,0,22,22
2014,Tabor,M,68,7,15,22
2014,Tallen,M,100,0,22,22
2014,Talulah,F,100,22,0,22
2014,Talyah,F,100,22,0,22
2014,Tamarion,M,100,0,22,22
2014,Tamaya,F,100,22,0,22
2014,Tanish,M,100,0,22,22
2014,Tashawn,M,100,0,22,22
2014,Tatem,M,68,7,15,22
2014,Tavish,M,100,0,22,22
2014,Tenlee,F,100,22,0,22
2014,Tera,F,100,22,0,22
2014,Thierry,M,100,0,22,22
2014,Tiyana,F,100,22,0,22
2014,Torah,F,100,22,0,22
2014,Trenity,F,100,22,0,22
2014,Trigg,M,100,0,22,22
2014,Twila,F,100,22,0,22
2014,Tyberius,M,100,0,22,22
2014,Tylah,F,100,22,0,22
2014,Uzair,M,100,0,22,22
2014,Verona,F,100,22,0,22
2014,Vidhi,F,100,22,0,22
2014,Vir,M,100,0,22,22
2014,Walton,M,100,0,22,22
2014,Wanda,F,100,22,0,22
2014,Wesam,M,100,0,22,22
2014,Whyatt,M,100,0,22,22
2014,Willamina,F,100,22,0,22
2014,Xaden,M,100,0,22,22
2014,Xavia,F,100,22,0,22
2014,Yafet,M,100,0,22,22
2014,Yaneisy,F,100,22,0,22
2014,Yaqub,M,100,0,22,22
2014,Yaxiel,M,100,0,22,22
2014,Yazid,M,100,0,22,22
2014,Yeimi,F,100,22,0,22
2014,Yulian,M,100,0,22,22
2014,Zacari,M,55,10,12,22
2014,Zahid,M,100,0,22,22
2014,Zakia,F,100,22,0,22
2014,Zaleah,F,100,22,0,22
2014,Zania,F,100,22,0,22
2014,Zanyla,F,100,22,0,22
2014,Zayvier,M,100,0,22,22
2014,Zemirah,F,100,22,0,22
2014,Zoelle,F,100,22,0,22
2014,Zurie,F,100,22,0,22
2014,Aahna,F,100,21,0,21
2014,Abishai,M,62,8,13,21
2014,Adaley,F,100,21,0,21
2014,Adaliz,F,100,21,0,21
2014,Ahnaf,M,100,0,21,21
2014,Ainslie,F,100,21,0,21
2014,Ajax,M,100,0,21,21
2014,Akshar,M,100,0,21,21
2014,Alayia,F,100,21,0,21
2014,Alexandr,M,100,0,21,21
2014,Alexianna,F,100,21,0,21
2014,Alhassan,M,100,0,21,21
2014,Allysa,F,100,21,0,21
2014,Alyan,M,100,0,21,21
2014,Ameyah,F,100,21,0,21
2014,Amoura,F,100,21,0,21
2014,Anaisha,F,100,21,0,21
2014,Analucia,F,100,21,0,21
2014,Anavictoria,F,100,21,0,21
2014,Andra,F,62,13,8,21
2014,Annalynne,F,100,21,0,21
2014,Antone,M,100,0,21,21
2014,Anyssa,F,100,21,0,21
2014,Ardyn,F,100,21,0,21
2014,Ariahna,F,100,21,0,21
2014,Arizbeth,F,100,21,0,21
2014,Arna,F,100,21,0,21
2014,Aryam,F,100,21,0,21
2014,Aryelle,F,100,21,0,21
2014,Assata,F,100,21,0,21
2014,Aubryana,F,100,21,0,21
2014,Avyukth,M,100,0,21,21
2014,Awa,F,100,21,0,21
2014,Ayelet,F,100,21,0,21
2014,Ayumi,F,100,21,0,21
2014,Azan,M,100,0,21,21
2014,Azaryah,F,62,13,8,21
2014,Bader,M,100,0,21,21
2014,Bayli,F,100,21,0,21
2014,Benuel,M,100,0,21,21
2014,Bristal,F,100,21,0,21
2014,Briya,F,100,21,0,21
2014,Bryten,M,67,7,14,21
2014,Cardell,M,100,0,21,21
2014,Cari,F,100,21,0,21
2014,Carlyle,M,100,0,21,21
2014,Cayce,M,52,10,11,21
2014,Celso,M,100,0,21,21
2014,Charlise,F,100,21,0,21
2014,Chasidy,F,100,21,0,21
2014,Chiamaka,F,100,21,0,21
2014,Cire,M,67,7,14,21
2014,Colbi,F,100,21,0,21
2014,Cortlyn,F,76,16,5,21
2014,Cosima,F,100,21,0,21
2014,Daevion,M,100,0,21,21
2014,Dalen,M,100,0,21,21
2014,Dallen,M,100,0,21,21
2014,Danilyn,F,100,21,0,21
2014,Davanee,F,100,21,0,21
2014,Davie,F,67,14,7,21
2014,Dawud,M,100,0,21,21
2014,Daxx,M,100,0,21,21
2014,Daymien,M,100,0,21,21
2014,Dayonna,F,100,21,0,21
2014,Deakon,M,100,0,21,21
2014,Delaina,F,100,21,0,21
2014,Delayza,F,100,21,0,21
2014,Demetrios,M,100,0,21,21
2014,Denae,F,100,21,0,21
2014,Destany,F,100,21,0,21
2014,Deyanira,F,100,21,0,21
2014,Dezi,F,52,11,10,21
2014,Dezmon,M,100,0,21,21
2014,Dhani,M,67,7,14,21
2014,Dmitriy,M,100,0,21,21
2014,Dorien,M,100,0,21,21
2014,Dravin,M,100,0,21,21
2014,Dreshawn,M,100,0,21,21
2014,Dreyson,M,100,0,21,21
2014,Duran,M,100,0,21,21
2014,Durrell,M,100,0,21,21
2014,Eisa,M,52,10,11,21
2014,Elayah,F,100,21,0,21
2014,Elayne,F,100,21,0,21
2014,Eleina,F,100,21,0,21
2014,Eleny,F,100,21,0,21
2014,Eleonor,F,100,21,0,21
2014,Elgin,M,100,0,21,21
2014,Eliaz,M,100,0,21,21
2014,Elija,M,100,0,21,21
2014,Eliyana,F,100,21,0,21
2014,Ellinor,F,100,21,0,21
2014,Emelina,F,100,21,0,21
2014,Emerick,M,100,0,21,21
2014,Emmalene,F,100,21,0,21
2014,Emmarae,F,100,21,0,21
2014,Eryk,M,100,0,21,21
2014,Esmerelda,F,100,21,0,21
2014,Essa,M,100,0,21,21
2014,Ethel,F,100,21,0,21
2014,Evi,F,100,21,0,21
2014,Eythan,M,100,0,21,21
2014,Ezariah,M,57,9,12,21
2014,Fae,F,100,21,0,21
2014,Faiz,M,100,0,21,21
2014,Faustina,F,100,21,0,21
2014,Fedor,M,100,0,21,21
2014,Fia,F,100,21,0,21
2014,Fynlee,F,100,21,0,21
2014,Genesys,F,100,21,0,21
2014,Gerrard,M,100,0,21,21
2014,Gianfranco,M,100,0,21,21
2014,Goddess,F,100,21,0,21
2014,Gwynn,F,100,21,0,21
2014,Gypsy,F,100,21,0,21
2014,Hadeel,F,100,21,0,21
2014,Hadia,F,100,21,0,21
2014,Halli,F,100,21,0,21
2014,Hamid,M,100,0,21,21
2014,Hania,F,100,21,0,21
2014,Hannaley,F,100,21,0,21
2014,Haydan,M,67,7,14,21
2014,Haylei,F,100,21,0,21
2014,Hayze,M,100,0,21,21
2014,Henchy,F,100,21,0,21
2014,Huckleberry,M,100,0,21,21
2014,Igor,M,100,0,21,21
2014,Irish,F,62,13,8,21
2014,Isabeau,F,100,21,0,21
2014,Ismaeel,M,100,0,21,21
2014,Isolde,F,100,21,0,21
2014,Iyanah,F,100,21,0,21
2014,Jadalyn,F,100,21,0,21
2014,Jahki,M,100,0,21,21
2014,Jaileen,F,100,21,0,21
2014,Jaimie,F,100,21,0,21
2014,Jaleigha,F,100,21,0,21
2014,Jamilet,F,100,21,0,21
2014,Janiyla,F,100,21,0,21
2014,Jannely,F,100,21,0,21
2014,Jaret,M,100,0,21,21
2014,Jaselyn,F,100,21,0,21
2014,Jaxsin,M,100,0,21,21
2014,Jaydn,M,67,7,14,21
2014,Jayleah,F,100,21,0,21
2014,Jaylynne,F,100,21,0,21
2014,Jayshaun,M,100,0,21,21
2014,Jaysion,M,100,0,21,21
2014,Jayton,M,100,0,21,21
2014,Jazzelle,F,100,21,0,21
2014,Jeanpaul,M,100,0,21,21
2014,Jedi,M,100,0,21,21
2014,Jerica,F,100,21,0,21
2014,Jocelynne,F,100,21,0,21
2014,Johari,F,71,15,6,21
2014,Jonelle,F,76,16,5,21
2014,Josalynn,F,100,21,0,21
2014,Joseantonio,M,100,0,21,21
2014,Jovana,F,100,21,0,21
2014,Judi,F,100,21,0,21
2014,Julieann,F,100,21,0,21
2014,Jumana,F,100,21,0,21
2014,Kaidin,M,100,0,21,21
2014,Kamylah,F,100,21,0,21
2014,Karishma,F,100,21,0,21
2014,Katlynn,F,100,21,0,21
2014,Kaylena,F,100,21,0,21
2014,Kaylianna,F,100,21,0,21
2014,Keana,F,100,21,0,21
2014,Keirah,F,100,21,0,21
2014,Kendel,M,71,6,15,21
2014,Kendrik,M,100,0,21,21
2014,Keygan,M,100,0,21,21
2014,Khaya,F,100,21,0,21
2014,Kinzey,F,100,21,0,21
2014,Kirstin,F,100,21,0,21
2014,Kirstyn,F,100,21,0,21
2014,Kiyana,F,100,21,0,21
2014,Kiyon,M,100,0,21,21
2014,Korrie,F,100,21,0,21
2014,Korynn,F,100,21,0,21
2014,Krysten,F,100,21,0,21
2014,Ksenia,F,100,21,0,21
2014,Kyana,F,100,21,0,21
2014,Kyon,M,100,0,21,21
2014,Labella,F,100,21,0,21
2014,Laiden,M,100,0,21,21
2014,Landrey,F,71,15,6,21
2014,Laszlo,M,100,0,21,21
2014,Lavonte,M,100,0,21,21
2014,Legaci,F,100,21,0,21
2014,Lennyx,F,71,15,6,21
2014,Lileigh,F,100,21,0,21
2014,Lovell,M,100,0,21,21
2014,Lydiah,F,100,21,0,21
2014,Maayan,F,100,21,0,21
2014,Macallan,M,100,0,21,21
2014,Maddelynn,F,100,21,0,21
2014,Maddi,F,100,21,0,21
2014,Maelin,F,100,21,0,21
2014,Mailey,F,100,21,0,21
2014,Maily,F,100,21,0,21
2014,Makenley,F,100,21,0,21
2014,Makensie,F,100,21,0,21
2014,Makinsley,F,100,21,0,21
2014,Mandi,F,100,21,0,21
2014,Marino,M,100,0,21,21
2014,Marlayna,F,100,21,0,21
2014,Marquell,M,100,0,21,21
2014,Matilde,F,100,21,0,21
2014,Matti,F,76,16,5,21
2014,Maxfield,M,100,0,21,21
2014,Mayerly,F,100,21,0,21
2014,Mccartney,F,100,21,0,21
2014,Md,M,100,0,21,21
2014,Mele,F,100,21,0,21
2014,Merry,F,100,21,0,21
2014,Miki,F,100,21,0,21
2014,Mirah,F,100,21,0,21
2014,Mirian,F,100,21,0,21
2014,Montreal,M,100,0,21,21
2014,Mose,M,100,0,21,21
2014,Muhamad,M,100,0,21,21
2014,Myana,F,100,21,0,21
2014,Mychael,M,100,0,21,21
2014,Myking,M,100,0,21,21
2014,Mylie,F,100,21,0,21
2014,Naira,F,100,21,0,21
2014,Nani,F,100,21,0,21
2014,Narayan,M,100,0,21,21
2014,Nason,M,100,0,21,21
2014,Nayana,F,100,21,0,21
2014,Naylani,F,100,21,0,21
2014,Nels,M,100,0,21,21
2014,Nevaan,M,100,0,21,21
2014,Newton,M,100,0,21,21
2014,Nicoletta,F,100,21,0,21
2014,Nuvia,F,100,21,0,21
2014,Odell,M,100,0,21,21
2014,Olivya,F,100,21,0,21
2014,Oluwatobiloba,M,67,7,14,21
2014,Orlin,M,100,0,21,21
2014,Othman,M,100,0,21,21
2014,Pascal,M,100,0,21,21
2014,Payne,M,100,0,21,21
2014,Peightyn,F,100,21,0,21
2014,Pennelope,F,100,21,0,21
2014,Persia,F,100,21,0,21
2014,Phyllis,F,100,21,0,21
2014,Presli,F,100,21,0,21
2014,Prim,F,100,21,0,21
2014,Princeston,M,100,0,21,21
2014,Raeghan,F,100,21,0,21
2014,Rahil,M,100,0,21,21
2014,Rahman,M,100,0,21,21
2014,Rakiyah,F,100,21,0,21
2014,Randon,M,100,0,21,21
2014,Raquan,M,100,0,21,21
2014,Ravenna,F,100,21,0,21
2014,Raylie,F,100,21,0,21
2014,Reagen,F,76,16,5,21
2014,Rebeka,F,100,21,0,21
2014,Reis,M,67,7,14,21
2014,Remmi,F,100,21,0,21
2014,Remmie,F,100,21,0,21
2014,Renly,M,76,5,16,21
2014,Ricco,M,100,0,21,21
2014,Rj,M,100,0,21,21
2014,Robel,M,100,0,21,21
2014,Rocklyn,F,100,21,0,21
2014,Rohin,M,100,0,21,21
2014,Roizy,F,100,21,0,21
2014,Rolan,M,100,0,21,21
2014,Rona,F,100,21,0,21
2014,Ronni,F,100,21,0,21
2014,Rosendo,M,100,0,21,21
2014,Roshni,F,100,21,0,21
2014,Rosmery,F,100,21,0,21
2014,Ruhaan,M,100,0,21,21
2014,Ryle,M,71,6,15,21
2014,Ryon,M,100,0,21,21
2014,Saatvik,M,100,0,21,21
2014,Safaa,F,100,21,0,21
2014,Safari,F,76,16,5,21
2014,Sahira,F,100,21,0,21
2014,Salih,M,100,0,21,21
2014,Sanders,M,100,0,21,21
2014,Saralynn,F,100,21,0,21
2014,Seba,F,100,21,0,21
2014,Sereen,F,100,21,0,21
2014,Shanvi,F,100,21,0,21
2014,Shelley,F,100,21,0,21
2014,Shyne,M,67,7,14,21
2014,Siah,F,62,13,8,21
2014,Sindy,F,100,21,0,21
2014,Sole,F,100,21,0,21
2014,Solimar,F,100,21,0,21
2014,Soul,M,57,9,12,21
2014,Spenser,M,67,7,14,21
2014,Stefon,M,100,0,21,21
2014,Stormi,F,100,21,0,21
2014,Tanishka,F,100,21,0,21
2014,Tayleigh,F,100,21,0,21
2014,Teya,F,100,21,0,21
2014,Torsten,M,100,0,21,21
2014,Trayce,M,100,0,21,21
2014,Treyden,M,100,0,21,21
2014,Tricia,F,100,21,0,21
2014,Tuesday,F,100,21,0,21
2014,Uzziel,M,100,0,21,21
2014,Vasilios,M,100,0,21,21
2014,Vianca,F,100,21,0,21
2014,Viliami,M,100,0,21,21
2014,Vittorio,M,100,0,21,21
2014,Weslie,F,67,14,7,21
2014,Wheeler,M,100,0,21,21
2014,Xion,M,100,0,21,21
2014,Yandiel,M,100,0,21,21
2014,Yaneliz,F,100,21,0,21
2014,Yaritzi,F,100,21,0,21
2014,Yetzali,F,100,21,0,21
2014,Yuma,M,100,0,21,21
2014,Yuriel,M,100,0,21,21
2014,Zakiah,F,76,16,5,21
2014,Zakkary,M,100,0,21,21
2014,Zayde,M,71,6,15,21
2014,Zebadiah,M,100,0,21,21
2014,Zita,F,100,21,0,21
2014,Zivah,F,100,21,0,21
2014,Zlata,F,100,21,0,21
2014,Zoriah,F,100,21,0,21
2014,Zyanya,F,100,21,0,21
2014,Aaren,M,100,0,20,20
2014,Aariah,F,100,20,0,20
2014,Aarian,M,65,7,13,20
2014,Abdoul,M,100,0,20,20
2014,Aby,F,100,20,0,20
2014,Aengus,M,100,0,20,20
2014,Afnan,F,75,15,5,20
2014,Agam,M,60,8,12,20
2014,Ailish,F,100,20,0,20
2014,Ainhoa,F,100,20,0,20
2014,Aixa,F,100,20,0,20
2014,Ajla,F,100,20,0,20
2014,Akilah,F,100,20,0,20
2014,Aking,M,100,0,20,20
2014,Akirah,F,100,20,0,20
2014,Alainna,F,100,20,0,20
2014,Aleck,M,100,0,20,20
2014,Amada,F,100,20,0,20
2014,Amaiah,F,100,20,0,20
2014,Amonte,M,100,0,20,20
2014,Analie,F,100,20,0,20
2014,Anayla,F,100,20,0,20
2014,Andriana,F,100,20,0,20
2014,Anthonie,M,100,0,20,20
2014,Antwaun,M,100,0,20,20
2014,Anyelin,F,100,20,0,20
2014,Arella,F,100,20,0,20
2014,Ariell,F,100,20,0,20
2014,Armond,M,100,0,20,20
2014,Arora,F,100,20,0,20
2014,Aryannah,F,100,20,0,20
2014,Ashlie,F,100,20,0,20
2014,Athalia,F,100,20,0,20
2014,Audi,F,60,12,8,20
2014,Aviella,F,100,20,0,20
2014,Avis,M,55,9,11,20
2014,Avrey,F,55,11,9,20
2014,Bahar,F,100,20,0,20
2014,Bailie,F,100,20,0,20
2014,Basel,M,100,0,20,20
2014,Bassam,M,100,0,20,20
2014,Benjamen,M,100,0,20,20
2014,Benjiman,M,100,0,20,20
2014,Beya,F,100,20,0,20
2014,Bowman,M,100,0,20,20
2014,Breydan,M,100,0,20,20
2014,Briah,F,100,20,0,20
2014,Bright,M,100,0,20,20
2014,British,F,100,20,0,20
2014,Caio,M,100,0,20,20
2014,Callyn,F,100,20,0,20
2014,Cameo,F,60,12,8,20
2014,Carlena,F,100,20,0,20
2014,Chantz,M,100,0,20,20
2014,Chanze,M,100,0,20,20
2014,Chayden,M,100,0,20,20
2014,Che,M,100,0,20,20
2014,Christoph,M,100,0,20,20
2014,Ciela,F,100,20,0,20
2014,Clemente,M,100,0,20,20
2014,Cliff,M,100,0,20,20
2014,Cliffton,M,100,0,20,20
2014,Coley,F,55,11,9,20
2014,Colsen,M,100,0,20,20
2014,Contessa,F,100,20,0,20
2014,Corbett,M,100,0,20,20
2014,Corrie,F,100,20,0,20
2014,Courage,M,65,7,13,20
2014,Cylee,F,100,20,0,20
2014,Dacari,M,100,0,20,20
2014,Dailynn,F,100,20,0,20
2014,Daimon,M,100,0,20,20
2014,Daleah,F,100,20,0,20
2014,Damaria,F,100,20,0,20
2014,Damiah,F,100,20,0,20
2014,Damond,M,100,0,20,20
2014,Danaya,F,100,20,0,20
2014,Darci,F,100,20,0,20
2014,Dayshawn,M,100,0,20,20
2014,Decklin,M,100,0,20,20
2014,Deetya,F,100,20,0,20
2014,Delbert,M,100,0,20,20
2014,Delfino,M,100,0,20,20
2014,Delsin,M,100,0,20,20
2014,Deng,M,100,0,20,20
2014,Devlyn,F,70,14,6,20
2014,Dianne,F,100,20,0,20
2014,Djuan,M,100,0,20,20
2014,Dmarion,M,100,0,20,20
2014,Dove,F,100,20,0,20
2014,Dunya,F,100,20,0,20
2014,Eboni,F,100,20,0,20
2014,Eily,F,100,20,0,20
2014,Elda,F,100,20,0,20
2014,Elenora,F,100,20,0,20
2014,Elenore,F,100,20,0,20
2014,Eliette,F,100,20,0,20
2014,Elisabetta,F,100,20,0,20
2014,Elleana,F,100,20,0,20
2014,Ellianah,F,100,20,0,20
2014,Ellsie,F,100,20,0,20
2014,Ellyse,F,100,20,0,20
2014,Elona,F,100,20,0,20
2014,Elroy,M,100,0,20,20
2014,Emin,M,100,0,20,20
2014,Emmaly,F,100,20,0,20
2014,Emmalyne,F,100,20,0,20
2014,Emrey,F,100,20,0,20
2014,Errol,M,100,0,20,20
2014,Erykah,F,100,20,0,20
2014,Evaline,F,100,20,0,20
2014,Evann,M,70,6,14,20
2014,Everlyn,F,100,20,0,20
2014,Fatema,F,100,20,0,20
2014,Filomena,F,100,20,0,20
2014,Franklyn,M,100,0,20,20
2014,Franko,M,100,0,20,20
2014,Galileo,M,100,0,20,20
2014,Galvin,M,100,0,20,20
2014,Georgios,M,100,0,20,20
2014,Geremiah,M,100,0,20,20
2014,Grier,F,75,15,5,20
2014,Griffyn,M,70,6,14,20
2014,Haakon,M,100,0,20,20
2014,Hamdi,F,100,20,0,20
2014,Hartlyn,F,100,20,0,20
2014,Haruki,M,100,0,20,20
2014,Hasani,M,100,0,20,20
2014,Heydi,F,100,20,0,20
2014,Ioannis,M,100,0,20,20
2014,Irfan,M,100,0,20,20
2014,Israella,F,100,20,0,20
2014,Isyss,F,100,20,0,20
2014,Ivelisse,F,100,20,0,20
2014,Iza,F,100,20,0,20
2014,Jaaziah,M,100,0,20,20
2014,Jaeson,M,100,0,20,20
2014,Jafar,M,100,0,20,20
2014,Jaidynn,F,100,20,0,20
2014,Jaivion,M,100,0,20,20
2014,Jakaden,M,100,0,20,20
2014,Jakiah,F,75,15,5,20
2014,Jalin,M,60,8,12,20
2014,Jamisyn,F,75,15,5,20
2014,Jamyia,F,100,20,0,20
2014,Janani,F,100,20,0,20
2014,Jaretssi,F,100,20,0,20
2014,Jaslin,F,100,20,0,20
2014,Jatniel,M,100,0,20,20
2014,Jatziry,F,100,20,0,20
2014,Jennavieve,F,100,20,0,20
2014,Jeremi,M,100,0,20,20
2014,Jeremiyah,M,100,0,20,20
2014,Jernee,F,100,20,0,20
2014,Jevin,M,100,0,20,20
2014,Jeylin,F,100,20,0,20
2014,Jhoan,M,100,0,20,20
2014,Jhonatan,M,100,0,20,20
2014,Josian,M,100,0,20,20
2014,Josselin,F,100,20,0,20
2014,Josyah,M,100,0,20,20
2014,Julee,F,100,20,0,20
2014,July,F,60,12,8,20
2014,Juvenal,M,100,0,20,20
2014,Kacyn,M,70,6,14,20
2014,Kahari,M,100,0,20,20
2014,Kailie,F,100,20,0,20
2014,Kaiyan,M,100,0,20,20
2014,Kalev,M,100,0,20,20
2014,Kalob,M,100,0,20,20
2014,Kani,M,70,6,14,20
2014,Karalina,F,100,20,0,20
2014,Karrigan,F,100,20,0,20
2014,Kattaleya,F,100,20,0,20
2014,Kayda,F,100,20,0,20
2014,Kc,M,100,0,20,20
2014,Keidy,F,100,20,0,20
2014,Kemar,M,100,0,20,20
2014,Kendan,M,100,0,20,20
2014,Kennan,M,100,0,20,20
2014,Kennia,F,100,20,0,20
2014,Kenshin,M,100,0,20,20
2014,Kentavious,M,100,0,20,20
2014,Khairi,M,100,0,20,20
2014,Khylan,M,100,0,20,20
2014,Khylin,M,60,8,12,20
2014,Kimoni,F,50,10,10,20
2014,Kingjames,M,100,0,20,20
2014,Kingstyn,M,100,0,20,20
2014,Kion,M,100,0,20,20
2014,Konstantine,M,100,0,20,20
2014,Krishav,M,100,0,20,20
2014,Lamarr,M,100,0,20,20
2014,Lamiah,F,100,20,0,20
2014,Landynn,M,55,9,11,20
2014,Lania,F,100,20,0,20
2014,Larae,F,100,20,0,20
2014,Lasya,F,100,20,0,20
2014,Laylanie,F,100,20,0,20
2014,Leandre,M,100,0,20,20
2014,Lelah,F,100,20,0,20
2014,Letti,F,100,20,0,20
2014,Levii,M,100,0,20,20
2014,Lianne,F,100,20,0,20
2014,Liel,F,100,20,0,20
2014,Lilyth,F,100,20,0,20
2014,Lindon,M,100,0,20,20
2014,Lively,F,100,20,0,20
2014,Loriel,F,100,20,0,20
2014,Lorin,F,100,20,0,20
2014,Lucina,F,100,20,0,20
2014,Lynnleigh,F,100,20,0,20
2014,Lynzie,F,100,20,0,20
2014,Maaz,M,100,0,20,20
2014,Mael,M,100,0,20,20
2014,Mahlia,F,100,20,0,20
2014,Maizee,F,100,20,0,20
2014,Makaiya,F,100,20,0,20
2014,Makaylin,F,100,20,0,20
2014,Makenly,F,100,20,0,20
2014,Makeyla,F,100,20,0,20
2014,Makhia,F,100,20,0,20
2014,Maksymilian,M,100,0,20,20
2014,Manasvi,F,100,20,0,20
2014,Marci,F,100,20,0,20
2014,Margarito,M,100,0,20,20
2014,Marielena,F,100,20,0,20
2014,Marionna,F,100,20,0,20
2014,Marit,F,100,20,0,20
2014,Markese,M,100,0,20,20
2014,Marni,F,100,20,0,20
2014,Matea,F,100,20,0,20
2014,Maxamillion,M,100,0,20,20
2014,Mayumi,F,100,20,0,20
2014,Mckennah,F,100,20,0,20
2014,Mckinsey,F,100,20,0,20
2014,Mckinsley,F,100,20,0,20
2014,Mehreen,F,100,20,0,20
2014,Mekai,M,100,0,20,20
2014,Mesiah,M,100,0,20,20
2014,Miarose,F,100,20,0,20
2014,Midori,F,100,20,0,20
2014,Mikaeel,M,100,0,20,20
2014,Mikela,F,100,20,0,20
2014,Mikenna,F,100,20,0,20
2014,Mikeyla,F,100,20,0,20
2014,Milia,F,100,20,0,20
2014,Mirielle,F,100,20,0,20
2014,Mister,M,100,0,20,20
2014,Munir,M,100,0,20,20
2014,Myleah,F,100,20,0,20
2014,Mysha,F,100,20,0,20
2014,Nachman,M,100,0,20,20
2014,Naidelyn,F,100,20,0,20
2014,Naiyah,F,100,20,0,20
2014,Narek,M,100,0,20,20
2014,Nariya,F,100,20,0,20
2014,Naseer,M,100,0,20,20
2014,Nashley,F,100,20,0,20
2014,Nashly,F,100,20,0,20
2014,Niva,F,100,20,0,20
2014,Noriah,F,100,20,0,20
2014,Nuha,F,100,20,0,20
2014,Nur,F,65,13,7,20
2014,Nyles,M,100,0,20,20
2014,Oluwatamilore,F,75,15,5,20
2014,Oshea,M,100,0,20,20
2014,Ousmane,M,100,0,20,20
2014,Paizleigh,F,100,20,0,20
2014,Pearce,M,100,0,20,20
2014,Pheobe,F,100,20,0,20
2014,Priyanka,F,100,20,0,20
2014,Raelene,F,100,20,0,20
2014,Rainier,M,100,0,20,20
2014,Ranvir,M,100,0,20,20
2014,Rayleen,F,100,20,0,20
2014,Rebecka,F,100,20,0,20
2014,Reghan,F,100,20,0,20
2014,Reinaldo,M,100,0,20,20
2014,Reniyah,F,100,20,0,20
2014,Rielynn,F,100,20,0,20
2014,Rishan,M,100,0,20,20
2014,Riyad,M,100,0,20,20
2014,Rock,M,100,0,20,20
2014,Rocket,M,65,7,13,20
2014,Romario,M,100,0,20,20
2014,Rosaleen,F,100,20,0,20
2014,Roxas,M,100,0,20,20
2014,Rufus,M,100,0,20,20
2014,Ruslan,M,100,0,20,20
2014,Ryanna,F,100,20,0,20
2014,Rylon,M,100,0,20,20
2014,Sabin,M,100,0,20,20
2014,Saddie,F,100,20,0,20
2014,Safira,F,100,20,0,20
2014,Sahra,F,100,20,0,20
2014,Saidee,F,100,20,0,20
2014,Samual,M,100,0,20,20
2014,Sanayah,F,100,20,0,20
2014,Sari,F,100,20,0,20
2014,Saryah,F,100,20,0,20
2014,Savon,M,100,0,20,20
2014,Scotlynn,F,100,20,0,20
2014,Serenitee,F,100,20,0,20
2014,Shad,M,100,0,20,20
2014,Shadow,M,70,6,14,20
2014,Shantel,F,100,20,0,20
2014,Shanya,F,100,20,0,20
2014,Shaul,M,100,0,20,20
2014,Shaylene,F,100,20,0,20
2014,Shealynn,F,100,20,0,20
2014,Shoshanna,F,100,20,0,20
2014,Shraddha,F,100,20,0,20
2014,Silvestre,M,100,0,20,20
2014,Solveig,F,100,20,0,20
2014,Stanford,M,100,0,20,20
2014,Stark,M,100,0,20,20
2014,Stefen,M,100,0,20,20
2014,Strider,M,100,0,20,20
2014,Surina,F,100,20,0,20
2014,Syair,M,100,0,20,20
2014,Syniah,F,100,20,0,20
2014,Syrena,F,100,20,0,20
2014,Syria,F,100,20,0,20
2014,Talisa,F,100,20,0,20
2014,Tameem,M,100,0,20,20
2014,Tauriel,F,100,20,0,20
2014,Teanna,F,100,20,0,20
2014,Teghan,F,55,11,9,20
2014,Thora,F,100,20,0,20
2014,Tilden,M,100,0,20,20
2014,Tora,F,100,20,0,20
2014,Treston,M,100,0,20,20
2014,Trevyn,M,100,0,20,20
2014,Trindon,M,100,0,20,20
2014,Trinidy,F,100,20,0,20
2014,Tylie,F,100,20,0,20
2014,Tyrique,M,100,0,20,20
2014,Tysean,M,100,0,20,20
2014,Tyshon,M,100,0,20,20
2014,Vale,F,60,12,8,20
2014,Varsha,F,100,20,0,20
2014,Vashti,F,100,20,0,20
2014,Viva,F,100,20,0,20
2014,Warrick,M,100,0,20,20
2014,Weylin,M,100,0,20,20
2014,Woods,M,100,0,20,20
2014,Xaiver,M,100,0,20,20
2014,Xzavior,M,100,0,20,20
2014,Yakira,F,100,20,0,20
2014,Yamila,F,100,20,0,20
2014,Yeison,M,100,0,20,20
2014,Ysabelle,F,100,20,0,20
2014,Yui,F,100,20,0,20
2014,Zahmir,M,100,0,20,20
2014,Zalaya,F,100,20,0,20
2014,Zalayah,F,100,20,0,20
2014,Zamyah,F,100,20,0,20
2014,Zanden,M,100,0,20,20
2014,Zarianna,F,100,20,0,20
2014,Zaylynn,F,100,20,0,20
2014,Zendayah,F,100,20,0,20
2014,Zeth,M,100,0,20,20
2014,Ziyan,M,60,8,12,20
2014,Zuriah,F,100,20,0,20
2014,Zyaira,F,100,20,0,20
2014,Zymere,M,100,0,20,20
2014,Aadam,M,100,0,19,19
2014,Aarvi,F,100,19,0,19
2014,Abenezer,M,100,0,19,19
2014,Abrahan,M,100,0,19,19
2014,Aceyn,M,100,0,19,19
2014,Adahlia,F,100,19,0,19
2014,Adanna,F,100,19,0,19
2014,Addalee,F,100,19,0,19
2014,Adelheid,F,100,19,0,19
2014,Adlai,M,53,9,10,19
2014,Adylene,F,100,19,0,19
2014,Aeva,F,100,19,0,19
2014,Ahad,M,100,0,19,19
2014,Aidden,M,100,0,19,19
2014,Aidenn,M,100,0,19,19
2014,Aidon,M,100,0,19,19
2014,Airiana,F,100,19,0,19
2014,Aiyla,F,100,19,0,19
2014,Alania,F,100,19,0,19
2014,Aldin,M,100,0,19,19
2014,Aleesia,F,100,19,0,19
2014,Aleks,M,100,0,19,19
2014,Aleksey,M,100,0,19,19
2014,Alik,M,74,5,14,19
2014,Alisyn,F,100,19,0,19
2014,Alizon,F,100,19,0,19
2014,Alliah,F,100,19,0,19
2014,Allianna,F,100,19,0,19
2014,Allizon,F,100,19,0,19
2014,Allora,F,100,19,0,19
2014,Alon,M,100,0,19,19
2014,Alyzah,F,100,19,0,19
2014,Amilyah,F,100,19,0,19
2014,Amisha,F,100,19,0,19
2014,Amorah,F,100,19,0,19
2014,Amyla,F,100,19,0,19
2014,Ananias,M,100,0,19,19
2014,Anasophia,F,100,19,0,19
2014,Anastazia,F,100,19,0,19
2014,Andrik,M,100,0,19,19
2014,Angelena,F,100,19,0,19
2014,Angeliz,F,100,19,0,19
2014,Anjana,F,100,19,0,19
2014,Annalese,F,100,19,0,19
2014,Annastyn,F,100,19,0,19
2014,Anneke,F,100,19,0,19
2014,Anny,F,100,19,0,19
2014,Anzal,F,100,19,0,19
2014,Apple,F,100,19,0,19
2014,Arath,M,100,0,19,19
2014,Areesha,F,100,19,0,19
2014,Asaad,M,100,0,19,19
2014,Athanasios,M,100,0,19,19
2014,Attikus,M,100,0,19,19
2014,Aubreyanna,F,100,19,0,19
2014,Avaneesh,M,100,0,19,19
2014,Aveya,F,100,19,0,19
2014,Avner,M,100,0,19,19
2014,Ayaansh,M,100,0,19,19
2014,Aydien,M,100,0,19,19
2014,Ayyub,M,100,0,19,19
2014,Azalee,F,100,19,0,19
2014,Azarion,M,100,0,19,19
2014,Bellamarie,F,100,19,0,19
2014,Bensyn,M,100,0,19,19
2014,Blessyn,F,100,19,0,19
2014,Bow,M,100,0,19,19
2014,Braidon,M,100,0,19,19
2014,Braxston,M,100,0,19,19
2014,Breydon,M,100,0,19,19
2014,Breyon,M,100,0,19,19
2014,Brieanna,F,100,19,0,19
2014,Brihana,F,100,19,0,19
2014,Britanny,F,100,19,0,19
2014,Brycin,M,100,0,19,19
2014,Bryler,M,100,0,19,19
2014,Brynlea,F,100,19,0,19
2014,Caedyn,M,100,0,19,19
2014,Calan,M,100,0,19,19
2014,Calyn,F,63,12,7,19
2014,Camdin,M,100,0,19,19
2014,Carah,F,100,19,0,19
2014,Carden,M,100,0,19,19
2014,Carlene,F,100,19,0,19
2014,Carmelina,F,100,19,0,19
2014,Carmina,F,100,19,0,19
2014,Cassian,M,100,0,19,19
2014,Catalia,F,100,19,0,19
2014,Cece,F,100,19,0,19
2014,Celestine,F,100,19,0,19
2014,Chanell,F,100,19,0,19
2014,Channel,F,100,19,0,19
2014,Charbel,M,100,0,19,19
2014,Chastin,M,74,5,14,19
2014,Cheikh,M,100,0,19,19
2014,Chesley,F,53,10,9,19
2014,Cheveyo,M,100,0,19,19
2014,Christabella,F,100,19,0,19
2014,Cianni,F,100,19,0,19
2014,Cohan,M,100,0,19,19
2014,Corah,F,100,19,0,19
2014,Corianna,F,100,19,0,19
2014,Corynn,F,100,19,0,19
2014,Cruise,M,100,0,19,19
2014,Cruzito,M,100,0,19,19
2014,Curt,M,100,0,19,19
2014,Dael,M,100,0,19,19
2014,Daija,F,100,19,0,19
2014,Dalyn,M,100,0,19,19
2014,Damarian,M,100,0,19,19
2014,Dannah,F,100,19,0,19
2014,Danniel,M,100,0,19,19
2014,Dathan,M,100,0,19,19
2014,Daviel,M,100,0,19,19
2014,Daylynn,F,100,19,0,19
2014,Degan,M,100,0,19,19
2014,Dekota,F,53,10,9,19
2014,Desiray,F,100,19,0,19
2014,Destine,F,53,10,9,19
2014,Destry,M,74,5,14,19
2014,Deziah,F,74,14,5,19
2014,Dhruva,M,100,0,19,19
2014,Dionicio,M,100,0,19,19
2014,Donaven,M,100,0,19,19
2014,Eber,M,100,0,19,19
2014,Edinson,M,100,0,19,19
2014,Eisen,M,100,0,19,19
2014,Elka,F,100,19,0,19
2014,Emelin,F,100,19,0,19
2014,Emet,M,100,0,19,19
2014,Emiah,F,100,19,0,19
2014,Emmely,F,100,19,0,19
2014,Endia,F,100,19,0,19
2014,Enna,F,100,19,0,19
2014,Erma,F,100,19,0,19
2014,Evalena,F,100,19,0,19
2014,Evangelos,M,100,0,19,19
2014,Evoleht,F,100,19,0,19
2014,Evynn,F,100,19,0,19
2014,Eyleen,F,100,19,0,19
2014,Ezrael,M,100,0,19,19
2014,Falon,F,100,19,0,19
2014,Farren,F,74,14,5,19
2014,Favour,F,100,19,0,19
2014,Fawn,F,100,19,0,19
2014,Fin,M,100,0,19,19
2014,Finnlee,M,53,9,10,19
2014,Frady,F,100,19,0,19
2014,Gabriell,F,53,10,9,19
2014,Gaines,M,100,0,19,19
2014,Galileah,F,100,19,0,19
2014,Gertrude,F,100,19,0,19
2014,Gracelin,F,100,19,0,19
2014,Grahm,M,100,0,19,19
2014,Greyden,M,100,0,19,19
2014,Gustav,M,100,0,19,19
2014,Haile,F,63,12,7,19
2014,Haizley,F,100,19,0,19
2014,Hamish,M,100,0,19,19
2014,Hanif,M,100,0,19,19
2014,Hawthorne,M,100,0,19,19
2014,Hayle,F,100,19,0,19
2014,Hazelyn,F,100,19,0,19
2014,Heer,F,100,19,0,19
2014,Henslee,F,100,19,0,19
2014,Hira,F,100,19,0,19
2014,Hiroshi,M,100,0,19,19
2014,Hiyab,F,74,14,5,19
2014,Holli,F,100,19,0,19
2014,Ikaika,M,100,0,19,19
2014,Ilona,F,100,19,0,19
2014,Infinity,F,100,19,0,19
2014,Iniya,F,100,19,0,19
2014,Ioanna,F,100,19,0,19
2014,Iriana,F,100,19,0,19
2014,Isaih,M,100,0,19,19
2014,Isidora,F,100,19,0,19
2014,Izaan,M,100,0,19,19
2014,Izac,M,100,0,19,19
2014,Jachin,M,100,0,19,19
2014,Jacinda,F,100,19,0,19
2014,Jadzia,F,100,19,0,19
2014,Jager,M,100,0,19,19
2014,Jahan,M,100,0,19,19
2014,Jahmeir,M,100,0,19,19
2014,Jahniya,F,100,19,0,19
2014,Jaiven,M,100,0,19,19
2014,Jakira,F,100,19,0,19
2014,Jalayna,F,100,19,0,19
2014,Jalina,F,100,19,0,19
2014,Jamarie,M,68,6,13,19
2014,Jameelah,F,100,19,0,19
2014,Jamesyn,F,58,11,8,19
2014,Jamirah,F,100,19,0,19
2014,Jamire,M,100,0,19,19
2014,Janellie,F,100,19,0,19
2014,Jannet,F,100,19,0,19
2014,Janyia,F,100,19,0,19
2014,Jarom,M,100,0,19,19
2014,Jarron,M,100,0,19,19
2014,Jasani,F,68,13,6,19
2014,Jaxxson,M,100,0,19,19
2014,Jaydeen,M,74,5,14,19
2014,Jaydence,M,63,7,12,19
2014,Jaylean,F,100,19,0,19
2014,Jaylenn,F,63,12,7,19
2014,Jayli,F,100,19,0,19
2014,Jaymison,M,100,0,19,19
2014,Jaziya,F,100,19,0,19
2014,Jenise,F,100,19,0,19
2014,Jep,M,100,0,19,19
2014,Jessejames,M,100,0,19,19
2014,Jhonathan,M,100,0,19,19
2014,Joeseph,M,100,0,19,19
2014,Johnie,M,74,5,14,19
2014,Jonae,F,100,19,0,19
2014,Jood,F,100,19,0,19
2014,Jordany,M,100,0,19,19
2014,Josee,F,100,19,0,19
2014,Joshue,M,100,0,19,19
2014,Juwan,M,100,0,19,19
2014,Kadience,F,100,19,0,19
2014,Kaeo,M,100,0,19,19
2014,Kaleyah,F,100,19,0,19
2014,Kalon,M,100,0,19,19
2014,Kamyia,F,100,19,0,19
2014,Karan,M,100,0,19,19
2014,Karima,F,100,19,0,19
2014,Karlyn,F,100,19,0,19
2014,Kasch,M,100,0,19,19
2014,Katara,F,100,19,0,19
2014,Katerin,F,100,19,0,19
2014,Katharina,F,100,19,0,19
2014,Katiana,F,100,19,0,19
2014,Kaydince,F,100,19,0,19
2014,Kayleeann,F,100,19,0,19
2014,Kaylynne,F,100,19,0,19
2014,Kaytlyn,F,100,19,0,19
2014,Kazi,M,74,5,14,19
2014,Keilany,F,100,19,0,19
2014,Kemora,F,100,19,0,19
2014,Kemuel,M,100,0,19,19
2014,Kendallyn,F,100,19,0,19
2014,Kenlei,F,100,19,0,19
2014,Kennah,F,100,19,0,19
2014,Kenzly,F,100,19,0,19
2014,Keyona,F,100,19,0,19
2014,Khiara,F,100,19,0,19
2014,Khilee,F,100,19,0,19
2014,Khori,F,100,19,0,19
2014,Kiely,F,100,19,0,19
2014,Kindall,F,74,14,5,19
2014,Kitzia,F,100,19,0,19
2014,Kristie,F,100,19,0,19
2014,Krithik,M,100,0,19,19
2014,Kyiah,F,100,19,0,19
2014,Kylinn,F,100,19,0,19
2014,Kylor,M,100,0,19,19
2014,Kynzee,F,100,19,0,19
2014,Laiba,F,100,19,0,19
2014,Lamichael,M,100,0,19,19
2014,Lareina,F,100,19,0,19
2014,Leam,M,100,0,19,19
2014,Leanny,F,100,19,0,19
2014,Leira,F,100,19,0,19
2014,Leiyah,F,100,19,0,19
2014,Leola,F,100,19,0,19
2014,Leyland,M,100,0,19,19
2014,Lilie,F,100,19,0,19
2014,Lillyona,F,100,19,0,19
2014,Lindsy,F,100,19,0,19
2014,Lio,M,100,0,19,19
2014,Lorenza,F,68,13,6,19
2014,Lucah,M,100,0,19,19
2014,Lucious,M,100,0,19,19
2014,Lyan,M,100,0,19,19
2014,Maanya,F,100,19,0,19
2014,Mahika,F,100,19,0,19
2014,Mahkai,M,100,0,19,19
2014,Malachy,M,100,0,19,19
2014,Malaiyah,F,100,19,0,19
2014,Malania,F,100,19,0,19
2014,Malichi,M,100,0,19,19
2014,Mariaelena,F,100,19,0,19
2014,Maricella,F,100,19,0,19
2014,Marlaysia,F,100,19,0,19
2014,Marshon,M,100,0,19,19
2014,Maryalice,F,100,19,0,19
2014,Mathilde,F,100,19,0,19
2014,Maybelline,F,100,19,0,19
2014,Maynard,M,100,0,19,19
2014,Mcclain,M,63,7,12,19
2014,Mekenzie,F,100,19,0,19
2014,Meron,F,100,19,0,19
2014,Miqueas,M,100,0,19,19
2014,Miroslava,F,100,19,0,19
2014,Misa,F,100,19,0,19
2014,Mitch,M,100,0,19,19
2014,Myangel,F,100,19,0,19
2014,Myer,M,100,0,19,19
2014,Nakia,F,100,19,0,19
2014,Nakiya,F,100,19,0,19
2014,Nardos,F,100,19,0,19
2014,Nasya,F,100,19,0,19
2014,Nathali,F,100,19,0,19
2014,Natnael,M,100,0,19,19
2014,Navayah,F,100,19,0,19
2014,Nazario,M,100,0,19,19
2014,Nazier,M,100,0,19,19
2014,Neeko,M,100,0,19,19
2014,Neomi,F,100,19,0,19
2014,Neriyah,F,100,19,0,19
2014,Nicklas,M,100,0,19,19
2014,Nikol,F,100,19,0,19
2014,Nirvaan,M,100,0,19,19
2014,Noely,F,100,19,0,19
2014,Nuria,F,100,19,0,19
2014,Ogden,M,100,0,19,19
2014,Oksana,F,100,19,0,19
2014,Olan,M,100,0,19,19
2014,Oluwatimilehin,M,100,0,19,19
2014,Oreoluwa,F,63,12,7,19
2014,Parish,M,53,9,10,19
2014,Pascual,M,100,0,19,19
2014,Piero,M,100,0,19,19
2014,Pola,F,100,19,0,19
2014,Praneel,M,100,0,19,19
2014,Ragnar,M,100,0,19,19
2014,Raihan,M,100,0,19,19
2014,Raisa,F,100,19,0,19
2014,Raja,M,68,6,13,19
2014,Rama,F,100,19,0,19
2014,Rayansh,M,100,0,19,19
2014,Reba,F,100,19,0,19
2014,Rebekkah,F,100,19,0,19
2014,Rexton,M,100,0,19,19
2014,Reyan,M,100,0,19,19
2014,Reygan,F,100,19,0,19
2014,Rielyn,F,100,19,0,19
2014,Ripken,M,100,0,19,19
2014,Ritaj,F,100,19,0,19
2014,Romen,M,100,0,19,19
2014,Rossy,F,100,19,0,19
2014,Rui,M,100,0,19,19
2014,Rumaisa,F,100,19,0,19
2014,Ruxin,M,100,0,19,19
2014,Ryo,M,100,0,19,19
2014,Sabian,M,100,0,19,19
2014,Safiyyah,F,100,19,0,19
2014,Saliha,F,100,19,0,19
2014,Samay,M,74,5,14,19
2014,Samina,F,100,19,0,19
2014,Sanaii,F,100,19,0,19
2014,Santonio,M,100,0,19,19
2014,Sarita,F,100,19,0,19
2014,Saskia,F,100,19,0,19
2014,Sayid,M,100,0,19,19
2014,Shahad,F,100,19,0,19
2014,Shanti,F,100,19,0,19
2014,Shareef,M,100,0,19,19
2014,Sheena,F,100,19,0,19
2014,Sherrod,M,100,0,19,19
2014,Simrah,F,100,19,0,19
2014,Sophiya,F,100,19,0,19
2014,Sparkle,F,100,19,0,19
2014,Sriya,F,100,19,0,19
2014,Stacia,F,100,19,0,19
2014,Stellah,F,100,19,0,19
2014,Styles,M,100,0,19,19
2014,Suraiya,F,100,19,0,19
2014,Syaire,M,100,0,19,19
2014,Tad,M,100,0,19,19
2014,Takai,M,100,0,19,19
2014,Talib,M,100,0,19,19
2014,Tam,F,58,11,8,19
2014,Tamsin,F,100,19,0,19
2014,Tana,F,100,19,0,19
2014,Tanush,M,100,0,19,19
2014,Tarynn,F,100,19,0,19
2014,Tehilla,F,100,19,0,19
2014,Temima,F,100,19,0,19
2014,Tenleigh,F,100,19,0,19
2014,Thai,M,63,7,12,19
2014,Timoteo,M,100,0,19,19
2014,Toleen,F,100,19,0,19
2014,Travell,M,100,0,19,19
2014,Trayvion,M,100,0,19,19
2014,Trevan,M,100,0,19,19
2014,Tuck,M,100,0,19,19
2014,Tvisha,F,100,19,0,19
2014,Tyjuan,M,100,0,19,19
2014,Tylynn,F,68,13,6,19
2014,Tyrek,M,100,0,19,19
2014,Tytiana,F,100,19,0,19
2014,Ulices,M,100,0,19,19
2014,Unity,F,100,19,0,19
2014,Valorie,F,100,19,0,19
2014,Vedanshi,F,100,19,0,19
2014,Viviann,F,100,19,0,19
2014,Viyan,M,100,0,19,19
2014,Webb,M,100,0,19,19
2014,Wesleigh,F,100,19,0,19
2014,Willian,M,100,0,19,19
2014,Xiana,F,100,19,0,19
2014,Yahia,M,100,0,19,19
2014,Yalexa,F,100,19,0,19
2014,Yalitza,F,100,19,0,19
2014,Zakk,M,100,0,19,19
2014,Zalia,F,100,19,0,19
2014,Zamara,F,100,19,0,19
2014,Zamyra,F,100,19,0,19
2014,Zanaya,F,100,19,0,19
2014,Zehra,F,100,19,0,19
2014,Zenia,F,100,19,0,19
2014,Zeta,F,100,19,0,19
2014,Zeyad,M,100,0,19,19
2014,Ziare,M,100,0,19,19
2014,Zlatan,M,100,0,19,19
2014,Zoejane,F,100,19,0,19
2014,Zunaira,F,100,19,0,19
2014,Zyier,M,100,0,19,19
2014,Zyrah,F,100,19,0,19
2014,Aadarsh,M,100,0,18,18
2014,Aamina,F,100,18,0,18
2014,Aarish,M,100,0,18,18
2014,Aashritha,F,100,18,0,18
2014,Abi,F,100,18,0,18
2014,Abrie,F,100,18,0,18
2014,Adael,M,100,0,18,18
2014,Adaiah,F,72,13,5,18
2014,Addalie,F,100,18,0,18
2014,Addeline,F,100,18,0,18
2014,Adelene,F,100,18,0,18
2014,Aditri,F,100,18,0,18
2014,Adna,F,100,18,0,18
2014,Adri,F,67,12,6,18
2014,Aerianna,F,100,18,0,18
2014,Aeron,M,100,0,18,18
2014,Ahniyah,F,100,18,0,18
2014,Ahria,F,100,18,0,18
2014,Ahyan,M,100,0,18,18
2014,Ailene,F,100,18,0,18
2014,Aiven,M,100,0,18,18
2014,Alaisha,F,100,18,0,18
2014,Alayza,F,100,18,0,18
2014,Aleesa,F,100,18,0,18
2014,Aleiya,F,100,18,0,18
2014,Alta,F,100,18,0,18
2014,Alucard,M,100,0,18,18
2014,Alyjah,M,56,8,10,18
2014,Alyric,F,100,18,0,18
2014,Alyxandria,F,100,18,0,18
2014,Amberlin,F,100,18,0,18
2014,Ambree,F,100,18,0,18
2014,Amerika,F,100,18,0,18
2014,Amil,M,100,0,18,18
2014,Amylah,F,100,18,0,18
2014,Anaelle,F,100,18,0,18
2014,Anahita,F,100,18,0,18
2014,Anaira,F,100,18,0,18
2014,Analeigha,F,100,18,0,18
2014,Anasia,F,100,18,0,18
2014,Anik,M,100,0,18,18
2014,Anina,F,100,18,0,18
2014,Annaclaire,F,100,18,0,18
2014,Annaleise,F,100,18,0,18
2014,Annalicia,F,100,18,0,18
2014,Aolanis,F,100,18,0,18
2014,Arhan,M,100,0,18,18
2014,Arielis,F,100,18,0,18
2014,Arisa,F,100,18,0,18
2014,Arkin,M,100,0,18,18
2014,Arlan,M,100,0,18,18
2014,Aryonna,F,100,18,0,18
2014,Ashiya,F,100,18,0,18
2014,Attila,M,100,0,18,18
2014,Atziry,F,100,18,0,18
2014,Augusto,M,100,0,18,18
2014,Avalynne,F,100,18,0,18
2014,Aviyah,F,100,18,0,18
2014,Avy,F,100,18,0,18
2014,Aycen,M,100,0,18,18
2014,Baily,F,100,18,0,18
2014,Bailyn,F,100,18,0,18
2014,Balian,M,100,0,18,18
2014,Baran,M,56,8,10,18
2014,Batool,F,100,18,0,18
2014,Batya,F,100,18,0,18
2014,Belladonna,F,100,18,0,18
2014,Beren,M,67,6,12,18
2014,Bintou,F,100,18,0,18
2014,Braelin,F,56,10,8,18
2014,Brave,M,100,0,18,18
2014,Brax,M,100,0,18,18
2014,Brealynn,F,100,18,0,18
2014,Brienne,F,100,18,0,18
2014,Brion,M,100,0,18,18
2014,Bryley,F,100,18,0,18
2014,Buster,M,100,0,18,18
2014,Caellum,M,100,0,18,18
2014,Cambryn,F,61,11,7,18
2014,Camilah,F,100,18,0,18
2014,Camilia,F,100,18,0,18
2014,Cammie,F,100,18,0,18
2014,Camya,F,100,18,0,18
2014,Caralyn,F,100,18,0,18
2014,Carolena,F,100,18,0,18
2014,Cassady,F,100,18,0,18
2014,Castor,M,100,0,18,18
2014,Cato,M,100,0,18,18
2014,Cecile,F,100,18,0,18
2014,Cecilio,M,100,0,18,18
2014,Charmaine,F,100,18,0,18
2014,Cheyanna,F,100,18,0,18
2014,Christion,M,100,0,18,18
2014,Cleopatra,F,100,18,0,18
2014,Codey,M,100,0,18,18
2014,Courtlynn,F,100,18,0,18
2014,Cris,M,100,0,18,18
2014,Daevon,M,100,0,18,18
2014,Dagoberto,M,100,0,18,18
2014,Daijon,M,100,0,18,18
2014,Daleyssa,F,100,18,0,18
2014,Dalya,F,100,18,0,18
2014,Damauri,M,100,0,18,18
2014,Daniah,F,100,18,0,18
2014,Danilynn,F,100,18,0,18
2014,Dashiel,M,100,0,18,18
2014,Dashon,M,100,0,18,18
2014,Deleyza,F,100,18,0,18
2014,Delfina,F,100,18,0,18
2014,Deliyah,F,100,18,0,18
2014,Demetra,F,100,18,0,18
2014,Dennise,F,100,18,0,18
2014,Deslyn,F,100,18,0,18
2014,Devani,F,100,18,0,18
2014,Devika,F,100,18,0,18
2014,Domenica,F,100,18,0,18
2014,Domonique,M,100,0,18,18
2014,Donivan,M,100,0,18,18
2014,Dreden,M,100,0,18,18
2014,Drelyn,M,100,0,18,18
2014,Ediel,M,100,0,18,18
2014,Edrian,M,100,0,18,18
2014,Ehsan,M,100,0,18,18
2014,Eleonore,F,100,18,0,18
2014,Emberleigh,F,100,18,0,18
2014,Emmanuela,F,100,18,0,18
2014,Enza,F,100,18,0,18
2014,Erza,F,72,13,5,18
2014,Evanie,F,100,18,0,18
2014,Evoleth,F,100,18,0,18
2014,Eyal,M,100,0,18,18
2014,Ezmeralda,F,100,18,0,18
2014,Faelynn,F,100,18,0,18
2014,Falcon,M,100,0,18,18
2014,Fatuma,F,100,18,0,18
2014,Fianna,F,100,18,0,18
2014,Freida,F,100,18,0,18
2014,Freja,F,100,18,0,18
2014,Gabrian,M,100,0,18,18
2014,Gaelle,F,100,18,0,18
2014,Galaxy,F,100,18,0,18
2014,Gehrig,M,100,0,18,18
2014,Gelila,F,100,18,0,18
2014,Genessa,F,100,18,0,18
2014,Gianny,F,56,10,8,18
2014,Giavana,F,100,18,0,18
2014,Giorgia,F,100,18,0,18
2014,Glendon,M,100,0,18,18
2014,Gracia,F,100,18,0,18
2014,Habib,M,100,0,18,18
2014,Haedyn,F,72,13,5,18
2014,Hajra,F,100,18,0,18
2014,Hanah,F,100,18,0,18
2014,Hanifa,F,100,18,0,18
2014,Harsh,M,100,0,18,18
2014,Hasini,F,100,18,0,18
2014,Hazelynn,F,100,18,0,18
2014,Heinrich,M,100,0,18,18
2014,Henning,M,100,0,18,18
2014,Hutton,M,100,0,18,18
2014,Huzaifa,M,100,0,18,18
2014,Idaly,F,100,18,0,18
2014,Imanol,M,100,0,18,18
2014,Io,F,67,12,6,18
2014,Ione,F,100,18,0,18
2014,Isadore,F,50,9,9,18
2014,Isaura,F,100,18,0,18
2014,Isys,F,100,18,0,18
2014,Ivaan,M,100,0,18,18
2014,Izaiyah,M,100,0,18,18
2014,Jabir,M,100,0,18,18
2014,Jacobie,M,100,0,18,18
2014,Jadrian,M,100,0,18,18
2014,Jaecion,M,100,0,18,18
2014,Jaelee,F,100,18,0,18
2014,Jaeleigh,F,100,18,0,18
2014,Jafeth,M,100,0,18,18
2014,Jaionna,F,100,18,0,18
2014,Jaiveer,M,100,0,18,18
2014,Jaiya,F,100,18,0,18
2014,Jaleesa,F,100,18,0,18
2014,Jaleeyah,F,100,18,0,18
2014,Jamaree,M,100,0,18,18
2014,Jamien,M,100,0,18,18
2014,Jamiracle,F,100,18,0,18
2014,Jamyiah,F,100,18,0,18
2014,Jashon,M,100,0,18,18
2014,Jasiri,M,61,7,11,18
2014,Javaughn,M,100,0,18,18
2014,Jayke,M,100,0,18,18
2014,Jaynee,F,100,18,0,18
2014,Jazarah,F,100,18,0,18
2014,Jazzmin,F,100,18,0,18
2014,Jeannie,F,100,18,0,18
2014,Jeanpierre,M,100,0,18,18
2014,Jelissa,F,100,18,0,18
2014,Jeniah,F,100,18,0,18
2014,Jennika,F,100,18,0,18
2014,Jeyren,M,100,0,18,18
2014,Jezabelle,F,100,18,0,18
2014,Jezelle,F,100,18,0,18
2014,Jhamir,M,100,0,18,18
2014,Josiel,M,100,0,18,18
2014,Jostin,M,100,0,18,18
2014,Jozelyn,F,100,18,0,18
2014,Junaid,M,100,0,18,18
2014,Justen,M,100,0,18,18
2014,Kaicen,M,100,0,18,18
2014,Kaige,M,100,0,18,18
2014,Kaija,F,100,18,0,18
2014,Kailei,F,100,18,0,18
2014,Kainalu,M,100,0,18,18
2014,Kaio,M,100,0,18,18
2014,Kairee,F,50,9,9,18
2014,Kallum,M,100,0,18,18
2014,Kally,F,100,18,0,18
2014,Kallyn,F,100,18,0,18
2014,Kalyani,F,100,18,0,18
2014,Kambryn,F,100,18,0,18
2014,Kamirah,F,100,18,0,18
2014,Kamrie,F,100,18,0,18
2014,Kandyce,F,100,18,0,18
2014,Kariana,F,100,18,0,18
2014,Kashtyn,M,72,5,13,18
2014,Kashvi,F,100,18,0,18
2014,Kasidy,F,100,18,0,18
2014,Kathya,F,100,18,0,18
2014,Kattleya,F,100,18,0,18
2014,Kaytlynn,F,100,18,0,18
2014,Kayton,M,56,8,10,18
2014,Keatyn,F,72,13,5,18
2014,Keene,M,100,0,18,18
2014,Keera,F,100,18,0,18
2014,Keighan,M,100,0,18,18
2014,Kelcee,F,100,18,0,18
2014,Kemya,F,100,18,0,18
2014,Kenden,M,100,0,18,18
2014,Kennedee,F,100,18,0,18
2014,Kenner,M,100,0,18,18
2014,Kennith,M,100,0,18,18
2014,Keonna,F,100,18,0,18
2014,Keshon,M,100,0,18,18
2014,Kevan,M,100,0,18,18
2014,Keyaan,M,100,0,18,18
2014,Keyri,F,100,18,0,18
2014,Khaliya,F,100,18,0,18
2014,Khilyn,F,56,10,8,18
2014,Kiylee,F,100,18,0,18
2014,Krimson,F,72,13,5,18
2014,Krissy,F,100,18,0,18
2014,Kross,M,100,0,18,18
2014,Kyndel,F,100,18,0,18
2014,Kyrillos,M,100,0,18,18
2014,Kyro,M,100,0,18,18
2014,Ladd,M,100,0,18,18
2014,Lain,M,100,0,18,18
2014,Lajuan,M,100,0,18,18
2014,Lanayah,F,100,18,0,18
2014,Lashae,F,100,18,0,18
2014,Layanna,F,100,18,0,18
2014,Leanora,F,100,18,0,18
2014,Leelynn,M,72,5,13,18
2014,Leeyah,F,100,18,0,18
2014,Leighana,F,100,18,0,18
2014,Leonid,M,100,0,18,18
2014,Lielle,F,100,18,0,18
2014,Liliane,F,100,18,0,18
2014,Lilo,F,100,18,0,18
2014,Lilyonna,F,100,18,0,18
2014,Linette,F,100,18,0,18
2014,Lion,M,100,0,18,18
2014,Lisseth,F,100,18,0,18
2014,Lupe,F,72,13,5,18
2014,Lyrick,M,72,5,13,18
2014,Mackinzie,F,100,18,0,18
2014,Madalena,F,100,18,0,18
2014,Madhav,M,100,0,18,18
2014,Madi,F,100,18,0,18
2014,Madilyne,F,100,18,0,18
2014,Maiyah,F,100,18,0,18
2014,Makye,M,100,0,18,18
2014,Malasia,F,100,18,0,18
2014,Maliek,M,100,0,18,18
2014,Malory,F,100,18,0,18
2014,Margeaux,F,100,18,0,18
2014,Margret,F,100,18,0,18
2014,Mariangel,F,100,18,0,18
2014,Marquese,M,100,0,18,18
2014,Marshaun,M,100,0,18,18
2014,Marylynn,F,100,18,0,18
2014,Matty,F,67,12,6,18
2014,Maximos,M,100,0,18,18
2014,Mckinnley,F,100,18,0,18
2014,Meghana,F,100,18,0,18
2014,Melayna,F,100,18,0,18
2014,Merary,F,100,18,0,18
2014,Meriam,F,100,18,0,18
2014,Miasia,F,100,18,0,18
2014,Miesha,F,100,18,0,18
2014,Mikhi,M,100,0,18,18
2014,Mikkel,M,100,0,18,18
2014,Minnah,F,100,18,0,18
2014,Miroslav,M,100,0,18,18
2014,Missael,M,100,0,18,18
2014,Mitzi,F,100,18,0,18
2014,Mouhamadou,M,100,0,18,18
2014,Mujtaba,M,100,0,18,18
2014,Mykaela,F,100,18,0,18
2014,Myonna,F,100,18,0,18
2014,Myrical,F,100,18,0,18
2014,Naiara,F,100,18,0,18
2014,Naksh,M,100,0,18,18
2014,Naraly,F,100,18,0,18
2014,Naveed,M,100,0,18,18
2014,Naylea,F,100,18,0,18
2014,Nayleen,F,100,18,0,18
2014,Neithan,M,100,0,18,18
2014,Nero,M,100,0,18,18
2014,Nevaya,F,100,18,0,18
2014,Nickole,F,100,18,0,18
2014,Niharika,F,100,18,0,18
2014,Nimrat,F,100,18,0,18
2014,Nimrit,F,100,18,0,18
2014,Nissi,F,100,18,0,18
2014,Nivaan,M,100,0,18,18
2014,Nolin,M,100,0,18,18
2014,Nyellie,F,100,18,0,18
2014,Oaklen,M,100,0,18,18
2014,Olaoluwa,M,100,0,18,18
2014,Oriah,F,100,18,0,18
2014,Paisly,F,100,18,0,18
2014,Param,M,100,0,18,18
2014,Park,M,100,0,18,18
2014,Peyten,F,100,18,0,18
2014,Pratham,M,100,0,18,18
2014,Pratik,M,100,0,18,18
2014,Prentice,M,100,0,18,18
2014,Presten,M,100,0,18,18
2014,Prestin,M,100,0,18,18
2014,Qais,M,100,0,18,18
2014,Quinnley,F,100,18,0,18
2014,Quynn,F,100,18,0,18
2014,Raylinn,F,100,18,0,18
2014,Raynee,F,100,18,0,18
2014,Rein,F,56,10,8,18
2014,Reyaan,M,100,0,18,18
2014,Riven,F,56,10,8,18
2014,Rmani,F,72,13,5,18
2014,Rollin,M,100,0,18,18
2014,Rosaura,F,100,18,0,18
2014,Russel,M,100,0,18,18
2014,Ryelee,F,67,12,6,18
2014,Saara,F,100,18,0,18
2014,Sameeha,F,100,18,0,18
2014,Samyiah,F,100,18,0,18
2014,Sanad,M,100,0,18,18
2014,Sarabeth,F,100,18,0,18
2014,Sarafina,F,100,18,0,18
2014,Sascha,F,72,13,5,18
2014,Saveah,F,100,18,0,18
2014,Sebastiano,M,100,0,18,18
2014,Seleste,F,100,18,0,18
2014,Semira,F,100,18,0,18
2014,Servando,M,100,0,18,18
2014,Shaela,F,100,18,0,18
2014,Shaheer,M,100,0,18,18
2014,Shailyn,F,100,18,0,18
2014,Shakir,M,100,0,18,18
2014,Shamus,M,100,0,18,18
2014,Shani,F,100,18,0,18
2014,Shaylah,F,100,18,0,18
2014,Shevy,F,100,18,0,18
2014,Shloka,F,100,18,0,18
2014,Shree,F,56,10,8,18
2014,Sivan,F,100,18,0,18
2014,Skylinn,F,100,18,0,18
2014,Sloka,F,100,18,0,18
2014,Sophea,F,100,18,0,18
2014,Srinidhi,F,100,18,0,18
2014,Stevi,F,100,18,0,18
2014,Storie,F,100,18,0,18
2014,Sulayman,M,100,0,18,18
2014,Supreme,M,100,0,18,18
2014,Swayzee,F,100,18,0,18
2014,Syris,M,100,0,18,18
2014,Taevon,M,100,0,18,18
2014,Tage,M,100,0,18,18
2014,Takara,F,100,18,0,18
2014,Tamyra,F,100,18,0,18
2014,Tanay,M,100,0,18,18
2014,Taurean,M,100,0,18,18
2014,Tayte,M,100,0,18,18
2014,Teodoro,M,100,0,18,18
2014,Teryn,F,100,18,0,18
2014,Tessie,F,100,18,0,18
2014,Tevita,M,100,0,18,18
2014,Teyana,F,100,18,0,18
2014,Theoden,M,100,0,18,18
2014,Timia,F,100,18,0,18
2014,Tinslee,F,100,18,0,18
2014,Torren,M,100,0,18,18
2014,Trayden,M,100,0,18,18
2014,Trayson,M,100,0,18,18
2014,Trudy,F,100,18,0,18
2014,Tyliyah,F,100,18,0,18
2014,Varshini,F,100,18,0,18
2014,Vasilisa,F,100,18,0,18
2014,Vincenza,F,100,18,0,18
2014,Vivia,F,100,18,0,18
2014,Wilma,F,100,18,0,18
2014,Wylee,M,100,0,18,18
2014,Xoey,F,100,18,0,18
2014,Yadriel,M,100,0,18,18
2014,Yaiden,M,100,0,18,18
2014,Yamen,M,100,0,18,18
2014,Yanessa,F,100,18,0,18
2014,Yariana,F,100,18,0,18
2014,Yeilin,F,100,18,0,18
2014,Yonis,M,100,0,18,18
2014,Younes,M,100,0,18,18
2014,Younis,M,100,0,18,18
2014,Yousaf,M,100,0,18,18
2014,Zaidee,F,100,18,0,18
2014,Zailee,F,100,18,0,18
2014,Zailynn,F,100,18,0,18
2014,Zairah,F,100,18,0,18
2014,Zamiah,F,100,18,0,18
2014,Zariana,F,100,18,0,18
2014,Zariel,F,100,18,0,18
2014,Zavior,M,100,0,18,18
2014,Zayed,M,100,0,18,18
2014,Zelia,F,100,18,0,18
2014,Zenovia,F,100,18,0,18
2014,Zeriah,F,100,18,0,18
2014,Ziara,F,100,18,0,18
2014,Zixuan,M,56,8,10,18
2014,Zuzu,F,100,18,0,18
2014,Aaliyha,F,100,17,0,17
2014,Aalyah,F,100,17,0,17
2014,Aarini,F,100,17,0,17
2014,Aasha,F,100,17,0,17
2014,Aayushi,F,100,17,0,17
2014,Abijah,M,100,0,17,17
2014,Adabelle,F,100,17,0,17
2014,Adalae,F,100,17,0,17
2014,Adelena,F,100,17,0,17
2014,Adiana,F,100,17,0,17
2014,Adithi,F,100,17,0,17
2014,Adrean,M,100,0,17,17
2014,Adryana,F,100,17,0,17
2014,Afsheen,F,100,17,0,17
2014,Ahan,M,100,0,17,17
2014,Aidynn,M,100,0,17,17
2014,Ailah,F,100,17,0,17
2014,Aizlynn,F,100,17,0,17
2014,Ala,F,100,17,0,17
2014,Aleph,M,100,0,17,17
2014,Alexcia,F,100,17,0,17
2014,Alicianna,F,100,17,0,17
2014,Allura,F,100,17,0,17
2014,Almir,M,100,0,17,17
2014,Alura,F,100,17,0,17
2014,Alva,F,65,11,6,17
2014,Alyviah,F,100,17,0,17
2014,Amay,M,100,0,17,17
2014,Amreen,F,100,17,0,17
2014,Amulya,F,100,17,0,17
2014,Amylia,F,100,17,0,17
2014,Anaid,F,100,17,0,17
2014,Analis,F,100,17,0,17
2014,Anam,F,100,17,0,17
2014,Andrae,M,100,0,17,17
2014,Andrina,F,100,17,0,17
2014,Angelis,F,100,17,0,17
2014,Anjolaoluwa,F,100,17,0,17
2014,Annaleigha,F,100,17,0,17
2014,Antuan,M,100,0,17,17
2014,Aquiles,M,100,0,17,17
2014,Ariyanah,F,100,17,0,17
2014,Arlee,F,100,17,0,17
2014,Arush,M,100,0,17,17
2014,Aryel,F,100,17,0,17
2014,Aslyn,F,100,17,0,17
2014,Atheena,F,100,17,0,17
2014,Aubrionna,F,100,17,0,17
2014,Audric,M,100,0,17,17
2014,Augustina,F,100,17,0,17
2014,Ave,F,100,17,0,17
2014,Aveon,M,100,0,17,17
2014,Awab,M,100,0,17,17
2014,Axell,M,100,0,17,17
2014,Ayanah,F,100,17,0,17
2014,Aynslee,F,100,17,0,17
2014,Ayse,F,100,17,0,17
2014,Azeem,M,100,0,17,17
2014,Azim,M,100,0,17,17
2014,Bana,F,100,17,0,17
2014,Bates,M,100,0,17,17
2014,Bayden,M,100,0,17,17
2014,Beauden,M,100,0,17,17
2014,Behr,M,100,0,17,17
2014,Besan,F,100,17,0,17
2014,Bhavya,F,59,10,7,17
2014,Bleu,M,65,6,11,17
2014,Bohdi,M,100,0,17,17
2014,Bora,M,59,7,10,17
2014,Bowden,M,100,0,17,17
2014,Bowe,M,100,0,17,17
2014,Bracken,M,100,0,17,17
2014,Brae,F,53,9,8,17
2014,Brandie,F,100,17,0,17
2014,Brecklynn,F,100,17,0,17
2014,Breylin,M,71,5,12,17
2014,Breylon,M,100,0,17,17
2014,Breyson,M,100,0,17,17
2014,Brianda,F,100,17,0,17
2014,Briele,F,100,17,0,17
2014,Brielynn,F,100,17,0,17
2014,Brienna,F,100,17,0,17
2014,Brittain,F,71,12,5,17
2014,Brocha,F,100,17,0,17
2014,Brodyn,M,100,0,17,17
2014,Caelin,F,59,10,7,17
2014,Caidan,M,100,0,17,17
2014,Cailen,M,65,6,11,17
2014,Caisyn,F,53,9,8,17
2014,Callia,F,100,17,0,17
2014,Calypso,F,100,17,0,17
2014,Camauri,M,53,8,9,17
2014,Carlitos,M,100,0,17,17
2014,Cashus,M,100,0,17,17
2014,Caspar,M,100,0,17,17
2014,Caven,M,100,0,17,17
2014,Cayli,F,100,17,0,17
2014,Cera,F,100,17,0,17
2014,Charlea,F,100,17,0,17
2014,Chazz,M,100,0,17,17
2014,Chenoa,F,100,17,0,17
2014,Chrishawn,M,100,0,17,17
2014,Christien,M,100,0,17,17
2014,Clarisse,F,100,17,0,17
2014,Connar,M,100,0,17,17
2014,Cornelio,M,100,0,17,17
2014,Corryn,F,100,17,0,17
2014,Coulson,M,100,0,17,17
2014,Cricket,F,100,17,0,17
2014,Cristel,F,100,17,0,17
2014,Dakayla,F,100,17,0,17
2014,Dalexa,F,100,17,0,17
2014,Danisha,F,100,17,0,17
2014,Daphnee,F,100,17,0,17
2014,Dason,M,100,0,17,17
2014,Deandrea,F,65,11,6,17
2014,Deleon,M,100,0,17,17
2014,Demarkus,M,100,0,17,17
2014,Demaryius,M,100,0,17,17
2014,Deontay,M,100,0,17,17
2014,Despina,F,100,17,0,17
2014,Devina,F,100,17,0,17
2014,Deziray,F,100,17,0,17
2014,Dharma,F,100,17,0,17
2014,Dillyn,F,100,17,0,17
2014,Dilyn,F,65,11,6,17
2014,Diva,F,100,17,0,17
2014,Draiden,M,100,0,17,17
2014,Dryden,M,100,0,17,17
2014,Dupree,M,100,0,17,17
2014,Eda,F,100,17,0,17
2014,Edmundo,M,100,0,17,17
2014,Efrata,F,100,17,0,17
2014,Ehren,M,100,0,17,17
2014,Eladio,M,100,0,17,17
2014,Eliani,F,100,17,0,17
2014,Elijha,M,100,0,17,17
2014,Ellarae,F,100,17,0,17
2014,Elloise,F,100,17,0,17
2014,Elsi,F,100,17,0,17
2014,Emarion,M,100,0,17,17
2014,Emya,F,100,17,0,17
2014,Enaya,F,100,17,0,17
2014,Endy,M,71,5,12,17
2014,Eniya,F,100,17,0,17
2014,Esequiel,M,100,0,17,17
2014,Evalynne,F,100,17,0,17
2014,Everhett,M,100,0,17,17
2014,Everitt,M,100,0,17,17
2014,Eziah,M,100,0,17,17
2014,Fabien,M,100,0,17,17
2014,Fable,F,100,17,0,17
2014,Feras,M,100,0,17,17
2014,Finnleigh,F,100,17,0,17
2014,Fitz,M,100,0,17,17
2014,Fradel,F,100,17,0,17
2014,Friedrich,M,100,0,17,17
2014,Frimet,F,100,17,0,17
2014,Gaberiel,M,100,0,17,17
2014,Graceann,F,100,17,0,17
2014,Graceson,M,100,0,17,17
2014,Graden,M,100,0,17,17
2014,Gradyn,M,100,0,17,17
2014,Grason,M,100,0,17,17
2014,Gunther,M,100,0,17,17
2014,Gurfateh,M,100,0,17,17
2014,Haiven,F,100,17,0,17
2014,Hale,M,100,0,17,17
2014,Hammad,M,100,0,17,17
2014,Hannahgrace,F,100,17,0,17
2014,Hannibal,M,100,0,17,17
2014,Haygen,M,100,0,17,17
2014,Hayk,M,100,0,17,17
2014,Helina,F,100,17,0,17
2014,Henrick,M,100,0,17,17
2014,Henrry,M,100,0,17,17
2014,Henson,M,100,0,17,17
2014,Hinata,F,100,17,0,17
2014,Holiday,F,100,17,0,17
2014,Honora,F,100,17,0,17
2014,Honour,F,71,12,5,17
2014,Ifrah,F,100,17,0,17
2014,Ileen,F,100,17,0,17
2014,Indi,F,100,17,0,17
2014,Inna,F,100,17,0,17
2014,Iran,M,71,5,12,17
2014,Iya,F,100,17,0,17
2014,Iyan,M,100,0,17,17
2014,Jaanvi,F,100,17,0,17
2014,Jacek,M,100,0,17,17
2014,Jacque,M,100,0,17,17
2014,Jahvon,M,100,0,17,17
2014,Jaiannah,F,100,17,0,17
2014,Jaimee,F,100,17,0,17
2014,Jaivon,M,100,0,17,17
2014,Jakye,M,100,0,17,17
2014,Jalea,F,100,17,0,17
2014,Jamariah,F,100,17,0,17
2014,Jamarious,M,100,0,17,17
2014,Jamarri,M,100,0,17,17
2014,Jameela,F,100,17,0,17
2014,Jamian,M,100,0,17,17
2014,Jamira,F,100,17,0,17
2014,Janilah,F,100,17,0,17
2014,Jaquavion,M,100,0,17,17
2014,Jarel,M,100,0,17,17
2014,Jasai,M,100,0,17,17
2014,Jasia,F,100,17,0,17
2014,Jayshon,M,100,0,17,17
2014,Jazell,F,100,17,0,17
2014,Jazmynn,F,100,17,0,17
2014,Jeovanni,M,100,0,17,17
2014,Jerell,M,100,0,17,17
2014,Jersie,F,100,17,0,17
2014,Jestin,M,100,0,17,17
2014,Jeyson,M,100,0,17,17
2014,Jhoana,F,100,17,0,17
2014,Jonnie,F,65,11,6,17
2014,Joselyne,F,100,17,0,17
2014,Josi,F,100,17,0,17
2014,Judea,F,65,11,6,17
2014,Julieanne,F,100,17,0,17
2014,Juventino,M,100,0,17,17
2014,Kadiatou,F,100,17,0,17
2014,Kaede,F,100,17,0,17
2014,Kaesyn,M,100,0,17,17
2014,Kagan,M,100,0,17,17
2014,Kailash,M,100,0,17,17
2014,Kaisa,F,100,17,0,17
2014,Kaislee,F,100,17,0,17
2014,Kaithlyn,F,100,17,0,17
2014,Kaleya,F,100,17,0,17
2014,Kalii,F,100,17,0,17
2014,Kallista,F,100,17,0,17
2014,Kamerin,M,65,6,11,17
2014,Kamilo,M,100,0,17,17
2014,Kamorah,F,100,17,0,17
2014,Kamsiyochukwu,M,53,8,9,17
2014,Kamyiah,F,100,17,0,17
2014,Karlei,F,100,17,0,17
2014,Karman,F,100,17,0,17
2014,Karyn,F,100,17,0,17
2014,Kassia,F,100,17,0,17
2014,Kataleah,F,100,17,0,17
2014,Kavish,M,100,0,17,17
2014,Kaysan,M,100,0,17,17
2014,Kayshawn,M,100,0,17,17
2014,Keala,F,100,17,0,17
2014,Keeli,F,100,17,0,17
2014,Kelcey,F,100,17,0,17
2014,Kelci,F,100,17,0,17
2014,Keniya,F,100,17,0,17
2014,Kennon,M,100,0,17,17
2014,Kennya,F,100,17,0,17
2014,Kestrel,F,100,17,0,17
2014,Khalessi,F,100,17,0,17
2014,Kharisma,F,100,17,0,17
2014,Khyleigh,F,100,17,0,17
2014,Khylen,M,100,0,17,17
2014,Kien,M,100,0,17,17
2014,Kolsen,M,100,0,17,17
2014,Kushal,M,100,0,17,17
2014,Kyrielle,F,100,17,0,17
2014,Lahna,F,100,17,0,17
2014,Laiklyn,F,100,17,0,17
2014,Laiyla,F,100,17,0,17
2014,Lama,F,100,17,0,17
2014,Lanya,F,100,17,0,17
2014,Leeanne,F,100,17,0,17
2014,Leightyn,F,100,17,0,17
2014,Leondre,M,100,0,17,17
2014,Leone,M,100,0,17,17
2014,Leonela,F,100,17,0,17
2014,Leul,M,100,0,17,17
2014,Lexani,F,100,17,0,17
2014,Lilibeth,F,100,17,0,17
2014,Lilley,F,100,17,0,17
2014,Lillien,F,100,17,0,17
2014,Lillionna,F,100,17,0,17
2014,Lilou,F,100,17,0,17
2014,Lilyanah,F,100,17,0,17
2014,Lilymae,F,100,17,0,17
2014,Lolita,F,100,17,0,17
2014,Long,M,100,0,17,17
2014,Luan,M,100,0,17,17
2014,Lucciano,M,100,0,17,17
2014,Lucila,F,100,17,0,17
2014,Lundon,F,71,12,5,17
2014,Luzmaria,F,100,17,0,17
2014,Lyfe,M,71,5,12,17
2014,Lynelle,F,100,17,0,17
2014,Maaliyah,F,100,17,0,17
2014,Madox,M,100,0,17,17
2014,Maimouna,F,100,17,0,17
2014,Makaelyn,F,100,17,0,17
2014,Malajah,F,100,17,0,17
2014,Maleeya,F,100,17,0,17
2014,Maleeyah,F,100,17,0,17
2014,Malerie,F,100,17,0,17
2014,Manaal,F,100,17,0,17
2014,Manaia,F,100,17,0,17
2014,Manar,F,100,17,0,17
2014,Maraya,F,100,17,0,17
2014,Martel,M,100,0,17,17
2014,Marwah,F,100,17,0,17
2014,Masin,M,100,0,17,17
2014,Mathayus,M,100,0,17,17
2014,Mattia,M,100,0,17,17
2014,Mayeli,F,100,17,0,17
2014,Mehtab,M,100,0,17,17
2014,Melayah,F,100,17,0,17
2014,Melchizedek,M,100,0,17,17
2014,Merik,M,100,0,17,17
2014,Milka,F,100,17,0,17
2014,Mir,M,100,0,17,17
2014,Murat,M,100,0,17,17
2014,Naava,F,100,17,0,17
2014,Nadav,M,100,0,17,17
2014,Nadeen,F,100,17,0,17
2014,Naiovy,F,100,17,0,17
2014,Nairobi,F,100,17,0,17
2014,Naji,M,100,0,17,17
2014,Nam,M,100,0,17,17
2014,Naman,M,100,0,17,17
2014,Napoleon,M,100,0,17,17
2014,Nataniel,M,100,0,17,17
2014,Nathaneal,M,100,0,17,17
2014,Nature,F,65,11,6,17
2014,Nazar,M,100,0,17,17
2014,Nena,F,100,17,0,17
2014,Nesanel,M,100,0,17,17
2014,Nethra,F,100,17,0,17
2014,Niels,M,100,0,17,17
2014,Nirvan,M,100,0,17,17
2014,Nnamdi,M,100,0,17,17
2014,Noeli,F,100,17,0,17
2014,Novalie,F,100,17,0,17
2014,Novia,F,100,17,0,17
2014,Nusaybah,F,100,17,0,17
2014,Odyn,M,100,0,17,17
2014,Oleg,M,100,0,17,17
2014,Orli,F,100,17,0,17
2014,Orville,M,100,0,17,17
2014,Ozan,M,100,0,17,17
2014,Patsy,F,100,17,0,17
2014,Payslie,F,100,17,0,17
2014,Pharoah,M,100,0,17,17
2014,Phinehas,M,100,0,17,17
2014,Pike,M,100,0,17,17
2014,Poseidon,M,100,0,17,17
2014,Prithvi,M,100,0,17,17
2014,Quan,M,100,0,17,17
2014,Quetzali,F,100,17,0,17
2014,Raed,M,100,0,17,17
2014,Raeley,F,100,17,0,17
2014,Rahmir,M,100,0,17,17
2014,Rainee,F,100,17,0,17
2014,Raiya,F,100,17,0,17
2014,Rance,M,100,0,17,17
2014,Raniah,F,100,17,0,17
2014,Rayhana,F,100,17,0,17
2014,Reagyn,F,100,17,0,17
2014,Reda,M,100,0,17,17
2014,Rehaan,M,100,0,17,17
2014,Renna,F,100,17,0,17
2014,Reno,M,100,0,17,17
2014,Rexford,M,100,0,17,17
2014,Reyden,M,100,0,17,17
2014,Rhylynn,F,100,17,0,17
2014,Rianne,F,100,17,0,17
2014,Rich,M,100,0,17,17
2014,Riyaan,M,100,0,17,17
2014,Roark,M,100,0,17,17
2014,Robynn,F,100,17,0,17
2014,Rommel,M,100,0,17,17
2014,Rosely,F,100,17,0,17
2014,Rourke,M,100,0,17,17
2014,Rowin,M,59,7,10,17
2014,Ruqayyah,F,100,17,0,17
2014,Ryelle,F,100,17,0,17
2014,Sahid,M,100,0,17,17
2014,Saifan,M,100,0,17,17
2014,Saiya,F,100,17,0,17
2014,Samyia,F,100,17,0,17
2014,Sanchez,M,100,0,17,17
2014,Sani,F,100,17,0,17
2014,Sarvesh,M,100,0,17,17
2014,Serenitie,F,100,17,0,17
2014,Shahan,M,100,0,17,17
2014,Shailee,F,100,17,0,17
2014,Shaylen,F,100,17,0,17
2014,Shine,F,53,9,8,17
2014,Shreyansh,M,100,0,17,17
2014,Shylo,F,71,12,5,17
2014,Siani,F,100,17,0,17
2014,Siera,F,100,17,0,17
2014,Skarlette,F,100,17,0,17
2014,Skylynne,F,100,17,0,17
2014,Sona,F,100,17,0,17
2014,Sonnet,F,100,17,0,17
2014,Spring,F,100,17,0,17
2014,Srikar,M,100,0,17,17
2014,Stirling,M,100,0,17,17
2014,Suhas,M,100,0,17,17
2014,Suhaylah,F,100,17,0,17
2014,Suleyman,M,100,0,17,17
2014,Sumaiyah,F,100,17,0,17
2014,Sumayah,F,100,17,0,17
2014,Suzannah,F,100,17,0,17
2014,Suzy,F,100,17,0,17
2014,Svetlana,F,100,17,0,17
2014,Sybella,F,100,17,0,17
2014,Syre,M,100,0,17,17
2014,Syrenity,F,100,17,0,17
2014,Tadhg,M,100,0,17,17
2014,Taina,F,100,17,0,17
2014,Talea,F,100,17,0,17
2014,Tamira,F,100,17,0,17
2014,Teagyn,F,100,17,0,17
2014,Teon,M,100,0,17,17
2014,Terrill,M,100,0,17,17
2014,Texas,M,100,0,17,17
2014,Thania,F,100,17,0,17
2014,Tilley,F,100,17,0,17
2014,Timberly,F,100,17,0,17
2014,Topanga,F,100,17,0,17
2014,Torey,M,100,0,17,17
2014,Townsend,M,100,0,17,17
2014,Tressa,F,100,17,0,17
2014,Tri,M,100,0,17,17
2014,Trulee,F,100,17,0,17
2014,Trust,F,53,9,8,17
2014,Tuleen,F,100,17,0,17
2014,Tyaire,M,71,5,12,17
2014,Tyion,M,100,0,17,17
2014,Tyliah,F,100,17,0,17
2014,Victorious,M,59,7,10,17
2014,Vivi,F,100,17,0,17
2014,Wesly,M,100,0,17,17
2014,Woodson,M,100,0,17,17
2014,Wyett,M,100,0,17,17
2014,Ximenna,F,100,17,0,17
2014,Yahshua,M,100,0,17,17
2014,Yanna,F,100,17,0,17
2014,Yaser,M,100,0,17,17
2014,Yaziel,M,100,0,17,17
2014,Yazlin,F,100,17,0,17
2014,Yehudah,M,100,0,17,17
2014,Yeriel,M,100,0,17,17
2014,Yichen,M,71,5,12,17
2014,Yoandri,M,100,0,17,17
2014,Yoshua,M,100,0,17,17
2014,Yuritzy,F,100,17,0,17
2014,Zackaria,M,100,0,17,17
2014,Zaniel,M,100,0,17,17
2014,Zanyia,F,100,17,0,17
2014,Zarria,F,100,17,0,17
2014,Zaryiah,F,100,17,0,17
2014,Zebediah,M,100,0,17,17
2014,Zenna,F,100,17,0,17
2014,Zephan,M,100,0,17,17
2014,Zhoey,F,100,17,0,17
2014,Zubair,M,100,0,17,17
2014,Zyah,F,100,17,0,17
2014,Aaban,M,100,0,16,16
2014,Aanvi,F,100,16,0,16
2014,Aasim,M,100,0,16,16
2014,Abdifatah,M,100,0,16,16
2014,Abena,F,100,16,0,16
2014,Abigaelle,F,100,16,0,16
2014,Adalaya,F,100,16,0,16
2014,Adeleigh,F,100,16,0,16
2014,Adeleine,F,100,16,0,16
2014,Adlynn,F,100,16,0,16
2014,Adriann,F,50,8,8,16
2014,Adriella,F,100,16,0,16
2014,Aftyn,F,100,16,0,16
2014,Ahmere,M,100,0,16,16
2014,Ahren,M,100,0,16,16
2014,Aiman,M,69,5,11,16
2014,Airyana,F,100,16,0,16
2014,Ajdin,M,100,0,16,16
2014,Ajwa,F,100,16,0,16
2014,Akshita,F,100,16,0,16
2014,Alaijah,F,100,16,0,16
2014,Alajah,F,100,16,0,16
2014,Aleisha,F,100,16,0,16
2014,Alexsa,F,100,16,0,16
2014,Alianah,F,100,16,0,16
2014,Alissandra,F,100,16,0,16
2014,Alleyah,F,100,16,0,16
2014,Alonnah,F,100,16,0,16
2014,Ama,F,100,16,0,16
2014,Amerah,F,100,16,0,16
2014,Amillion,M,56,7,9,16
2014,Amra,F,100,16,0,16
2014,Amrit,M,100,0,16,16
2014,Analina,F,100,16,0,16
2014,Ananda,F,100,16,0,16
2014,Anastyn,F,100,16,0,16
2014,Andreana,F,100,16,0,16
2014,Andru,M,100,0,16,16
2014,Angelle,F,100,16,0,16
2014,Anjelina,F,100,16,0,16
2014,Annalena,F,100,16,0,16
2014,Annalina,F,100,16,0,16
2014,Annebelle,F,100,16,0,16
2014,Anni,F,100,16,0,16
2014,Annica,F,100,16,0,16
2014,Anorah,F,100,16,0,16
2014,Ansen,M,100,0,16,16
2014,Apryl,F,100,16,0,16
2014,Arbor,F,100,16,0,16
2014,Areya,F,100,16,0,16
2014,Ariabella,F,100,16,0,16
2014,Aribelle,F,100,16,0,16
2014,Ariea,F,100,16,0,16
2014,Artez,M,100,0,16,16
2014,Artis,M,100,0,16,16
2014,Artyom,M,100,0,16,16
2014,Ashira,F,100,16,0,16
2014,Ashleen,F,100,16,0,16
2014,Aubryanna,F,100,16,0,16
2014,Audria,F,100,16,0,16
2014,Auguste,M,100,0,16,16
2014,Avalene,F,100,16,0,16
2014,Avana,F,100,16,0,16
2014,Avram,M,100,0,16,16
2014,Avriana,F,100,16,0,16
2014,Awad,M,100,0,16,16
2014,Aybree,F,100,16,0,16
2014,Ayiden,M,100,0,16,16
2014,Ayline,F,100,16,0,16
2014,Bentli,F,56,9,7,16
2014,Bentlie,F,56,9,7,16
2014,Bentzion,M,100,0,16,16
2014,Beretta,F,100,16,0,16
2014,Berl,M,100,0,16,16
2014,Bert,M,100,0,16,16
2014,Bethania,F,100,16,0,16
2014,Bettie,F,100,16,0,16
2014,Betzaida,F,100,16,0,16
2014,Blaklee,F,100,16,0,16
2014,Bluma,F,100,16,0,16
2014,Brayten,M,100,0,16,16
2014,Breckon,M,100,0,16,16
2014,Breelle,F,100,16,0,16
2014,Breindel,F,100,16,0,16
2014,Brek,M,100,0,16,16
2014,Briann,F,100,16,0,16
2014,Brighten,M,69,5,11,16
2014,Brin,F,100,16,0,16
2014,Brittani,F,100,16,0,16
2014,Brockton,M,100,0,16,16
2014,Brynlynn,F,100,16,0,16
2014,Caiya,F,100,16,0,16
2014,Calem,M,100,0,16,16
2014,Camaron,M,100,0,16,16
2014,Cambridge,M,62,6,10,16
2014,Camillia,F,100,16,0,16
2014,Camri,F,100,16,0,16
2014,Canden,M,100,0,16,16
2014,Caoimhe,F,100,16,0,16
2014,Carlina,F,100,16,0,16
2014,Carlotta,F,100,16,0,16
2014,Castle,M,100,0,16,16
2014,Cayley,F,100,16,0,16
2014,Celestino,M,100,0,16,16
2014,Charvi,F,100,16,0,16
2014,Chelsee,F,100,16,0,16
2014,Chyenne,F,100,16,0,16
2014,Cinthya,F,100,16,0,16
2014,Cobe,M,100,0,16,16
2014,Connelly,F,50,8,8,16
2014,Cortana,F,100,16,0,16
2014,Coty,M,100,0,16,16
2014,Cristo,M,100,0,16,16
2014,Cuyler,M,100,0,16,16
2014,Dagan,M,100,0,16,16
2014,Dalaysia,F,100,16,0,16
2014,Daltyn,M,100,0,16,16
2014,Damarrion,M,100,0,16,16
2014,Danasia,F,100,16,0,16
2014,Danay,F,100,16,0,16
2014,Daniell,M,69,5,11,16
2014,Danyka,F,100,16,0,16
2014,Darely,F,100,16,0,16
2014,Darleen,F,100,16,0,16
2014,Daryan,M,100,0,16,16
2014,Dawit,M,100,0,16,16
2014,Dayan,M,100,0,16,16
2014,Dayon,M,100,0,16,16
2014,Daysia,F,100,16,0,16
2014,Deitrick,M,100,0,16,16
2014,Delaynie,F,100,16,0,16
2014,Delon,M,100,0,16,16
2014,Demaya,F,100,16,0,16
2014,Demiya,F,100,16,0,16
2014,Derrian,M,100,0,16,16
2014,Dewey,M,100,0,16,16
2014,Deysi,F,100,16,0,16
2014,Dhiya,F,100,16,0,16
2014,Dijon,M,100,0,16,16
2014,Dilara,F,100,16,0,16
2014,Dmoni,M,100,0,16,16
2014,Dominica,F,100,16,0,16
2014,Dredyn,M,100,0,16,16
2014,Dyllon,M,100,0,16,16
2014,Edlyn,F,100,16,0,16
2014,Eero,M,100,0,16,16
2014,Eidan,M,100,0,16,16
2014,Eilah,F,100,16,0,16
2014,Elika,F,100,16,0,16
2014,Elis,F,62,10,6,16
2014,Ellagrace,F,100,16,0,16
2014,Ellanora,F,100,16,0,16
2014,Ellerie,F,100,16,0,16
2014,Ellise,F,100,16,0,16
2014,Elson,M,100,0,16,16
2014,Elya,M,56,7,9,16
2014,Emad,M,100,0,16,16
2014,Emberli,F,100,16,0,16
2014,Emillia,F,100,16,0,16
2014,Emmalea,F,100,16,0,16
2014,Emmalia,F,100,16,0,16
2014,Emmersen,F,100,16,0,16
2014,Emoree,F,100,16,0,16
2014,England,F,100,16,0,16
2014,Epic,M,69,5,11,16
2014,Erial,F,100,16,0,16
2014,Esmay,F,100,16,0,16
2014,Espn,M,100,0,16,16
2014,Estephany,F,100,16,0,16
2014,Evangelene,F,100,16,0,16
2014,Evaristo,M,100,0,16,16
2014,Eveleen,F,100,16,0,16
2014,Eytan,M,100,0,16,16
2014,Fara,F,100,16,0,16
2014,Farrell,M,69,5,11,16
2014,Fenton,M,100,0,16,16
2014,Finian,M,100,0,16,16
2014,Florian,M,100,0,16,16
2014,Fraida,F,100,16,0,16
2014,Francois,M,100,0,16,16
2014,Franki,F,100,16,0,16
2014,Ganon,M,100,0,16,16
2014,Garth,M,100,0,16,16
2014,Gaston,M,100,0,16,16
2014,Gavriella,F,100,16,0,16
2014,Geremy,M,100,0,16,16
2014,Gerry,M,100,0,16,16
2014,Giovannie,M,100,0,16,16
2014,Gohan,M,100,0,16,16
2014,Greenley,F,100,16,0,16
2014,Haleema,F,100,16,0,16
2014,Haneef,M,100,0,16,16
2014,Hargun,F,100,16,0,16
2014,Hayzen,M,100,0,16,16
2014,Hazelle,F,100,16,0,16
2014,Hieu,M,100,0,16,16
2014,Hodan,F,100,16,0,16
2014,Huntlee,F,69,11,5,16
2014,Huston,M,100,0,16,16
2014,Illianna,F,100,16,0,16
2014,Ilsa,F,100,16,0,16
2014,Ilyssa,F,100,16,0,16
2014,Imara,F,100,16,0,16
2014,Isella,F,100,16,0,16
2014,Island,F,100,16,0,16
2014,Issaiah,M,100,0,16,16
2014,Iszabella,F,100,16,0,16
2014,Itai,M,100,0,16,16
2014,Izayiah,M,100,0,16,16
2014,Jachai,M,100,0,16,16
2014,Jadeyn,F,100,16,0,16
2014,Jaelani,F,100,16,0,16
2014,Jahnae,F,100,16,0,16
2014,Jahniyah,F,100,16,0,16
2014,Jahziah,M,100,0,16,16
2014,Jalah,F,100,16,0,16
2014,Jamario,M,100,0,16,16
2014,Jamee,F,100,16,0,16
2014,Jamesen,M,100,0,16,16
2014,Jami,F,100,16,0,16
2014,Janeli,F,100,16,0,16
2014,Janvi,F,100,16,0,16
2014,Jarah,F,100,16,0,16
2014,Jasin,M,100,0,16,16
2014,Javarius,M,100,0,16,16
2014,Jayd,F,56,9,7,16
2014,Jaymarie,F,100,16,0,16
2014,Jaysa,F,100,16,0,16
2014,Jema,F,100,16,0,16
2014,Jeneva,F,100,16,0,16
2014,Jennessa,F,100,16,0,16
2014,Jeralyn,F,100,16,0,16
2014,Jeremaih,M,100,0,16,16
2014,Jessia,F,100,16,0,16
2014,Jj,M,100,0,16,16
2014,Joakim,M,100,0,16,16
2014,Johnathen,M,100,0,16,16
2014,Joniyah,F,100,16,0,16
2014,Jonnathan,M,100,0,16,16
2014,Joplin,F,100,16,0,16
2014,Jossalyn,F,100,16,0,16
2014,Joury,F,100,16,0,16
2014,Joven,M,100,0,16,16
2014,Juanmanuel,M,100,0,16,16
2014,Julyan,M,100,0,16,16
2014,Juston,M,100,0,16,16
2014,Kacelyn,F,100,16,0,16
2014,Kadija,F,100,16,0,16
2014,Kadir,M,100,0,16,16
2014,Kagen,M,100,0,16,16
2014,Kahmari,M,69,5,11,16
2014,Kaid,M,100,0,16,16
2014,Kaja,F,100,16,0,16
2014,Kalaysia,F,100,16,0,16
2014,Kaled,M,100,0,16,16
2014,Kalman,M,100,0,16,16
2014,Kameran,M,100,0,16,16
2014,Kanani,F,100,16,0,16
2014,Kanen,M,100,0,16,16
2014,Kariah,F,100,16,0,16
2014,Karigan,F,100,16,0,16
2014,Kashus,M,100,0,16,16
2014,Kathalina,F,100,16,0,16
2014,Katriel,F,100,16,0,16
2014,Kayah,F,100,16,0,16
2014,Kayleah,F,100,16,0,16
2014,Kayra,F,100,16,0,16
2014,Kaysie,F,100,16,0,16
2014,Kayven,M,100,0,16,16
2014,Kealani,F,100,16,0,16
2014,Keaston,M,100,0,16,16
2014,Keianna,F,100,16,0,16
2014,Keir,M,100,0,16,16
2014,Kejuan,M,100,0,16,16
2014,Kelden,M,100,0,16,16
2014,Kemauri,M,69,5,11,16
2014,Kemon,M,100,0,16,16
2014,Kena,F,69,11,5,16
2014,Kenda,F,100,16,0,16
2014,Kenedy,F,100,16,0,16
2014,Kento,M,100,0,16,16
2014,Khaidyn,M,100,0,16,16
2014,Khalifa,M,100,0,16,16
2014,Khamryn,F,50,8,8,16
2014,Kharis,F,100,16,0,16
2014,Khia,F,100,16,0,16
2014,Khye,M,100,0,16,16
2014,Khyri,M,100,0,16,16
2014,Kilah,F,100,16,0,16
2014,Kileigh,F,100,16,0,16
2014,Kimberli,F,100,16,0,16
2014,Klyde,M,100,0,16,16
2014,Kodee,F,62,10,6,16
2014,Kollyns,F,100,16,0,16
2014,Konstantina,F,100,16,0,16
2014,Krystel,F,100,16,0,16
2014,Kylia,F,100,16,0,16
2014,Kylyn,F,69,11,5,16
2014,Kymberlee,F,100,16,0,16
2014,Kymoni,M,100,0,16,16
2014,Kyna,F,100,16,0,16
2014,Kynadi,F,100,16,0,16
2014,Kynedi,F,100,16,0,16
2014,Ladarrius,M,100,0,16,16
2014,Lady,F,100,16,0,16
2014,Laksh,M,100,0,16,16
2014,Lanai,F,100,16,0,16
2014,Lashaun,M,100,0,16,16
2014,Laurielle,F,100,16,0,16
2014,Laythan,M,100,0,16,16
2014,Lemar,M,100,0,16,16
2014,Lennex,F,62,10,6,16
2014,Lestat,M,100,0,16,16
2014,Lexia,F,100,16,0,16
2014,Lexii,F,100,16,0,16
2014,Liahm,M,100,0,16,16
2014,Lincy,F,100,16,0,16
2014,Lizmarie,F,100,16,0,16
2014,Lohgan,F,50,8,8,16
2014,Lorianna,F,100,16,0,16
2014,Lunden,M,62,6,10,16
2014,Lylia,F,100,16,0,16
2014,Lyndee,F,100,16,0,16
2014,Maclin,M,100,0,16,16
2014,Maeli,F,100,16,0,16
2014,Magaby,F,100,16,0,16
2014,Maggy,F,100,16,0,16
2014,Maija,F,100,16,0,16
2014,Mailee,F,100,16,0,16
2014,Mairin,F,100,16,0,16
2014,Makaylie,F,100,16,0,16
2014,Makaylynn,F,100,16,0,16
2014,Makenzye,F,100,16,0,16
2014,Makinna,F,100,16,0,16
2014,Makoto,M,100,0,16,16
2014,Maleeah,F,100,16,0,16
2014,Maliq,M,100,0,16,16
2014,Mandela,M,100,0,16,16
2014,Mang,M,69,5,11,16
2014,Manvi,F,100,16,0,16
2014,Marcelle,F,50,8,8,16
2014,Marcoantonio,M,100,0,16,16
2014,Mariaguadalupe,F,100,16,0,16
2014,Marianela,F,100,16,0,16
2014,Mariko,F,100,16,0,16
2014,Marita,F,100,16,0,16
2014,Marlina,F,100,16,0,16
2014,Marsean,M,100,0,16,16
2014,Marysol,F,100,16,0,16
2014,Mataya,F,100,16,0,16
2014,Matei,M,100,0,16,16
2014,Mattingly,F,100,16,0,16
2014,Maylyn,F,100,16,0,16
2014,Maysin,M,69,5,11,16
2014,Mazi,F,62,10,6,16
2014,Megha,F,100,16,0,16
2014,Meiah,F,100,16,0,16
2014,Meika,F,100,16,0,16
2014,Mekhai,M,100,0,16,16
2014,Melaysia,F,100,16,0,16
2014,Melena,F,100,16,0,16
2014,Melyssa,F,100,16,0,16
2014,Merryn,F,100,16,0,16
2014,Mikala,F,100,16,0,16
2014,Milayna,F,100,16,0,16
2014,Mills,M,62,6,10,16
2014,Minha,F,100,16,0,16
2014,Mirko,M,100,0,16,16
2014,Montae,M,100,0,16,16
2014,Morgyn,F,100,16,0,16
2014,Mourad,M,100,0,16,16
2014,Mousa,M,100,0,16,16
2014,Muhammadali,M,100,0,16,16
2014,Muntaha,F,100,16,0,16
2014,Myers,M,69,5,11,16
2014,Nadeem,M,100,0,16,16
2014,Nader,M,100,0,16,16
2014,Nadezhda,F,100,16,0,16
2014,Nainoa,M,100,0,16,16
2014,Natalyah,F,100,16,0,16
2014,Nation,M,100,0,16,16
2014,Naveyah,F,100,16,0,16
2014,Nayden,M,100,0,16,16
2014,Nayel,M,100,0,16,16
2014,Naziah,F,56,9,7,16
2014,Naziyah,F,100,16,0,16
2014,Nekoda,M,100,0,16,16
2014,Nela,F,100,16,0,16
2014,Neyla,F,100,16,0,16
2014,Nickolai,M,100,0,16,16
2014,Niralya,F,100,16,0,16
2014,Nochum,M,100,0,16,16
2014,Noemie,F,100,16,0,16
2014,Nomi,F,100,16,0,16
2014,Novalynn,F,100,16,0,16
2014,Nyaire,M,56,7,9,16
2014,Nyleah,F,100,16,0,16
2014,Nylia,F,100,16,0,16
2014,Ociel,M,100,0,16,16
2014,Oisin,M,100,0,16,16
2014,Oluwatomisin,F,62,10,6,16
2014,Olvin,M,100,0,16,16
2014,Patterson,M,69,5,11,16
2014,Paycen,F,56,9,7,16
2014,Peniel,F,56,9,7,16
2014,Percival,M,100,0,16,16
2014,Peytin,F,100,16,0,16
2014,Pharrah,F,100,16,0,16
2014,Pinchus,M,100,0,16,16
2014,Prajna,F,100,16,0,16
2014,Quinlee,F,100,16,0,16
2014,Quintyn,M,100,0,16,16
2014,Qusai,M,100,0,16,16
2014,Railee,F,100,16,0,16
2014,Rainn,F,50,8,8,16
2014,Raiyan,M,100,0,16,16
2014,Ramel,M,100,0,16,16
2014,Raquelle,F,100,16,0,16
2014,Raziyah,F,100,16,0,16
2014,Redmond,M,100,0,16,16
2014,Reham,F,100,16,0,16
2014,Renaldo,M,100,0,16,16
2014,Retal,F,100,16,0,16
2014,Rheagan,F,100,16,0,16
2014,Rheya,F,100,16,0,16
2014,Roarke,M,100,0,16,16
2014,Rojelio,M,100,0,16,16
2014,Roza,F,100,16,0,16
2014,Ruari,M,69,5,11,16
2014,Ruhan,M,100,0,16,16
2014,Rupert,M,100,0,16,16
2014,Ryliegh,F,100,16,0,16
2014,Sacha,M,56,7,9,16
2014,Sadiq,M,100,0,16,16
2014,Salmaan,M,100,0,16,16
2014,Samer,M,100,0,16,16
2014,Samhita,F,100,16,0,16
2014,Samreen,F,100,16,0,16
2014,Sanay,M,100,0,16,16
2014,Saraiah,F,100,16,0,16
2014,Satya,F,100,16,0,16
2014,Savior,M,100,0,16,16
2014,Sayer,M,100,0,16,16
2014,Sejal,F,100,16,0,16
2014,Senai,M,56,7,9,16
2014,Shanzay,F,100,16,0,16
2014,Shari,F,100,16,0,16
2014,Shaylie,F,100,16,0,16
2014,Shem,M,100,0,16,16
2014,Sherlin,F,100,16,0,16
2014,Shloma,M,100,0,16,16
2014,Sho,M,100,0,16,16
2014,Shooter,M,100,0,16,16
2014,Shyam,M,100,0,16,16
2014,Sian,F,69,11,5,16
2014,Sibyl,F,100,16,0,16
2014,Sigrid,F,100,16,0,16
2014,Sila,F,100,16,0,16
2014,Sirenity,F,100,16,0,16
2014,Sneijder,M,100,0,16,16
2014,Sohum,M,100,0,16,16
2014,Solace,F,56,9,7,16
2014,Solan,M,100,0,16,16
2014,Soma,F,50,8,8,16
2014,Souleymane,M,100,0,16,16
2014,Sriyan,M,100,0,16,16
2014,Staci,F,100,16,0,16
2014,Starling,F,69,11,5,16
2014,Sujey,F,100,16,0,16
2014,Sura,F,100,16,0,16
2014,Sydnei,F,100,16,0,16
2014,Symir,M,100,0,16,16
2014,Taevion,M,100,0,16,16
2014,Tahani,F,100,16,0,16
2014,Taiga,M,100,0,16,16
2014,Talmage,M,100,0,16,16
2014,Tanav,M,100,0,16,16
2014,Tanyla,F,100,16,0,16
2014,Tarah,F,100,16,0,16
2014,Tarell,M,100,0,16,16
2014,Tasha,F,100,16,0,16
2014,Tasia,F,100,16,0,16
2014,Taveon,M,100,0,16,16
2014,Telia,F,100,16,0,16
2014,Teonna,F,100,16,0,16
2014,Teri,F,100,16,0,16
2014,Thanh,M,56,7,9,16
2014,Theodoros,M,100,0,16,16
2014,Thunder,M,100,0,16,16
2014,Tien,M,100,0,16,16
2014,Tino,M,100,0,16,16
2014,Tonantzin,F,100,16,0,16
2014,Tor,M,100,0,16,16
2014,Torben,M,100,0,16,16
2014,Torrian,M,100,0,16,16
2014,Traevon,M,100,0,16,16
2014,Tray,M,100,0,16,16
2014,Trayton,M,100,0,16,16
2014,Trinitie,F,100,16,0,16
2014,Tyeson,M,100,0,16,16
2014,Tymon,M,100,0,16,16
2014,Tyre,M,100,0,16,16
2014,Tyvon,M,100,0,16,16
2014,Vani,F,100,16,0,16
2014,Vedha,F,100,16,0,16
2014,Vela,F,100,16,0,16
2014,Verenice,F,100,16,0,16
2014,Vidya,F,100,16,0,16
2014,Viera,F,100,16,0,16
2014,Vijay,M,100,0,16,16
2014,Vilma,F,100,16,0,16
2014,Vin,M,100,0,16,16
2014,Vishal,M,100,0,16,16
2014,Vishruth,M,100,0,16,16
2014,Whitt,M,100,0,16,16
2014,Winson,M,100,0,16,16
2014,Wisam,M,100,0,16,16
2014,Wyatte,M,100,0,16,16
2014,Xzayvier,M,100,0,16,16
2014,Yanelli,F,100,16,0,16
2014,Yari,F,100,16,0,16
2014,Yarielis,F,100,16,0,16
2014,Yassir,M,100,0,16,16
2014,Yeiden,M,100,0,16,16
2014,Yena,F,100,16,0,16
2014,Yizel,F,100,16,0,16
2014,Yohannes,M,100,0,16,16
2014,Yoni,M,100,0,16,16
2014,Yostin,M,100,0,16,16
2014,Yovany,M,100,0,16,16
2014,Yul,M,100,0,16,16
2014,Yuritza,F,100,16,0,16
2014,Zaide,M,62,6,10,16
2014,Zakariyah,M,100,0,16,16
2014,Zala,F,100,16,0,16
2014,Zaleigh,F,100,16,0,16
2014,Zanyiah,F,100,16,0,16
2014,Zaydee,F,100,16,0,16
2014,Zaydyn,M,100,0,16,16
2014,Zebastian,M,100,0,16,16
2014,Zeek,M,100,0,16,16
2014,Zerenity,F,100,16,0,16
2014,Zimri,M,100,0,16,16
2014,Zo,F,69,11,5,16
2014,Zubayr,M,100,0,16,16
2014,Zuly,F,100,16,0,16
2014,Zyere,M,100,0,16,16
2014,Zyren,M,100,0,16,16
2014,Aamari,M,60,6,9,15
2014,Aanshi,F,100,15,0,15
2014,Aariya,F,100,15,0,15
2014,Abdulla,M,100,0,15,15
2014,Adaleena,F,100,15,0,15
2014,Adamary,F,100,15,0,15
2014,Addilynne,F,100,15,0,15
2014,Addisynn,F,100,15,0,15
2014,Adely,F,100,15,0,15
2014,Adonnis,M,100,0,15,15
2014,Adrianah,F,100,15,0,15
2014,Adrick,M,100,0,15,15
2014,Adrin,M,100,0,15,15
2014,Adriyana,F,100,15,0,15
2014,Aeriana,F,100,15,0,15
2014,Afia,F,100,15,0,15
2014,Agustina,F,100,15,0,15
2014,Ahkeem,M,100,0,15,15
2014,Ahlana,F,100,15,0,15
2014,Ahlayah,F,100,15,0,15
2014,Ahnna,F,100,15,0,15
2014,Ahrianna,F,100,15,0,15
2014,Aibhlinn,F,100,15,0,15
2014,Aina,F,100,15,0,15
2014,Aissata,F,100,15,0,15
2014,Aithan,M,100,0,15,15
2014,Aivah,F,100,15,0,15
2014,Akiyah,F,100,15,0,15
2014,Akshat,M,100,0,15,15
2014,Aleksia,F,100,15,0,15
2014,Alexx,M,67,5,10,15
2014,Alexxis,F,100,15,0,15
2014,Alexya,F,100,15,0,15
2014,Alicja,F,100,15,0,15
2014,Alim,M,100,0,15,15
2014,Allayah,F,100,15,0,15
2014,Alleah,F,100,15,0,15
2014,Almira,F,100,15,0,15
2014,Aloni,F,100,15,0,15
2014,Alp,M,100,0,15,15
2014,Alyra,F,100,15,0,15
2014,Alys,F,100,15,0,15
2014,Amarissa,F,100,15,0,15
2014,Amazing,F,100,15,0,15
2014,Ameila,F,100,15,0,15
2014,Ameriah,F,100,15,0,15
2014,Amilcar,M,100,0,15,15
2014,Amonie,F,100,15,0,15
2014,Amrita,F,100,15,0,15
2014,Anala,F,100,15,0,15
2014,Analaya,F,100,15,0,15
2014,Analayah,F,100,15,0,15
2014,Anant,M,100,0,15,15
2014,Anastasios,M,100,0,15,15
2014,Andreah,F,100,15,0,15
2014,Andree,M,100,0,15,15
2014,Andrews,M,100,0,15,15
2014,Anely,F,100,15,0,15
2014,Anevay,F,100,15,0,15
2014,Angella,F,100,15,0,15
2014,Anjolie,F,100,15,0,15
2014,Annasofia,F,100,15,0,15
2014,Anniah,F,100,15,0,15
2014,Annsleigh,F,100,15,0,15
2014,Anthoni,M,100,0,15,15
2014,Antwuan,M,100,0,15,15
2014,Anuj,M,100,0,15,15
2014,Anzley,F,100,15,0,15
2014,Aphrodite,F,100,15,0,15
2014,Arfa,F,100,15,0,15
2014,Arhum,M,100,0,15,15
2014,Ariauna,F,100,15,0,15
2014,Arihana,F,100,15,0,15
2014,Arika,F,100,15,0,15
2014,Ariv,M,100,0,15,15
2014,Arjay,M,100,0,15,15
2014,Arlington,M,67,5,10,15
2014,Aroush,F,100,15,0,15
2014,Arrayah,F,100,15,0,15
2014,Arshia,F,100,15,0,15
2014,Artur,M,100,0,15,15
2014,Arushi,F,100,15,0,15
2014,Aryianna,F,100,15,0,15
2014,Asenath,F,100,15,0,15
2014,Ashanty,F,100,15,0,15
2014,Ashari,F,100,15,0,15
2014,Ashia,F,100,15,0,15
2014,Ashraf,M,100,0,15,15
2014,Ashtynn,F,100,15,0,15
2014,Asmi,F,100,15,0,15
2014,Athina,F,100,15,0,15
2014,Aubreana,F,100,15,0,15
2014,Audreyanna,F,100,15,0,15
2014,Aunesty,F,100,15,0,15
2014,Auset,F,100,15,0,15
2014,Autymn,F,100,15,0,15
2014,Avacyn,F,100,15,0,15
2014,Avalina,F,100,15,0,15
2014,Avante,M,100,0,15,15
2014,Avantika,F,100,15,0,15
2014,Averyana,F,100,15,0,15
2014,Avina,F,100,15,0,15
2014,Aviona,F,100,15,0,15
2014,Avon,M,100,0,15,15
2014,Avriel,F,60,9,6,15
2014,Avyana,F,100,15,0,15
2014,Axcel,M,100,0,15,15
2014,Ayane,F,100,15,0,15
2014,Aydyn,M,100,0,15,15
2014,Ayisha,F,100,15,0,15
2014,Aymen,M,100,0,15,15
2014,Ayrianna,F,100,15,0,15
2014,Azad,M,100,0,15,15
2014,Azai,M,100,0,15,15
2014,Azayah,F,60,9,6,15
2014,Baby,F,67,10,5,15
2014,Baelyn,F,100,15,0,15
2014,Bailynn,F,100,15,0,15
2014,Bao,M,100,0,15,15
2014,Belicia,F,100,15,0,15
2014,Benita,F,100,15,0,15
2014,Bethenny,F,100,15,0,15
2014,Bina,F,100,15,0,15
2014,Binta,F,100,15,0,15
2014,Blayton,M,100,0,15,15
2014,Bonita,F,100,15,0,15
2014,Braelynne,F,100,15,0,15
2014,Brandin,M,100,0,15,15
2014,Bravery,M,67,5,10,15
2014,Braxon,M,100,0,15,15
2014,Brees,M,100,0,15,15
2014,Brina,F,100,15,0,15
2014,Briyana,F,100,15,0,15
2014,Brucha,F,100,15,0,15
2014,Brylei,F,100,15,0,15
2014,Cabella,F,100,15,0,15
2014,Caelum,M,100,0,15,15
2014,Cally,F,100,15,0,15
2014,Calynn,F,100,15,0,15
2014,Camree,F,100,15,0,15
2014,Camrie,F,100,15,0,15
2014,Caralynn,F,100,15,0,15
2014,Carlson,M,100,0,15,15
2014,Carmelita,F,100,15,0,15
2014,Cassidi,F,100,15,0,15
2014,Cataleyah,F,100,15,0,15
2014,Catie,F,100,15,0,15
2014,Caylynn,F,100,15,0,15
2014,Ceana,F,100,15,0,15
2014,Ceejay,M,100,0,15,15
2014,Celest,F,100,15,0,15
2014,Chaney,F,100,15,0,15
2014,Charlei,F,100,15,0,15
2014,Charliee,F,100,15,0,15
2014,Chasin,M,100,0,15,15
2014,Chaston,M,100,0,15,15
2014,Chesky,M,100,0,15,15
2014,Chetan,M,100,0,15,15
2014,Chief,M,100,0,15,15
2014,Chukwuemeka,M,100,0,15,15
2014,Conlee,F,60,9,6,15
2014,Cordarius,M,100,0,15,15
2014,Coumba,F,100,15,0,15
2014,Cuauhtemoc,M,100,0,15,15
2014,Cyla,F,100,15,0,15
2014,Cyniah,F,100,15,0,15
2014,Cyrine,F,100,15,0,15
2014,Dailey,F,100,15,0,15
2014,Daja,F,100,15,0,15
2014,Dalaney,F,100,15,0,15
2014,Dallon,M,100,0,15,15
2014,Dalvin,M,100,0,15,15
2014,Damario,M,100,0,15,15
2014,Damier,M,100,0,15,15
2014,Damontae,M,100,0,15,15
2014,Damyah,F,100,15,0,15
2014,Danelle,F,100,15,0,15
2014,Dannia,F,100,15,0,15
2014,Dantae,M,100,0,15,15
2014,Darris,M,100,0,15,15
2014,Darshan,M,100,0,15,15
2014,Dashun,M,100,0,15,15
2014,Davante,M,100,0,15,15
2014,Davia,F,100,15,0,15
2014,Davida,F,100,15,0,15
2014,Davit,M,100,0,15,15
2014,Daxtin,M,100,0,15,15
2014,Declynn,F,100,15,0,15
2014,Delaila,F,100,15,0,15
2014,Delayna,F,100,15,0,15
2014,Delores,F,100,15,0,15
2014,Demarko,M,100,0,15,15
2014,Demetrice,M,100,0,15,15
2014,Demontae,M,100,0,15,15
2014,Denilson,M,100,0,15,15
2014,Deniyah,F,100,15,0,15
2014,Deryn,F,67,10,5,15
2014,Dessa,F,100,15,0,15
2014,Destani,F,100,15,0,15
2014,Dezarae,F,100,15,0,15
2014,Dhanvin,M,100,0,15,15
2014,Dima,F,100,15,0,15
2014,Disha,F,100,15,0,15
2014,Dmarcus,M,100,0,15,15
2014,Domanik,M,100,0,15,15
2014,Dominico,M,100,0,15,15
2014,Donovin,M,100,0,15,15
2014,Donya,F,100,15,0,15
2014,Duvid,M,100,0,15,15
2014,Dwain,M,100,0,15,15
2014,Dynasti,F,100,15,0,15
2014,Eagan,M,100,0,15,15
2014,Edel,M,100,0,15,15
2014,Edwardo,M,100,0,15,15
2014,Edythe,F,100,15,0,15
2014,Elihu,M,100,0,15,15
2014,Elinore,F,100,15,0,15
2014,Elisse,F,100,15,0,15
2014,Eliyas,M,100,0,15,15
2014,Elize,F,100,15,0,15
2014,Ellakate,F,100,15,0,15
2014,Ellarie,F,100,15,0,15
2014,Elliannah,F,100,15,0,15
2014,Ellina,F,100,15,0,15
2014,Ellouise,F,100,15,0,15
2014,Elyce,F,100,15,0,15
2014,Elyssia,F,100,15,0,15
2014,Elyzabeth,F,100,15,0,15
2014,Embrie,F,100,15,0,15
2014,Emjay,F,60,9,6,15
2014,Emmalise,F,100,15,0,15
2014,Emmary,F,100,15,0,15
2014,Emmry,F,100,15,0,15
2014,Enid,F,100,15,0,15
2014,Eniola,F,100,15,0,15
2014,Enola,F,100,15,0,15
2014,Evaleigh,F,100,15,0,15
2014,Evangelyn,F,100,15,0,15
2014,Even,M,100,0,15,15
2014,Evlyn,F,100,15,0,15
2014,Evony,F,100,15,0,15
2014,Eymi,F,100,15,0,15
2014,Fadi,M,100,0,15,15
2014,Faheem,M,100,0,15,15
2014,Fareed,M,100,0,15,15
2014,Fatimata,F,100,15,0,15
2014,Feynman,M,100,0,15,15
2014,Fielding,M,100,0,15,15
2014,Fiora,F,100,15,0,15
2014,Flannery,F,100,15,0,15
2014,Galina,F,100,15,0,15
2014,Gates,M,100,0,15,15
2014,Gauri,F,100,15,0,15
2014,Georgio,M,100,0,15,15
2014,Geovanna,F,100,15,0,15
2014,Germain,M,100,0,15,15
2014,Giulietta,F,100,15,0,15
2014,Givanni,M,100,0,15,15
2014,Gorgeous,F,100,15,0,15
2014,Graclyn,F,100,15,0,15
2014,Grantley,M,100,0,15,15
2014,Graziella,F,100,15,0,15
2014,Greggory,M,100,0,15,15
2014,Greydon,M,100,0,15,15
2014,Grover,M,100,0,15,15
2014,Gurman,M,100,0,15,15
2014,Haeden,M,67,5,10,15
2014,Hanzel,M,100,0,15,15
2014,Harlon,M,100,0,15,15
2014,Harriett,F,100,15,0,15
2014,Haseeb,M,100,0,15,15
2014,Hau,F,53,8,7,15
2014,Hawwa,F,100,15,0,15
2014,Hazely,F,100,15,0,15
2014,Hemi,M,53,7,8,15
2014,Hercules,M,100,0,15,15
2014,Hermela,F,100,15,0,15
2014,Holy,F,100,15,0,15
2014,Humaira,F,100,15,0,15
2014,Hyatt,M,100,0,15,15
2014,Hyde,M,100,0,15,15
2014,Idrees,M,100,0,15,15
2014,Idy,F,100,15,0,15
2014,Iliya,M,53,7,8,15
2014,Iliyah,F,100,15,0,15
2014,Irais,F,100,15,0,15
2014,Islam,M,100,0,15,15
2014,Issabelle,F,100,15,0,15
2014,Issiah,M,100,0,15,15
2014,Itza,F,100,15,0,15
2014,Ivori,F,100,15,0,15
2014,Ivorie,F,100,15,0,15
2014,Ivry,F,100,15,0,15
2014,Izzah,F,100,15,0,15
2014,Jaaliyah,F,100,15,0,15
2014,Jacorian,M,100,0,15,15
2014,Jaedan,M,100,0,15,15
2014,Jaevon,M,100,0,15,15
2014,Jaheem,M,100,0,15,15
2014,Jahel,M,100,0,15,15
2014,Jaion,M,100,0,15,15
2014,Jaiveon,M,100,0,15,15
2014,Jakelyn,F,100,15,0,15
2014,Jakia,F,100,15,0,15
2014,Jakya,F,100,15,0,15
2014,Jalal,M,100,0,15,15
2014,Jalan,M,100,0,15,15
2014,Jaleia,F,100,15,0,15
2014,Jalilah,F,100,15,0,15
2014,Janeliz,F,100,15,0,15
2014,Janelys,F,100,15,0,15
2014,Jasher,M,100,0,15,15
2014,Jasim,M,100,0,15,15
2014,Jasion,M,100,0,15,15
2014,Jasline,F,100,15,0,15
2014,Jasson,M,100,0,15,15
2014,Javonta,M,100,0,15,15
2014,Jaylei,F,100,15,0,15
2014,Jayln,M,67,5,10,15
2014,Jaynie,F,100,15,0,15
2014,Jayziah,M,100,0,15,15
2014,Jazalynn,F,100,15,0,15
2014,Jazlyne,F,100,15,0,15
2014,Jazper,M,100,0,15,15
2014,Jcion,M,100,0,15,15
2014,Jeferson,M,100,0,15,15
2014,Jeison,M,100,0,15,15
2014,Jenevie,F,100,15,0,15
2014,Jenisha,F,100,15,0,15
2014,Jeniyah,F,100,15,0,15
2014,Jeramy,M,100,0,15,15
2014,Jeremey,M,100,0,15,15
2014,Jeron,M,100,0,15,15
2014,Jerusalem,F,100,15,0,15
2014,Jerzi,F,100,15,0,15
2014,Jiovanny,M,100,0,15,15
2014,Joceline,F,100,15,0,15
2014,Johnthomas,M,100,0,15,15
2014,Jorian,M,100,0,15,15
2014,Josafat,M,100,0,15,15
2014,Josaiah,M,100,0,15,15
2014,Jourdin,F,60,9,6,15
2014,Jove,M,100,0,15,15
2014,Julen,M,100,0,15,15
2014,Julienne,F,100,15,0,15
2014,Jurney,F,100,15,0,15
2014,Kadarius,M,100,0,15,15
2014,Kaleeah,F,100,15,0,15
2014,Kaliann,F,100,15,0,15
2014,Kalix,M,100,0,15,15
2014,Kana,F,100,15,0,15
2014,Kanton,M,100,0,15,15
2014,Kanyla,F,100,15,0,15
2014,Karena,F,100,15,0,15
2014,Karisa,F,100,15,0,15
2014,Kashawn,M,100,0,15,15
2014,Kashlynn,F,100,15,0,15
2014,Katey,F,100,15,0,15
2014,Katherina,F,100,15,0,15
2014,Kathrynn,F,100,15,0,15
2014,Kayan,M,100,0,15,15
2014,Kaydenn,M,100,0,15,15
2014,Kayin,M,67,5,10,15
2014,Kayler,M,60,6,9,15
2014,Kaylia,F,100,15,0,15
2014,Kaynen,M,100,0,15,15
2014,Kayon,M,100,0,15,15
2014,Kaytie,F,100,15,0,15
2014,Kealan,M,100,0,15,15
2014,Keiana,F,100,15,0,15
2014,Keilana,F,100,15,0,15
2014,Keirsten,F,100,15,0,15
2014,Keithen,M,100,0,15,15
2014,Kelia,F,100,15,0,15
2014,Kelsee,F,100,15,0,15
2014,Kendyn,M,100,0,15,15
2014,Kenlyn,F,100,15,0,15
2014,Kensli,F,100,15,0,15
2014,Keoki,M,100,0,15,15
2014,Keonte,M,100,0,15,15
2014,Keyler,M,100,0,15,15
2014,Keysi,F,100,15,0,15
2014,Khamila,F,100,15,0,15
2014,Khamya,F,100,15,0,15
2014,Khiya,F,100,15,0,15
2014,Khyle,M,53,7,8,15
2014,Kindle,F,100,15,0,15
2014,Koji,M,100,0,15,15
2014,Kolden,M,100,0,15,15
2014,Kord,M,100,0,15,15
2014,Kristoffer,M,100,0,15,15
2014,Kwabena,M,100,0,15,15
2014,Kyasia,F,100,15,0,15
2014,Kynlei,F,100,15,0,15
2014,Laikynn,F,100,15,0,15
2014,Lailee,F,100,15,0,15
2014,Laityn,F,100,15,0,15
2014,Lakendrick,M,100,0,15,15
2014,Lamir,M,100,0,15,15
2014,Latrice,F,100,15,0,15
2014,Lavar,M,100,0,15,15
2014,Lawsen,M,100,0,15,15
2014,Layani,F,100,15,0,15
2014,Leeba,F,100,15,0,15
2014,Leiliana,F,100,15,0,15
2014,Leiloni,F,100,15,0,15
2014,Len,M,100,0,15,15
2014,Lenaya,F,100,15,0,15
2014,Leniyah,F,100,15,0,15
2014,Lennie,M,60,6,9,15
2014,Leoni,F,100,15,0,15
2014,Lexiana,F,100,15,0,15
2014,Leyanna,F,100,15,0,15
2014,Leylanie,F,100,15,0,15
2014,Lianny,F,100,15,0,15
2014,Liban,M,100,0,15,15
2014,Libbie,F,100,15,0,15
2014,Lillah,F,100,15,0,15
2014,Lilleigh,F,100,15,0,15
2014,Lilliah,F,100,15,0,15
2014,Lillymae,F,100,15,0,15
2014,Lilyahna,F,100,15,0,15
2014,Lilybeth,F,100,15,0,15
2014,Linzy,F,100,15,0,15
2014,Lisandra,F,100,15,0,15
2014,Livian,F,100,15,0,15
2014,Lorcan,M,100,0,15,15
2014,Loriana,F,100,15,0,15
2014,Lovella,F,100,15,0,15
2014,Lowen,M,100,0,15,15
2014,Lukus,M,100,0,15,15
2014,Lyah,F,100,15,0,15
2014,Lynae,F,100,15,0,15
2014,Lyndsay,F,100,15,0,15
2014,Lynnette,F,100,15,0,15
2014,Lynnix,F,100,15,0,15
2014,Lyrica,F,100,15,0,15
2014,Madalin,F,100,15,0,15
2014,Madigan,F,100,15,0,15
2014,Mahogani,F,100,15,0,15
2014,Malikye,M,100,0,15,15
2014,Malissa,F,100,15,0,15
2014,Mally,F,100,15,0,15
2014,Marck,M,100,0,15,15
2014,Marianny,F,100,15,0,15
2014,Maricarmen,F,100,15,0,15
2014,Marielys,F,100,15,0,15
2014,Marti,F,100,15,0,15
2014,Matilynn,F,100,15,0,15
2014,Maude,F,100,15,0,15
2014,Mckensie,F,100,15,0,15
2014,Meeya,F,100,15,0,15
2014,Megyn,F,100,15,0,15
2014,Melanee,F,100,15,0,15
2014,Melea,F,100,15,0,15
2014,Menna,F,100,15,0,15
2014,Merle,M,100,0,15,15
2014,Messi,M,100,0,15,15
2014,Meztli,F,100,15,0,15
2014,Michai,M,100,0,15,15
2014,Michaiah,F,100,15,0,15
2014,Mickenzie,F,100,15,0,15
2014,Mikaylee,F,100,15,0,15
2014,Milayah,F,100,15,0,15
2014,Miryam,F,100,15,0,15
2014,Moana,F,100,15,0,15
2014,Modesty,F,100,15,0,15
2014,Mohan,M,100,0,15,15
2014,Moksha,F,100,15,0,15
2014,Monserat,F,100,15,0,15
2014,Moustapha,M,100,0,15,15
2014,Myrna,F,100,15,0,15
2014,Nakari,M,53,7,8,15
2014,Nakiah,F,100,15,0,15
2014,Nakyah,F,100,15,0,15
2014,Nandan,M,100,0,15,15
2014,Natallie,F,100,15,0,15
2014,Navon,M,100,0,15,15
2014,Neda,F,100,15,0,15
2014,Neven,M,100,0,15,15
2014,Nicholi,M,100,0,15,15
2014,Nickoli,M,100,0,15,15
2014,Nishant,M,100,0,15,15
2014,Nita,F,100,15,0,15
2014,Niveah,F,100,15,0,15
2014,Niyanna,F,100,15,0,15
2014,Nolawi,M,100,0,15,15
2014,Norie,F,100,15,0,15
2014,Nox,M,100,0,15,15
2014,Nyzir,M,100,0,15,15
2014,Odalis,F,100,15,0,15
2014,Olliver,M,100,0,15,15
2014,Olson,M,100,0,15,15
2014,Opie,M,100,0,15,15
2014,Ostin,M,100,0,15,15
2014,Oziah,M,100,0,15,15
2014,Perez,M,100,0,15,15
2014,Philemon,M,100,0,15,15
2014,Pieper,F,100,15,0,15
2014,Poet,F,60,9,6,15
2014,Preslynn,F,100,15,0,15
2014,Qadir,M,100,0,15,15
2014,Racquel,F,100,15,0,15
2014,Raeden,M,67,5,10,15
2014,Raffi,M,100,0,15,15
2014,Rally,M,100,0,15,15
2014,Rashaan,M,100,0,15,15
2014,Rashell,F,100,15,0,15
2014,Raychel,F,100,15,0,15
2014,Rayelle,F,100,15,0,15
2014,Rebekka,F,100,15,0,15
2014,Redding,M,100,0,15,15
2014,Refael,M,100,0,15,15
2014,Reily,M,67,5,10,15
2014,Reniya,F,100,15,0,15
2014,Reverie,F,100,15,0,15
2014,Rhyse,M,67,5,10,15
2014,Riccardo,M,100,0,15,15
2014,Rifky,F,100,15,0,15
2014,Rihan,M,53,7,8,15
2014,Ritika,F,100,15,0,15
2014,Robben,M,100,0,15,15
2014,Rosalin,F,100,15,0,15
2014,Roselee,F,100,15,0,15
2014,Roselie,F,100,15,0,15
2014,Roseline,F,100,15,0,15
2014,Roux,F,53,8,7,15
2014,Rozalia,F,100,15,0,15
2014,Ruba,F,100,15,0,15
2014,Runa,F,100,15,0,15
2014,Rushil,M,100,0,15,15
2014,Ryenn,F,100,15,0,15
2014,Rykker,M,100,0,15,15
2014,Ryot,M,100,0,15,15
2014,Sabino,M,100,0,15,15
2014,Sable,F,100,15,0,15
2014,Sabra,F,100,15,0,15
2014,Sabri,M,67,5,10,15
2014,Sadi,F,100,15,0,15
2014,Samaiya,F,100,15,0,15
2014,Samanyu,M,100,0,15,15
2014,Sammantha,F,100,15,0,15
2014,Samyak,M,100,0,15,15
2014,Sanav,M,100,0,15,15
2014,Sarahy,F,100,15,0,15
2014,Sayan,M,100,0,15,15
2014,Sayda,F,100,15,0,15
2014,Schyler,M,60,6,9,15
2014,Seif,M,100,0,15,15
2014,Serge,M,100,0,15,15
2014,Shadrach,M,100,0,15,15
2014,Shaheen,M,100,0,15,15
2014,Shailey,F,100,15,0,15
2014,Shamira,F,100,15,0,15
2014,Shaquan,M,100,0,15,15
2014,Sharlene,F,100,15,0,15
2014,Sharod,M,100,0,15,15
2014,Siddhanth,M,100,0,15,15
2014,Silus,M,100,0,15,15
2014,Silvano,M,100,0,15,15
2014,Sina,F,53,8,7,15
2014,Slayton,M,100,0,15,15
2014,Sofija,F,100,15,0,15
2014,Stavros,M,100,0,15,15
2014,Stoney,M,100,0,15,15
2014,Suhayb,M,100,0,15,15
2014,Suki,F,100,15,0,15
2014,Sumeya,F,100,15,0,15
2014,Sway,F,67,10,5,15
2014,Tahiri,F,100,15,0,15
2014,Takayla,F,100,15,0,15
2014,Taleyah,F,100,15,0,15
2014,Talula,F,100,15,0,15
2014,Tamiah,F,100,15,0,15
2014,Taniah,F,100,15,0,15
2014,Tannen,M,100,0,15,15
2014,Tannon,M,100,0,15,15
2014,Tanveer,M,67,5,10,15
2014,Taren,M,53,7,8,15
2014,Taye,M,100,0,15,15
2014,Taylie,F,100,15,0,15
2014,Taylinn,F,100,15,0,15
2014,Tayvin,M,100,0,15,15
2014,Teresita,F,100,15,0,15
2014,Terrianna,F,100,15,0,15
2014,Thelonious,M,100,0,15,15
2014,Thurston,M,100,0,15,15
2014,Tiarra,F,100,15,0,15
2014,Tiegan,F,100,15,0,15
2014,Tionne,F,100,15,0,15
2014,Toba,F,100,15,0,15
2014,Traven,M,100,0,15,15
2014,Traxton,M,100,0,15,15
2014,Tyleigh,F,100,15,0,15
2014,Tyreke,M,100,0,15,15
2014,Tyton,M,100,0,15,15
2014,Tyus,M,100,0,15,15
2014,Tzirel,F,100,15,0,15
2014,Valeska,F,100,15,0,15
2014,Vaughan,M,100,0,15,15
2014,Vedika,F,100,15,0,15
2014,Vegas,M,53,7,8,15
2014,Vella,F,100,15,0,15
2014,Velvet,F,100,15,0,15
2014,Vickie,F,100,15,0,15
2014,Vuk,M,100,0,15,15
2014,Vung,F,100,15,0,15
2014,Wafa,F,100,15,0,15
2014,Welles,M,100,0,15,15
2014,Whisper,F,100,15,0,15
2014,Whit,M,100,0,15,15
2014,Wilton,M,100,0,15,15
2014,Wissam,M,100,0,15,15
2014,Xylah,F,100,15,0,15
2014,Yani,F,67,10,5,15
2014,Yarianna,F,100,15,0,15
2014,Yaroslav,M,100,0,15,15
2014,Yehia,M,100,0,15,15
2014,Yesica,F,100,15,0,15
2014,Yoan,M,100,0,15,15
2014,Yoanna,F,100,15,0,15
2014,Yochanan,M,100,0,15,15
2014,Yuchen,M,60,6,9,15
2014,Zabdiel,M,100,0,15,15
2014,Zaccai,M,100,0,15,15
2014,Zahria,F,100,15,0,15
2014,Zai,M,100,0,15,15
2014,Zaia,F,100,15,0,15
2014,Zailah,F,100,15,0,15
2014,Zainah,F,100,15,0,15
2014,Zakayla,F,100,15,0,15
2014,Zaley,F,100,15,0,15
2014,Zalman,M,100,0,15,15
2014,Zamzam,F,100,15,0,15
2014,Zana,F,100,15,0,15
2014,Zandra,F,100,15,0,15
2014,Zekiah,M,67,5,10,15
2014,Zenon,M,100,0,15,15
2014,Zeva,F,100,15,0,15
2014,Zhuri,F,100,15,0,15
2014,Ziana,F,100,15,0,15
2014,Zoila,F,100,15,0,15
2014,Zoran,M,100,0,15,15
2014,Zorion,M,100,0,15,15
2014,Zvi,M,100,0,15,15
2014,Zyire,M,100,0,15,15
2014,Aanika,F,100,14,0,14
2014,Aaris,F,50,7,7,14
2014,Abdalrahman,M,100,0,14,14
2014,Abdikadir,M,100,0,14,14
2014,Abdimalik,M,100,0,14,14
2014,Abdulkareem,M,100,0,14,14
2014,Abdurahman,M,100,0,14,14
2014,Abeer,F,100,14,0,14
2014,Aboubacar,M,100,0,14,14
2014,Abrian,M,100,0,14,14
2014,Abygale,F,100,14,0,14
2014,Acie,M,64,5,9,14
2014,Adaora,F,100,14,0,14
2014,Addis,M,57,6,8,14
2014,Adelae,F,100,14,0,14
2014,Adelita,F,100,14,0,14
2014,Adessa,F,100,14,0,14
2014,Adoniah,F,50,7,7,14
2014,Adylin,F,100,14,0,14
2014,Adynn,M,64,5,9,14
2014,Aeliana,F,100,14,0,14
2014,Aeon,M,64,5,9,14
2014,Aerielle,F,100,14,0,14
2014,Afreen,F,100,14,0,14
2014,Agata,F,100,14,0,14
2014,Ahava,F,100,14,0,14
2014,Ahni,F,100,14,0,14
2014,Aimar,M,64,5,9,14
2014,Aissa,F,100,14,0,14
2014,Aizley,F,100,14,0,14
2014,Al,M,100,0,14,14
2014,Alaena,F,100,14,0,14
2014,Aldous,M,100,0,14,14
2014,Aldrin,M,100,0,14,14
2014,Aleighna,F,100,14,0,14
2014,Aleta,F,100,14,0,14
2014,Alexy,F,64,9,5,14
2014,Alima,F,100,14,0,14
2014,Alivya,F,100,14,0,14
2014,Allure,F,100,14,0,14
2014,Alyannah,F,100,14,0,14
2014,Amarionna,F,100,14,0,14
2014,Amatullah,F,100,14,0,14
2014,Amela,F,100,14,0,14
2014,Ameliana,F,100,14,0,14
2014,Amiera,F,100,14,0,14
2014,Ammaar,M,100,0,14,14
2014,Analissa,F,100,14,0,14
2014,Ananiah,F,100,14,0,14
2014,Angelus,M,100,0,14,14
2014,Angelys,F,100,14,0,14
2014,Anias,M,100,0,14,14
2014,Aniket,M,100,0,14,14
2014,Anisah,F,100,14,0,14
2014,Annaka,F,100,14,0,14
2014,Annelie,F,100,14,0,14
2014,Anselmo,M,100,0,14,14
2014,Anshika,F,100,14,0,14
2014,Antonette,F,100,14,0,14
2014,Anum,F,100,14,0,14
2014,Anzlee,F,100,14,0,14
2014,Aoi,F,100,14,0,14
2014,Apollonia,F,100,14,0,14
2014,Aradhana,F,100,14,0,14
2014,Arash,M,100,0,14,14
2014,Arena,F,100,14,0,14
2014,Ariellah,F,100,14,0,14
2014,Ariely,F,100,14,0,14
2014,Arieona,F,100,14,0,14
2014,Arijana,F,100,14,0,14
2014,Ariyel,F,100,14,0,14
2014,Arnez,M,100,0,14,14
2014,Arrabella,F,100,14,0,14
2014,Arsalan,M,100,0,14,14
2014,Arynn,F,100,14,0,14
2014,Ashwath,M,100,0,14,14
2014,Astoria,F,100,14,0,14
2014,Athziry,F,100,14,0,14
2014,Atif,M,100,0,14,14
2014,Aurelie,F,100,14,0,14
2014,Averianna,F,100,14,0,14
2014,Aviela,F,100,14,0,14
2014,Avyay,M,100,0,14,14
2014,Aws,M,100,0,14,14
2014,Axelle,F,100,14,0,14
2014,Ayari,F,100,14,0,14
2014,Aydrien,M,100,0,14,14
2014,Ayeden,M,100,0,14,14
2014,Aylinn,F,100,14,0,14
2014,Azaylea,F,100,14,0,14
2014,Azion,M,57,6,8,14
2014,Azzam,M,100,0,14,14
2014,Baden,M,100,0,14,14
2014,Bawi,M,100,0,14,14
2014,Baylei,F,100,14,0,14
2014,Baylynn,F,100,14,0,14
2014,Bellagrace,F,100,14,0,14
2014,Bellamia,F,100,14,0,14
2014,Beryl,F,100,14,0,14
2014,Betania,F,100,14,0,14
2014,Blayklee,F,100,14,0,14
2014,Bohdan,M,100,0,14,14
2014,Bradey,M,100,0,14,14
2014,Brahm,M,100,0,14,14
2014,Braxden,M,100,0,14,14
2014,Brayley,F,100,14,0,14
2014,Brayon,M,100,0,14,14
2014,Breeann,F,100,14,0,14
2014,Brennah,F,100,14,0,14
2014,Breyer,F,50,7,7,14
2014,Bridgit,F,100,14,0,14
2014,Brigg,M,100,0,14,14
2014,Bristen,M,64,5,9,14
2014,Britten,M,64,5,9,14
2014,Brixon,M,100,0,14,14
2014,Cadan,M,100,0,14,14
2014,Cadynce,F,100,14,0,14
2014,Caila,F,100,14,0,14
2014,Calaya,F,100,14,0,14
2014,Calvary,F,64,9,5,14
2014,Candon,M,100,0,14,14
2014,Cayde,M,100,0,14,14
2014,Caydee,F,100,14,0,14
2014,Cebastian,M,100,0,14,14
2014,Chancey,F,57,8,6,14
2014,Charlye,F,100,14,0,14
2014,Chaseton,M,100,0,14,14
2014,Chessa,F,100,14,0,14
2014,Chevie,F,64,9,5,14
2014,Chidinma,F,100,14,0,14
2014,Chikamso,F,64,9,5,14
2014,Christi,F,100,14,0,14
2014,Christoffer,M,100,0,14,14
2014,Chyann,F,100,14,0,14
2014,Cinch,M,100,0,14,14
2014,Clea,F,100,14,0,14
2014,Clementina,F,100,14,0,14
2014,Conlin,M,100,0,14,14
2014,Cormick,M,100,0,14,14
2014,Corrin,F,100,14,0,14
2014,Coryn,F,100,14,0,14
2014,Cosmo,M,100,0,14,14
2014,Cyrene,F,100,14,0,14
2014,Dadrian,M,100,0,14,14
2014,Dain,M,100,0,14,14
2014,Daizee,F,100,14,0,14
2014,Daken,M,100,0,14,14
2014,Dakodah,M,64,5,9,14
2014,Dalaya,F,100,14,0,14
2014,Dallan,M,100,0,14,14
2014,Dally,F,100,14,0,14
2014,Dalon,M,100,0,14,14
2014,Damarco,M,100,0,14,14
2014,Damere,M,100,0,14,14
2014,Damone,M,100,0,14,14
2014,Danelly,F,100,14,0,14
2014,Davaughn,M,100,0,14,14
2014,Daveion,M,100,0,14,14
2014,Dayleen,F,100,14,0,14
2014,Daylyn,M,57,6,8,14
2014,Daytona,F,64,9,5,14
2014,Daziyah,F,100,14,0,14
2014,Declin,M,100,0,14,14
2014,Dedric,M,100,0,14,14
2014,Delayla,F,100,14,0,14
2014,Demetre,M,100,0,14,14
2014,Demetric,M,100,0,14,14
2014,Derrius,M,100,0,14,14
2014,Detrick,M,100,0,14,14
2014,Devi,F,100,14,0,14
2014,Deyanna,F,100,14,0,14
2014,Dhalia,F,100,14,0,14
2014,Dhanvi,F,100,14,0,14
2014,Dhanya,F,100,14,0,14
2014,Dhruvi,F,100,14,0,14
2014,Dinero,M,100,0,14,14
2014,Dionisio,M,100,0,14,14
2014,Dodger,M,100,0,14,14
2014,Dominque,M,100,0,14,14
2014,Dondre,M,100,0,14,14
2014,Dorion,M,100,0,14,14
2014,Dorrian,M,100,0,14,14
2014,Dovber,M,100,0,14,14
2014,Drayven,M,100,0,14,14
2014,Dreama,F,100,14,0,14
2014,Drishti,F,100,14,0,14
2014,Duchess,F,100,14,0,14
2014,Efe,M,100,0,14,14
2014,Elah,F,100,14,0,14
2014,Elaya,F,100,14,0,14
2014,Elbert,M,100,0,14,14
2014,Eleah,F,100,14,0,14
2014,Elexia,F,100,14,0,14
2014,Eliane,F,100,14,0,14
2014,Elier,M,100,0,14,14
2014,Eliyanah,F,100,14,0,14
2014,Elke,F,100,14,0,14
2014,Ellary,F,100,14,0,14
2014,Ellias,M,100,0,14,14
2014,Elliyah,F,100,14,0,14
2014,Elnora,F,100,14,0,14
2014,Elody,F,100,14,0,14
2014,Elysse,F,100,14,0,14
2014,Emalia,F,100,14,0,14
2014,Emary,F,100,14,0,14
2014,Emeree,F,100,14,0,14
2014,Emett,M,100,0,14,14
2014,Emilea,F,100,14,0,14
2014,Emmerich,M,100,0,14,14
2014,Epiphany,F,100,14,0,14
2014,Eriberto,M,100,0,14,14
2014,Eriyana,F,100,14,0,14
2014,Eriyanna,F,100,14,0,14
2014,Evalise,F,100,14,0,14
2014,Everton,M,100,0,14,14
2014,Evia,F,100,14,0,14
2014,Evita,F,100,14,0,14
2014,Evolett,F,100,14,0,14
2014,Evonne,F,100,14,0,14
2014,Fadumo,F,100,14,0,14
2014,Fahima,F,100,14,0,14
2014,Farryn,F,100,14,0,14
2014,Fartun,F,100,14,0,14
2014,Flavia,F,100,14,0,14
2014,Frederik,M,100,0,14,14
2014,Fredi,M,100,0,14,14
2014,Froylan,M,100,0,14,14
2014,Gannen,M,100,0,14,14
2014,Garin,M,100,0,14,14
2014,Genna,F,100,14,0,14
2014,Germaine,M,100,0,14,14
2014,Ghassan,M,100,0,14,14
2014,Gracynn,F,100,14,0,14
2014,Graesyn,M,64,5,9,14
2014,Gram,M,100,0,14,14
2014,Gregg,M,100,0,14,14
2014,Gulianna,F,100,14,0,14
2014,Gwynevere,F,100,14,0,14
2014,Hadli,F,100,14,0,14
2014,Hamdan,M,100,0,14,14
2014,Hannia,F,100,14,0,14
2014,Harvest,F,64,9,5,14
2014,Haset,F,100,14,0,14
2014,Hasset,F,100,14,0,14
2014,Havannah,F,100,14,0,14
2014,Havish,M,100,0,14,14
2014,Hebe,F,100,14,0,14
2014,Herschel,M,100,0,14,14
2014,Hiliana,F,100,14,0,14
2014,Hiya,F,100,14,0,14
2014,Holten,M,100,0,14,14
2014,Huntyr,M,57,6,8,14
2014,Hutchinson,M,100,0,14,14
2014,Imane,F,100,14,0,14
2014,Irianna,F,100,14,0,14
2014,Isidore,M,100,0,14,14
2014,Itzia,F,100,14,0,14
2014,Jabria,F,100,14,0,14
2014,Jacarri,M,100,0,14,14
2014,Jacquez,M,100,0,14,14
2014,Jadaveon,M,100,0,14,14
2014,Jadin,M,100,0,14,14
2014,Jahmier,M,100,0,14,14
2014,Jaiana,F,100,14,0,14
2014,Jaiel,M,57,6,8,14
2014,Jakel,M,100,0,14,14
2014,Jakhai,M,100,0,14,14
2014,Jalayla,F,100,14,0,14
2014,Jaley,F,100,14,0,14
2014,Jalicia,F,100,14,0,14
2014,Jamarrion,M,100,0,14,14
2014,Jamea,F,100,14,0,14
2014,Jamiere,M,100,0,14,14
2014,Janita,F,100,14,0,14
2014,Jannelle,F,100,14,0,14
2014,Jashan,M,100,0,14,14
2014,Jasiya,F,100,14,0,14
2014,Jasneet,F,100,14,0,14
2014,Javonni,M,100,0,14,14
2014,Jaxi,F,100,14,0,14
2014,Jaxsun,M,100,0,14,14
2014,Jaxxen,M,100,0,14,14
2014,Jayan,M,100,0,14,14
2014,Jaydrian,M,100,0,14,14
2014,Jayleene,F,100,14,0,14
2014,Jayliani,F,100,14,0,14
2014,Jaymi,F,100,14,0,14
2014,Jazalyn,F,100,14,0,14
2014,Jazion,M,100,0,14,14
2014,Jazzalyn,F,100,14,0,14
2014,Jazzmyne,F,100,14,0,14
2014,Jeanie,F,100,14,0,14
2014,Jeilani,F,100,14,0,14
2014,Jennavecia,F,100,14,0,14
2014,Jerard,M,100,0,14,14
2014,Jerico,M,100,0,14,14
2014,Jeriyah,F,100,14,0,14
2014,Jesaiah,M,100,0,14,14
2014,Jesica,F,100,14,0,14
2014,Jessilyn,F,100,14,0,14
2014,Jetta,F,100,14,0,14
2014,Jiah,F,100,14,0,14
2014,Johnatan,M,100,0,14,14
2014,Joline,F,100,14,0,14
2014,Jonan,M,100,0,14,14
2014,Jorie,F,100,14,0,14
2014,Josseline,F,100,14,0,14
2014,Jream,F,100,14,0,14
2014,Juanantonio,M,100,0,14,14
2014,Juhi,F,100,14,0,14
2014,Juliza,F,100,14,0,14
2014,Jurni,F,100,14,0,14
2014,Jurnie,F,100,14,0,14
2014,Kadan,M,100,0,14,14
2014,Kaegan,M,64,5,9,14
2014,Kaelen,M,100,0,14,14
2014,Kahli,F,100,14,0,14
2014,Kahliyah,F,100,14,0,14
2014,Kaida,F,100,14,0,14
2014,Kailana,F,100,14,0,14
2014,Kairyn,M,100,0,14,14
2014,Kaiyden,M,100,0,14,14
2014,Kala,F,100,14,0,14
2014,Kalisi,F,100,14,0,14
2014,Kamaree,F,64,9,5,14
2014,Kamillah,F,100,14,0,14
2014,Kamree,F,100,14,0,14
2014,Karianna,F,100,14,0,14
2014,Karlina,F,100,14,0,14
2014,Karolynn,F,100,14,0,14
2014,Karrah,F,100,14,0,14
2014,Kassadee,F,100,14,0,14
2014,Kassidie,F,100,14,0,14
2014,Kastiel,M,100,0,14,14
2014,Kathryne,F,100,14,0,14
2014,Katlin,F,100,14,0,14
2014,Keahi,M,100,0,14,14
2014,Keani,F,50,7,7,14
2014,Kedrick,M,100,0,14,14
2014,Keela,F,100,14,0,14
2014,Keilen,M,100,0,14,14
2014,Keiley,F,100,14,0,14
2014,Keiona,F,100,14,0,14
2014,Kelechi,M,100,0,14,14
2014,Kemiya,F,100,14,0,14
2014,Kendale,M,100,0,14,14
2014,Kenechukwu,M,100,0,14,14
2014,Kenisha,F,100,14,0,14
2014,Kennard,M,100,0,14,14
2014,Keo,M,100,0,14,14
2014,Keron,M,100,0,14,14
2014,Kerra,F,100,14,0,14
2014,Kesler,M,100,0,14,14
2014,Kessa,F,100,14,0,14
2014,Keymani,F,57,8,6,14
2014,Keyondre,M,100,0,14,14
2014,Keysha,F,100,14,0,14
2014,Keyvon,M,100,0,14,14
2014,Khaiden,M,100,0,14,14
2014,Khaleel,M,100,0,14,14
2014,Khalel,M,100,0,14,14
2014,Khalilah,F,100,14,0,14
2014,Khizar,M,100,0,14,14
2014,Khloi,F,100,14,0,14
2014,Khodi,F,57,8,6,14
2014,Khylei,F,100,14,0,14
2014,Kiaya,F,100,14,0,14
2014,Kieron,M,100,0,14,14
2014,Kiko,M,64,5,9,14
2014,Kilyn,F,64,9,5,14
2014,Kimmy,F,100,14,0,14
2014,Kimyah,F,100,14,0,14
2014,Kinan,M,100,0,14,14
2014,Kinda,F,100,14,0,14
2014,Kinza,F,100,14,0,14
2014,Kiril,M,100,0,14,14
2014,Kishan,M,100,0,14,14
2014,Kitty,F,100,14,0,14
2014,Klea,F,100,14,0,14
2014,Kobyn,M,100,0,14,14
2014,Koleson,M,100,0,14,14
2014,Kolette,F,100,14,0,14
2014,Koltan,M,100,0,14,14
2014,Korinne,F,100,14,0,14
2014,Korri,F,100,14,0,14
2014,Kortlyn,F,100,14,0,14
2014,Kylene,F,100,14,0,14
2014,Kymberly,F,100,14,0,14
2014,Kynsli,F,100,14,0,14
2014,Kyria,F,100,14,0,14
2014,Lafayette,M,100,0,14,14
2014,Lailyn,F,100,14,0,14
2014,Lakenzie,F,100,14,0,14
2014,Lamyah,F,100,14,0,14
2014,Lamyia,F,100,14,0,14
2014,Lariya,F,100,14,0,14
2014,Lavaeh,F,100,14,0,14
2014,Lawren,F,100,14,0,14
2014,Layni,F,100,14,0,14
2014,Lazaria,F,100,14,0,14
2014,Leahna,F,100,14,0,14
2014,Leibish,M,100,0,14,14
2014,Leiya,F,100,14,0,14
2014,Leliana,F,100,14,0,14
2014,Lenah,F,100,14,0,14
2014,Lenard,M,100,0,14,14
2014,Leron,M,100,0,14,14
2014,Leyana,F,100,14,0,14
2014,Light,M,57,6,8,14
2014,Lijah,M,100,0,14,14
2014,Lilyian,F,100,14,0,14
2014,Lilyona,F,100,14,0,14
2014,Lindyn,F,100,14,0,14
2014,Linkon,M,100,0,14,14
2014,Lolah,F,100,14,0,14
2014,Londan,F,100,14,0,14
2014,Loralai,F,100,14,0,14
2014,Loralye,F,100,14,0,14
2014,Lorenz,M,100,0,14,14
2014,Louden,M,100,0,14,14
2014,Lucrezia,F,100,14,0,14
2014,Lunabelle,F,100,14,0,14
2014,Lydon,M,100,0,14,14
2014,Maalik,M,100,0,14,14
2014,Macallister,M,100,0,14,14
2014,Macarthur,M,100,0,14,14
2014,Madylin,F,100,14,0,14
2014,Majed,M,100,0,14,14
2014,Makaylyn,F,100,14,0,14
2014,Makynzee,F,100,14,0,14
2014,Malaia,F,100,14,0,14
2014,Malayasia,F,100,14,0,14
2014,Malayiah,F,100,14,0,14
2014,Malley,F,100,14,0,14
2014,Maniya,F,100,14,0,14
2014,Marchello,M,100,0,14,14
2014,Marieli,F,100,14,0,14
2014,Mariem,F,100,14,0,14
2014,Marilee,F,100,14,0,14
2014,Markeese,M,100,0,14,14
2014,Markie,F,57,8,6,14
2014,Marque,M,100,0,14,14
2014,Marvella,F,100,14,0,14
2014,Marybella,F,100,14,0,14
2014,Marycatherine,F,100,14,0,14
2014,Maryrose,F,100,14,0,14
2014,Mattalyn,F,100,14,0,14
2014,Matthan,M,100,0,14,14
2014,Maui,F,57,8,6,14
2014,Mavryk,M,100,0,14,14
2014,Maxxwell,M,100,0,14,14
2014,Maytte,F,100,14,0,14
2014,Meg,F,100,14,0,14
2014,Meilah,F,100,14,0,14
2014,Memorie,F,100,14,0,14
2014,Memory,F,100,14,0,14
2014,Menaal,F,100,14,0,14
2014,Merlyn,F,64,9,5,14
2014,Merrill,F,50,7,7,14
2014,Meta,F,100,14,0,14
2014,Miciah,M,57,6,8,14
2014,Mikale,M,64,5,9,14
2014,Mikiyah,F,100,14,0,14
2014,Milee,F,100,14,0,14
2014,Millee,F,100,14,0,14
2014,Mio,F,100,14,0,14
2014,Miraj,M,64,5,9,14
2014,Miro,M,100,0,14,14
2014,Miyonna,F,100,14,0,14
2014,Mizael,M,100,0,14,14
2014,Mohamedamin,M,100,0,14,14
2014,Mohamud,M,100,0,14,14
2014,Mohit,M,100,0,14,14
2014,Mohsin,M,100,0,14,14
2014,Monzerrath,F,100,14,0,14
2014,Moosa,M,100,0,14,14
2014,Mora,F,100,14,0,14
2014,Mukund,M,100,0,14,14
2014,Munachiso,F,64,9,5,14
2014,Mustapha,M,100,0,14,14
2014,Mylani,F,100,14,0,14
2014,Mylin,F,64,9,5,14
2014,Mynor,M,100,0,14,14
2014,Naba,F,100,14,0,14
2014,Nadim,M,100,0,14,14
2014,Nadira,F,100,14,0,14
2014,Naheem,M,100,0,14,14
2014,Nalaysia,F,100,14,0,14
2014,Nashawn,M,100,0,14,14
2014,Nashton,M,100,0,14,14
2014,Natalija,F,100,14,0,14
2014,Nathyn,M,100,0,14,14
2014,Natividad,M,64,5,9,14
2014,Navie,F,100,14,0,14
2014,Navraj,M,100,0,14,14
2014,Naziya,F,100,14,0,14
2014,Nelia,F,100,14,0,14
2014,Nerissa,F,100,14,0,14
2014,Nettie,F,100,14,0,14
2014,Neviah,F,100,14,0,14
2014,Niasia,F,100,14,0,14
2014,Nichelle,F,100,14,0,14
2014,Nishan,M,100,0,14,14
2014,Nixie,F,100,14,0,14
2014,Nohlan,M,100,0,14,14
2014,Nysa,F,100,14,0,14
2014,Nyx,F,100,14,0,14
2014,Nyzaiah,M,100,0,14,14
2014,Obinna,M,100,0,14,14
2014,Oliviagrace,F,100,14,0,14
2014,Olivianna,F,100,14,0,14
2014,Omir,M,100,0,14,14
2014,Oriel,M,57,6,8,14
2014,Ovadia,M,100,0,14,14
2014,Padme,F,100,14,0,14
2014,Paighton,F,100,14,0,14
2014,Paislea,F,100,14,0,14
2014,Pema,F,100,14,0,14
2014,Pemberley,F,100,14,0,14
2014,Philipp,M,100,0,14,14
2014,Porsha,F,100,14,0,14
2014,Preet,F,57,8,6,14
2014,Prem,M,100,0,14,14
2014,Pryor,M,100,0,14,14
2014,Quinlyn,F,100,14,0,14
2014,Radek,M,100,0,14,14
2014,Rael,M,57,6,8,14
2014,Raigen,F,100,14,0,14
2014,Rainah,F,100,14,0,14
2014,Rajan,M,100,0,14,14
2014,Rakeb,F,100,14,0,14
2014,Rasul,M,100,0,14,14
2014,Rateel,F,100,14,0,14
2014,Raydel,M,100,0,14,14
2014,Raydon,M,100,0,14,14
2014,Raynard,M,100,0,14,14
2014,Rayner,M,100,0,14,14
2014,Rease,F,57,8,6,14
2014,Redford,M,100,0,14,14
2014,Rei,M,64,5,9,14
2014,Reighlyn,F,100,14,0,14
2014,Reiner,M,100,0,14,14
2014,Renard,M,100,0,14,14
2014,Renny,F,50,7,7,14
2014,Reuel,M,100,0,14,14
2014,Reymond,M,100,0,14,14
2014,Rhya,F,100,14,0,14
2014,Rhyland,M,100,0,14,14
2014,Riah,F,100,14,0,14
2014,Riata,F,100,14,0,14
2014,Ridhima,F,100,14,0,14
2014,Riki,F,100,14,0,14
2014,Rithika,F,100,14,0,14
2014,Rivaan,M,100,0,14,14
2014,Rob,M,100,0,14,14
2014,Rodina,F,100,14,0,14
2014,Rohaan,M,100,0,14,14
2014,Rolland,M,100,0,14,14
2014,Romie,F,100,14,0,14
2014,Ronell,M,100,0,14,14
2014,Ronnell,M,100,0,14,14
2014,Rosey,F,100,14,0,14
2014,Rowena,F,100,14,0,14
2014,Roxi,F,100,14,0,14
2014,Rozalynn,F,100,14,0,14
2014,Ruchama,F,100,14,0,14
2014,Ruchel,F,100,14,0,14
2014,Rudransh,M,100,0,14,14
2014,Rydge,M,100,0,14,14
2014,Rynlee,F,100,14,0,14
2014,Sabria,F,100,14,0,14
2014,Sadiya,F,100,14,0,14
2014,Safina,F,100,14,0,14
2014,Saida,F,100,14,0,14
2014,Saleah,F,100,14,0,14
2014,Saleena,F,100,14,0,14
2014,Samera,F,100,14,0,14
2014,Samora,F,100,14,0,14
2014,Sarkis,M,100,0,14,14
2014,Sarthak,M,100,0,14,14
2014,Sativa,F,100,14,0,14
2014,Savier,M,100,0,14,14
2014,Seger,M,100,0,14,14
2014,Serafin,M,100,0,14,14
2014,Sergey,M,100,0,14,14
2014,Shailynn,F,100,14,0,14
2014,Shaira,F,100,14,0,14
2014,Shalaya,F,100,14,0,14
2014,Sham,F,100,14,0,14
2014,Shan,M,100,0,14,14
2014,Shaniece,F,100,14,0,14
2014,Shaunak,M,100,0,14,14
2014,Sherly,F,100,14,0,14
2014,Shi,F,64,9,5,14
2014,Shifa,F,100,14,0,14
2014,Shilah,F,100,14,0,14
2014,Shloime,M,100,0,14,14
2014,Shravan,M,100,0,14,14
2014,Simar,F,100,14,0,14
2014,Simi,F,100,14,0,14
2014,Siona,F,100,14,0,14
2014,Sixto,M,100,0,14,14
2014,Smriti,F,100,14,0,14
2014,Somtochukwu,M,64,5,9,14
2014,Soniya,F,100,14,0,14
2014,Sophiagrace,F,100,14,0,14
2014,Sophiamarie,F,100,14,0,14
2014,Sreshta,F,100,14,0,14
2014,Stanislav,M,100,0,14,14
2014,Stepan,M,100,0,14,14
2014,Subhaan,M,100,0,14,14
2014,Sue,F,100,14,0,14
2014,Sufiyan,M,100,0,14,14
2014,Suriya,F,100,14,0,14
2014,Syanna,F,100,14,0,14
2014,Syra,F,100,14,0,14
2014,Taft,M,100,0,14,14
2014,Taheem,M,100,0,14,14
2014,Taher,M,100,0,14,14
2014,Tahmid,M,100,0,14,14
2014,Tait,M,100,0,14,14
2014,Takari,F,50,7,7,14
2014,Takumi,M,100,0,14,14
2014,Takyra,F,100,14,0,14
2014,Tamer,M,100,0,14,14
2014,Tamra,F,100,14,0,14
2014,Tamyah,F,100,14,0,14
2014,Tanasia,F,100,14,0,14
2014,Tanna,F,100,14,0,14
2014,Temperence,F,100,14,0,14
2014,Terah,F,100,14,0,14
2014,Terrian,M,100,0,14,14
2014,Terriana,F,100,14,0,14
2014,Terrick,M,100,0,14,14
2014,Thadeus,M,100,0,14,14
2014,Theadora,F,100,14,0,14
2014,Tiffanie,F,100,14,0,14
2014,Tigran,M,100,0,14,14
2014,Tobie,M,57,6,8,14
2014,Toma,M,100,0,14,14
2014,Toney,M,100,0,14,14
2014,Tosh,M,100,0,14,14
2014,Tracie,F,100,14,0,14
2014,Trajan,M,100,0,14,14
2014,Traveon,M,100,0,14,14
2014,Treysen,M,100,0,14,14
2014,Trish,F,100,14,0,14
2014,Trygg,M,100,0,14,14
2014,Trynity,F,100,14,0,14
2014,Tyrianna,F,100,14,0,14
2014,Tytianna,F,100,14,0,14
2014,Ulrich,M,100,0,14,14
2014,Umair,M,100,0,14,14
2014,Varick,M,100,0,14,14
2014,Vash,M,100,0,14,14
2014,Vasiliki,F,100,14,0,14
2014,Vayla,F,100,14,0,14
2014,Veena,F,100,14,0,14
2014,Vraj,M,100,0,14,14
2014,Vyom,M,100,0,14,14
2014,Wateen,F,100,14,0,14
2014,Wellington,M,100,0,14,14
2014,Willson,M,100,0,14,14
2014,Wolfe,M,100,0,14,14
2014,Wrangler,M,100,0,14,14
2014,Wrenn,F,100,14,0,14
2014,Yadhira,F,100,14,0,14
2014,Yamilett,F,100,14,0,14
2014,Yamilette,F,100,14,0,14
2014,Yandriel,M,100,0,14,14
2014,Yaron,M,100,0,14,14
2014,Yidel,M,100,0,14,14
2014,Yihan,F,57,8,6,14
2014,Yosiah,M,100,0,14,14
2014,Yovanni,M,100,0,14,14
2014,Yumna,F,100,14,0,14
2014,Yuvia,F,100,14,0,14
2014,Yvaine,F,100,14,0,14
2014,Zacharie,M,100,0,14,14
2014,Zaeem,M,100,0,14,14
2014,Zakery,M,100,0,14,14
2014,Zamier,M,100,0,14,14
2014,Zarayah,F,100,14,0,14
2014,Zayli,F,100,14,0,14
2014,Zharia,F,100,14,0,14
2014,Zillah,F,100,14,0,14
2014,Zissel,F,100,14,0,14
2014,Zohaib,M,100,0,14,14
2014,Zohar,M,57,6,8,14
2014,Zohra,F,100,14,0,14
2014,Zuley,F,100,14,0,14
2014,Zyria,F,100,14,0,14
2014,Aadhira,F,100,13,0,13
2014,Aalaya,F,100,13,0,13
2014,Aamirah,F,100,13,0,13
2014,Aara,F,100,13,0,13
2014,Abdulhadi,M,100,0,13,13
2014,Abem,M,100,0,13,13
2014,Abhi,M,100,0,13,13
2014,Abid,M,100,0,13,13
2014,Abiha,F,100,13,0,13
2014,Abra,F,100,13,0,13
2014,Adaleah,F,100,13,0,13
2014,Adaliah,F,100,13,0,13
2014,Adalynd,F,100,13,0,13
2014,Adasyn,F,100,13,0,13
2014,Addasyn,F,100,13,0,13
2014,Adeeb,M,100,0,13,13
2014,Adelind,F,100,13,0,13
2014,Adelyna,F,100,13,0,13
2014,Adhira,F,100,13,0,13
2014,Adonia,F,100,13,0,13
2014,Adriane,F,100,13,0,13
2014,Adrion,M,100,0,13,13
2014,Ahmiya,F,100,13,0,13
2014,Aizlyn,F,100,13,0,13
2014,Aksh,M,100,0,13,13
2014,Alayha,F,100,13,0,13
2014,Aldahir,M,100,0,13,13
2014,Aldyn,F,62,8,5,13
2014,Alem,M,100,0,13,13
2014,Alesandro,M,100,0,13,13
2014,Aliciana,F,100,13,0,13
2014,Alisandra,F,100,13,0,13
2014,Alixander,M,100,0,13,13
2014,Allannah,F,100,13,0,13
2014,Allayna,F,100,13,0,13
2014,Alwaleed,M,100,0,13,13
2014,Alysandra,F,100,13,0,13
2014,Amadi,F,62,8,5,13
2014,Amarilis,F,100,13,0,13
2014,Amarra,F,100,13,0,13
2014,Ameira,F,100,13,0,13
2014,Amjad,M,100,0,13,13
2014,Anaise,F,100,13,0,13
2014,Anchor,M,100,0,13,13
2014,Andersyn,F,100,13,0,13
2014,Andrianna,F,100,13,0,13
2014,Angeleah,F,100,13,0,13
2014,Angelito,M,100,0,13,13
2014,Angy,F,100,13,0,13
2014,Anjalee,F,100,13,0,13
2014,Anjelo,M,100,0,13,13
2014,Annakate,F,100,13,0,13
2014,Annayah,F,100,13,0,13
2014,Anneka,F,100,13,0,13
2014,Annia,F,100,13,0,13
2014,Antron,M,100,0,13,13
2014,Antwane,M,100,0,13,13
2014,Araiya,F,100,13,0,13
2014,Areeba,F,100,13,0,13
2014,Arelys,F,100,13,0,13
2014,Arif,M,100,0,13,13
2014,Arihaan,M,100,0,13,13
2014,Arliz,F,100,13,0,13
2014,Arlynn,F,100,13,0,13
2014,Armahni,F,54,7,6,13
2014,Arshiya,F,100,13,0,13
2014,Ashling,F,100,13,0,13
2014,Ashlinn,F,100,13,0,13
2014,Aslynn,F,100,13,0,13
2014,Astra,F,100,13,0,13
2014,Athaliah,F,100,13,0,13
2014,Aubriegh,F,100,13,0,13
2014,Aubrynn,F,100,13,0,13
2014,Audianna,F,100,13,0,13
2014,Aum,M,100,0,13,13
2014,Aviannah,F,100,13,0,13
2014,Aviendha,F,100,13,0,13
2014,Axten,M,100,0,13,13
2014,Ayaat,F,100,13,0,13
2014,Ayannah,F,100,13,0,13
2014,Aylla,F,100,13,0,13
2014,Aynsley,F,100,13,0,13
2014,Ayriana,F,100,13,0,13
2014,Aysa,F,100,13,0,13
2014,Aysel,F,100,13,0,13
2014,Ayushi,F,100,13,0,13
2014,Azaliyah,F,100,13,0,13
2014,Azavier,M,100,0,13,13
2014,Azula,F,100,13,0,13
2014,Baelynn,F,100,13,0,13
2014,Balthazar,M,100,0,13,13
2014,Banyan,M,100,0,13,13
2014,Barnabas,M,100,0,13,13
2014,Beauty,F,100,13,0,13
2014,Beckem,M,100,0,13,13
2014,Bemnet,M,62,5,8,13
2014,Beniah,M,100,0,13,13
2014,Berk,M,100,0,13,13
2014,Bethlehem,F,100,13,0,13
2014,Biak,F,54,7,6,13
2014,Blen,F,100,13,0,13
2014,Blessed,F,62,8,5,13
2014,Braelen,M,100,0,13,13
2014,Braelon,M,100,0,13,13
2014,Braison,M,100,0,13,13
2014,Braley,F,100,13,0,13
2014,Brandee,F,100,13,0,13
2014,Braniyah,F,100,13,0,13
2014,Brantleigh,F,100,13,0,13
2014,Braxson,M,100,0,13,13
2014,Braydn,M,100,0,13,13
2014,Breckan,M,100,0,13,13
2014,Breleigh,F,100,13,0,13
2014,Brennyn,F,54,7,6,13
2014,Brenyn,F,54,7,6,13
2014,Briahna,F,100,13,0,13
2014,Brinton,M,100,0,13,13
2014,Briyanna,F,100,13,0,13
2014,Brooklen,F,100,13,0,13
2014,Broox,M,100,0,13,13
2014,Buckley,M,100,0,13,13
2014,Cabela,F,100,13,0,13
2014,Caedon,M,100,0,13,13
2014,Caeson,M,100,0,13,13
2014,Cahlil,M,100,0,13,13
2014,Caliann,F,100,13,0,13
2014,Caliber,M,100,0,13,13
2014,Calyssa,F,100,13,0,13
2014,Camillo,M,100,0,13,13
2014,Can,M,100,0,13,13
2014,Candyce,F,100,13,0,13
2014,Cane,M,100,0,13,13
2014,Catalyna,F,100,13,0,13
2014,Catcher,M,100,0,13,13
2014,Catriona,F,100,13,0,13
2014,Cavani,M,100,0,13,13
2014,Caycee,F,100,13,0,13
2014,Caylah,F,100,13,0,13
2014,Cayne,M,100,0,13,13
2014,Celestia,F,100,13,0,13
2014,Charlyn,F,100,13,0,13
2014,Chavez,M,100,0,13,13
2014,Chaynce,M,100,0,13,13
2014,Chayson,M,100,0,13,13
2014,Cheick,M,100,0,13,13
2014,Cherie,F,100,13,0,13
2014,Chipper,M,100,0,13,13
2014,Chuck,M,100,0,13,13
2014,Chyler,F,100,13,0,13
2014,Cicily,F,100,13,0,13
2014,Cidney,F,100,13,0,13
2014,Ciena,F,100,13,0,13
2014,Cisco,M,100,0,13,13
2014,Claudette,F,100,13,0,13
2014,Coltrane,M,100,0,13,13
2014,Corabelle,F,100,13,0,13
2014,Cristy,F,100,13,0,13
2014,Czar,M,100,0,13,13
2014,Dace,M,100,0,13,13
2014,Dacia,F,100,13,0,13
2014,Daejon,M,100,0,13,13
2014,Daisie,F,100,13,0,13
2014,Daivion,M,100,0,13,13
2014,Daivon,M,100,0,13,13
2014,Daizy,F,100,13,0,13
2014,Dalena,F,100,13,0,13
2014,Daley,F,100,13,0,13
2014,Dali,M,54,6,7,13
2014,Dallie,F,100,13,0,13
2014,Daman,M,100,0,13,13
2014,Damar,M,100,0,13,13
2014,Damein,M,100,0,13,13
2014,Danella,F,100,13,0,13
2014,Danely,F,100,13,0,13
2014,Danessa,F,100,13,0,13
2014,Dawayne,M,100,0,13,13
2014,Dawood,M,100,0,13,13
2014,Dayvian,M,100,0,13,13
2014,Deaken,M,100,0,13,13
2014,Delicia,F,100,13,0,13
2014,Derius,M,100,0,13,13
2014,Deveon,M,100,0,13,13
2014,Dezaray,F,100,13,0,13
2014,Dhairya,M,100,0,13,13
2014,Diangelo,M,100,0,13,13
2014,Dillen,M,100,0,13,13
2014,Dillian,M,100,0,13,13
2014,Diontae,M,100,0,13,13
2014,Djibril,M,100,0,13,13
2014,Dmya,F,100,13,0,13
2014,Doc,M,100,0,13,13
2014,Domenik,M,100,0,13,13
2014,Donnovan,M,100,0,13,13
2014,Doran,M,100,0,13,13
2014,Dracen,M,100,0,13,13
2014,Dravyn,M,100,0,13,13
2014,Duru,F,100,13,0,13
2014,Dyllen,M,100,0,13,13
2014,Dymond,F,100,13,0,13
2014,Eaden,M,100,0,13,13
2014,Edris,M,100,0,13,13
2014,Edynn,F,100,13,0,13
2014,Eilyn,F,100,13,0,13
2014,Eivan,M,100,0,13,13
2014,Elainah,F,100,13,0,13
2014,Elasia,F,100,13,0,13
2014,Eldin,M,100,0,13,13
2014,Electra,F,100,13,0,13
2014,Elene,F,100,13,0,13
2014,Elianne,F,100,13,0,13
2014,Eliceo,M,100,0,13,13
2014,Elsbeth,F,100,13,0,13
2014,Elyon,M,100,0,13,13
2014,Emalina,F,100,13,0,13
2014,Emaree,F,100,13,0,13
2014,Emilyrose,F,100,13,0,13
2014,Emit,M,100,0,13,13
2014,Emiya,F,100,13,0,13
2014,Emmalou,F,100,13,0,13
2014,Emonii,F,100,13,0,13
2014,Emrick,M,100,0,13,13
2014,Emylee,F,100,13,0,13
2014,Enes,M,100,0,13,13
2014,Ephram,M,100,0,13,13
2014,Erandi,F,100,13,0,13
2014,Eriane,F,100,13,0,13
2014,Ernestina,F,100,13,0,13
2014,Estephanie,F,100,13,0,13
2014,Estrellita,F,100,13,0,13
2014,Everli,F,100,13,0,13
2014,Everson,M,100,0,13,13
2014,Evian,M,54,6,7,13
2014,Excel,F,54,7,6,13
2014,Eyob,M,100,0,13,13
2014,Faolan,M,100,0,13,13
2014,Farouk,M,100,0,13,13
2014,Faryn,F,100,13,0,13
2014,Fathima,F,100,13,0,13
2014,Fayelynn,F,100,13,0,13
2014,Fredric,M,100,0,13,13
2014,Fredrik,M,100,0,13,13
2014,Fuad,M,100,0,13,13
2014,Future,M,100,0,13,13
2014,Gabbriella,F,100,13,0,13
2014,Gabrianna,F,100,13,0,13
2014,Gail,F,100,13,0,13
2014,Garron,M,100,0,13,13
2014,Gatsby,M,100,0,13,13
2014,Gavan,M,100,0,13,13
2014,Gennaro,M,100,0,13,13
2014,Gleb,M,100,0,13,13
2014,Godfrey,M,100,0,13,13
2014,Grafton,M,100,0,13,13
2014,Grasyn,F,62,8,5,13
2014,Grayton,M,100,0,13,13
2014,Gregor,M,100,0,13,13
2014,Greidys,F,100,13,0,13
2014,Guliana,F,100,13,0,13
2014,Gurleen,F,100,13,0,13
2014,Guthrie,M,100,0,13,13
2014,Gwendalynn,F,100,13,0,13
2014,Hadiyah,F,100,13,0,13
2014,Haelyn,F,100,13,0,13
2014,Haigen,M,100,0,13,13
2014,Haizlee,F,100,13,0,13
2014,Halleigh,F,100,13,0,13
2014,Hanad,M,100,0,13,13
2014,Harbour,F,100,13,0,13
2014,Hart,M,100,0,13,13
2014,Haruka,F,100,13,0,13
2014,Hava,F,100,13,0,13
2014,Hawke,M,100,0,13,13
2014,Hazyl,F,100,13,0,13
2014,Helayna,F,100,13,0,13
2014,Helio,M,100,0,13,13
2014,Henrique,M,100,0,13,13
2014,Hibba,F,100,13,0,13
2014,Hipolito,M,100,0,13,13
2014,Hollee,F,100,13,0,13
2014,Huey,M,100,0,13,13
2014,Ikenna,M,100,0,13,13
2014,Iktan,M,100,0,13,13
2014,Ilena,F,100,13,0,13
2014,Iselle,F,100,13,0,13
2014,Ishi,F,100,13,0,13
2014,Ison,M,100,0,13,13
2014,Ivania,F,100,13,0,13
2014,Iyanla,F,100,13,0,13
2014,Iyanuoluwa,F,54,7,6,13
2014,Izzac,M,100,0,13,13
2014,Jaanai,F,100,13,0,13
2014,Jabin,M,100,0,13,13
2014,Jadavion,M,100,0,13,13
2014,Jadie,F,100,13,0,13
2014,Jadriel,M,100,0,13,13
2014,Jadynn,F,100,13,0,13
2014,Jaeleen,F,100,13,0,13
2014,Jahmal,M,100,0,13,13
2014,Jahnavi,F,100,13,0,13
2014,Jaiah,F,100,13,0,13
2014,Jailyne,F,100,13,0,13
2014,Jairon,M,100,0,13,13
2014,Jakeria,F,100,13,0,13
2014,Jakylah,F,100,13,0,13
2014,Jamelia,F,100,13,0,13
2014,Jamesha,F,100,13,0,13
2014,Jamez,M,100,0,13,13
2014,Jamielynn,F,100,13,0,13
2014,Janeva,F,100,13,0,13
2014,Janise,F,100,13,0,13
2014,Jannette,F,100,13,0,13
2014,Jantzen,M,100,0,13,13
2014,Jaselynn,F,100,13,0,13
2014,Jashua,M,100,0,13,13
2014,Jasslyn,F,100,13,0,13
2014,Javar,M,100,0,13,13
2014,Javeion,M,100,0,13,13
2014,Jaxie,F,100,13,0,13
2014,Jaydalynn,F,100,13,0,13
2014,Jayelle,F,100,13,0,13
2014,Jaylina,F,100,13,0,13
2014,Jaystin,M,100,0,13,13
2014,Jazier,M,100,0,13,13
2014,Jenasis,F,100,13,0,13
2014,Jenavie,F,100,13,0,13
2014,Jentri,F,100,13,0,13
2014,Jeovani,M,100,0,13,13
2014,Jered,M,100,0,13,13
2014,Jerika,F,100,13,0,13
2014,Jerin,M,100,0,13,13
2014,Jerrion,M,100,0,13,13
2014,Jerusha,F,100,13,0,13
2014,Jeyla,F,100,13,0,13
2014,Jhordyn,F,62,8,5,13
2014,Jiaire,M,100,0,13,13
2014,Jina,F,100,13,0,13
2014,Jinan,F,100,13,0,13
2014,Jiwoo,F,62,8,5,13
2014,Joeziah,M,100,0,13,13
2014,Johnanthony,M,100,0,13,13
2014,Johnhenry,M,100,0,13,13
2014,Johnpatrick,M,100,0,13,13
2014,Joli,F,100,13,0,13
2014,Jomari,M,100,0,13,13
2014,Jonathen,M,100,0,13,13
2014,Jonni,F,62,8,5,13
2014,Joon,M,62,5,8,13
2014,Jordanna,F,100,13,0,13
2014,Joycelynn,F,100,13,0,13
2014,Jozy,F,62,8,5,13
2014,Jsean,M,100,0,13,13
2014,Jshawn,M,100,0,13,13
2014,Juanito,M,100,0,13,13
2014,Juda,M,100,0,13,13
2014,Juni,F,100,13,0,13
2014,Kadon,M,100,0,13,13
2014,Kaedin,M,100,0,13,13
2014,Kaelah,F,100,13,0,13
2014,Kahleesi,F,100,13,0,13
2014,Kaho,F,100,13,0,13
2014,Kairon,M,100,0,13,13
2014,Kaislyn,F,100,13,0,13
2014,Kaleel,M,100,0,13,13
2014,Kalese,F,100,13,0,13
2014,Kalinda,F,100,13,0,13
2014,Kalyna,F,100,13,0,13
2014,Kalyse,F,100,13,0,13
2014,Kamon,M,100,0,13,13
2014,Kanishk,M,100,0,13,13
2014,Kanna,F,100,13,0,13
2014,Karmela,F,100,13,0,13
2014,Karrie,F,100,13,0,13
2014,Karyna,F,100,13,0,13
2014,Kashten,M,100,0,13,13
2014,Kasie,F,100,13,0,13
2014,Katelynne,F,100,13,0,13
2014,Katieann,F,100,13,0,13
2014,Kauan,M,100,0,13,13
2014,Kayelynn,F,100,13,0,13
2014,Kayzlee,F,100,13,0,13
2014,Kaziah,F,100,13,0,13
2014,Kazimir,M,100,0,13,13
2014,Keaira,F,100,13,0,13
2014,Keari,F,100,13,0,13
2014,Keaten,M,100,0,13,13
2014,Kedric,M,100,0,13,13
2014,Keerat,F,100,13,0,13
2014,Keian,M,100,0,13,13
2014,Keilin,F,62,8,5,13
2014,Keimani,F,62,8,5,13
2014,Kelbie,F,100,13,0,13
2014,Kember,F,100,13,0,13
2014,Kennedii,F,100,13,0,13
2014,Kenniel,M,100,0,13,13
2014,Kennis,F,54,7,6,13
2014,Kenrick,M,100,0,13,13
2014,Kenslei,F,100,13,0,13
2014,Kenta,M,100,0,13,13
2014,Keyleen,F,100,13,0,13
2014,Keyshaun,M,100,0,13,13
2014,Khale,M,100,0,13,13
2014,Khalie,F,100,13,0,13
2014,Khyan,M,100,0,13,13
2014,Kimberlie,F,100,13,0,13
2014,Kimorah,F,100,13,0,13
2014,Kimya,F,100,13,0,13
2014,Kingdavid,M,100,0,13,13
2014,Kinzee,F,100,13,0,13
2014,Kiva,F,100,13,0,13
2014,Klair,F,100,13,0,13
2014,Koralynn,F,100,13,0,13
2014,Koryn,F,100,13,0,13
2014,Kourtnee,F,100,13,0,13
2014,Kristell,F,100,13,0,13
2014,Kritika,F,100,13,0,13
2014,Kyanne,F,100,13,0,13
2014,Kylani,F,100,13,0,13
2014,Kyliah,F,100,13,0,13
2014,Kyrsten,F,100,13,0,13
2014,Kyshawn,M,100,0,13,13
2014,Ladonna,F,100,13,0,13
2014,Laelynn,F,100,13,0,13
2014,Lakenya,F,100,13,0,13
2014,Lakiyah,F,100,13,0,13
2014,Lalah,F,100,13,0,13
2014,Lam,F,62,8,5,13
2014,Lanora,F,100,13,0,13
2014,Lanyiah,F,100,13,0,13
2014,Larisa,F,100,13,0,13
2014,Larue,F,62,8,5,13
2014,Laryssa,F,100,13,0,13
2014,Lasean,M,100,0,13,13
2014,Lathen,M,100,0,13,13
2014,Lavi,M,100,0,13,13
2014,Lawsyn,M,54,6,7,13
2014,Leanah,F,100,13,0,13
2014,Leeani,F,100,13,0,13
2014,Leonidus,M,100,0,13,13
2014,Lessly,F,100,13,0,13
2014,Lillyth,F,100,13,0,13
2014,Lilybelle,F,100,13,0,13
2014,Lira,F,100,13,0,13
2014,Livianna,F,100,13,0,13
2014,Liyla,F,100,13,0,13
2014,Loraine,F,100,13,0,13
2014,Lorene,F,100,13,0,13
2014,Luanna,F,100,13,0,13
2014,Lucciana,F,100,13,0,13
2014,Lucilia,F,100,13,0,13
2014,Luian,M,100,0,13,13
2014,Lunabella,F,100,13,0,13
2014,Lunna,F,100,13,0,13
2014,Lyman,M,100,0,13,13
2014,Lynnex,F,100,13,0,13
2014,Machai,M,100,0,13,13
2014,Machi,M,100,0,13,13
2014,Maelys,F,100,13,0,13
2014,Mahamed,M,100,0,13,13
2014,Maimuna,F,100,13,0,13
2014,Makaiyah,F,100,13,0,13
2014,Makynleigh,F,100,13,0,13
2014,Malie,F,100,13,0,13
2014,Malyah,F,100,13,0,13
2014,Mame,F,100,13,0,13
2014,Man,F,100,13,0,13
2014,Manuella,F,100,13,0,13
2014,Marabelle,F,100,13,0,13
2014,Marjory,F,100,13,0,13
2014,Marquice,M,100,0,13,13
2014,Marykatherine,F,100,13,0,13
2014,Marylee,F,100,13,0,13
2014,Mateusz,M,100,0,13,13
2014,Matin,M,100,0,13,13
2014,Matson,M,100,0,13,13
2014,Maximilien,M,100,0,13,13
2014,Maxtyn,M,100,0,13,13
2014,Maybel,F,100,13,0,13
2014,Maysie,F,100,13,0,13
2014,Mayzee,F,100,13,0,13
2014,Mccrae,M,100,0,13,13
2014,Mckade,M,100,0,13,13
2014,Mehkai,M,100,0,13,13
2014,Mehr,F,100,13,0,13
2014,Meili,F,100,13,0,13
2014,Melaney,F,100,13,0,13
2014,Melinna,F,100,13,0,13
2014,Menno,M,100,0,13,13
2014,Meral,F,100,13,0,13
2014,Merick,M,100,0,13,13
2014,Meriel,F,100,13,0,13
2014,Merilyn,F,100,13,0,13
2014,Miami,F,100,13,0,13
2014,Mikiah,F,62,8,5,13
2014,Miklo,M,100,0,13,13
2014,Miliano,M,100,0,13,13
2014,Milica,F,100,13,0,13
2014,Minahil,F,100,13,0,13
2014,Mirza,M,100,0,13,13
2014,Misk,F,100,13,0,13
2014,Mitzy,F,100,13,0,13
2014,Miyuki,F,100,13,0,13
2014,Mordche,M,100,0,13,13
2014,Moriyah,F,100,13,0,13
2014,Mushka,F,100,13,0,13
2014,Myliah,F,100,13,0,13
2014,Myliyah,F,100,13,0,13
2014,Najah,F,100,13,0,13
2014,Najla,F,100,13,0,13
2014,Naliah,F,100,13,0,13
2014,Naryah,F,100,13,0,13
2014,Nasira,F,100,13,0,13
2014,Nassim,M,100,0,13,13
2014,Natally,F,100,13,0,13
2014,Navea,F,100,13,0,13
2014,Naw,F,100,13,0,13
2014,Ndeye,F,100,13,0,13
2014,Neeva,F,100,13,0,13
2014,Nereyda,F,100,13,0,13
2014,Neythan,M,100,0,13,13
2014,Nicki,F,100,13,0,13
2014,Nida,F,100,13,0,13
2014,Nidia,F,100,13,0,13
2014,Nili,F,100,13,0,13
2014,Nirvi,F,100,13,0,13
2014,Nissa,F,100,13,0,13
2014,Nissim,M,100,0,13,13
2014,Noach,M,100,0,13,13
2014,Noeh,M,100,0,13,13
2014,North,M,100,0,13,13
2014,Nuala,F,100,13,0,13
2014,Nyima,F,100,13,0,13
2014,Nyliah,F,100,13,0,13
2014,Nysir,M,100,0,13,13
2014,Oakes,M,100,0,13,13
2014,Oliana,F,100,13,0,13
2014,Olina,F,100,13,0,13
2014,Ollin,M,100,0,13,13
2014,Olsen,M,100,0,13,13
2014,Omran,M,100,0,13,13
2014,Orie,M,100,0,13,13
2014,Osias,M,100,0,13,13
2014,Osmin,M,100,0,13,13
2014,Pailyn,F,100,13,0,13
2014,Pailynn,F,100,13,0,13
2014,Paisli,F,100,13,0,13
2014,Paiten,F,100,13,0,13
2014,Patrik,M,100,0,13,13
2014,Pearla,F,100,13,0,13
2014,Peregrine,F,54,7,6,13
2014,Persephanie,F,100,13,0,13
2014,Petar,M,100,0,13,13
2014,Phelan,M,100,0,13,13
2014,Pinchos,M,100,0,13,13
2014,Pistol,M,62,5,8,13
2014,Posie,F,100,13,0,13
2014,Qamar,F,100,13,0,13
2014,Quiana,F,100,13,0,13
2014,Raahi,F,100,13,0,13
2014,Raelie,F,100,13,0,13
2014,Raelle,F,100,13,0,13
2014,Raffaella,F,100,13,0,13
2014,Raheim,M,100,0,13,13
2014,Rahel,F,100,13,0,13
2014,Raif,M,100,0,13,13
2014,Raima,F,100,13,0,13
2014,Ramatoulaye,F,100,13,0,13
2014,Ramello,M,100,0,13,13
2014,Ramla,F,100,13,0,13
2014,Rasha,F,100,13,0,13
2014,Rashod,M,100,0,13,13
2014,Ravon,M,100,0,13,13
2014,Rayder,M,100,0,13,13
2014,Rayquan,M,100,0,13,13
2014,Rayshaun,M,100,0,13,13
2014,Rayya,F,100,13,0,13
2014,Rea,F,100,13,0,13
2014,Reason,M,62,5,8,13
2014,Rema,F,100,13,0,13
2014,Remas,F,100,13,0,13
2014,Reo,M,100,0,13,13
2014,Revel,M,62,5,8,13
2014,Rhylin,F,62,8,5,13
2014,Ridhaan,M,100,0,13,13
2014,Rigdon,M,100,0,13,13
2014,Rihaan,M,100,0,13,13
2014,Robbin,M,54,6,7,13
2014,Rosi,F,100,13,0,13
2014,Rosselyn,F,100,13,0,13
2014,Roxann,F,100,13,0,13
2014,Royel,M,62,5,8,13
2014,Royer,M,100,0,13,13
2014,Rubina,F,100,13,0,13
2014,Ruel,M,100,0,13,13
2014,Ruhani,F,100,13,0,13
2014,Ruqayya,F,100,13,0,13
2014,Ruston,M,100,0,13,13
2014,Rustyn,M,100,0,13,13
2014,Ruthanne,F,100,13,0,13
2014,Ryane,F,100,13,0,13
2014,Rylah,F,100,13,0,13
2014,Ryson,M,100,0,13,13
2014,Saadiq,M,100,0,13,13
2014,Sabirin,F,100,13,0,13
2014,Sabrin,F,100,13,0,13
2014,Samarion,M,100,0,13,13
2014,Samika,F,100,13,0,13
2014,Sang,M,100,0,13,13
2014,Saraiya,F,100,13,0,13
2014,Saralyn,F,100,13,0,13
2014,Satori,F,100,13,0,13
2014,Saxton,M,100,0,13,13
2014,Scot,M,100,0,13,13
2014,Scottlynn,F,100,13,0,13
2014,Seana,F,100,13,0,13
2014,Sebastain,M,100,0,13,13
2014,Seriah,F,100,13,0,13
2014,Shanyla,F,100,13,0,13
2014,Sharell,F,100,13,0,13
2014,Shirin,F,100,13,0,13
2014,Shneur,M,100,0,13,13
2014,Shravya,F,100,13,0,13
2014,Shrihaan,M,100,0,13,13
2014,Shristi,F,100,13,0,13
2014,Shukri,F,100,13,0,13
2014,Shyanna,F,100,13,0,13
2014,Shyenne,F,100,13,0,13
2014,Sicilia,F,100,13,0,13
2014,Siddhi,F,100,13,0,13
2014,Sieanna,F,100,13,0,13
2014,Signe,F,100,13,0,13
2014,Silvio,M,100,0,13,13
2014,Simra,F,100,13,0,13
2014,Sinead,F,100,13,0,13
2014,Slayde,M,100,0,13,13
2014,Smaran,M,100,0,13,13
2014,Smera,F,100,13,0,13
2014,Snyder,M,100,0,13,13
2014,Solomia,F,100,13,0,13
2014,Sophina,F,100,13,0,13
2014,Soriya,F,100,13,0,13
2014,Sparsh,M,100,0,13,13
2014,Starlyn,F,100,13,0,13
2014,Steffany,F,100,13,0,13
2014,Stellarose,F,100,13,0,13
2014,Suhaan,M,100,0,13,13
2014,Suhaila,F,100,13,0,13
2014,Sujay,M,100,0,13,13
2014,Suraj,M,100,0,13,13
2014,Susanne,F,100,13,0,13
2014,Taeshawn,M,100,0,13,13
2014,Taisley,F,100,13,0,13
2014,Taleya,F,100,13,0,13
2014,Tao,M,100,0,13,13
2014,Taurus,M,100,0,13,13
2014,Tayon,M,100,0,13,13
2014,Tayvian,M,100,0,13,13
2014,Teasia,F,100,13,0,13
2014,Tehani,F,100,13,0,13
2014,Teighan,F,62,8,5,13
2014,Temprance,F,100,13,0,13
2014,Tenaya,F,100,13,0,13
2014,Terriyah,F,100,13,0,13
2014,Tessanne,F,100,13,0,13
2014,Teyanna,F,100,13,0,13
2014,Thayden,M,100,0,13,13
2014,Thessaly,F,100,13,0,13
2014,Tiare,F,100,13,0,13
2014,Timmothy,M,100,0,13,13
2014,Tiona,F,100,13,0,13
2014,Tisha,F,100,13,0,13
2014,Tobenna,M,100,0,13,13
2014,Torie,F,100,13,0,13
2014,Traniyah,F,100,13,0,13
2014,Trendon,M,100,0,13,13
2014,Trevell,M,100,0,13,13
2014,Trevis,M,100,0,13,13
2014,Treyshawn,M,100,0,13,13
2014,Trig,M,100,0,13,13
2014,Trinton,M,100,0,13,13
2014,Trip,M,100,0,13,13
2014,Tynan,M,100,0,13,13
2014,Tyrah,F,100,13,0,13
2014,Ubaldo,M,100,0,13,13
2014,Uchechukwu,M,100,0,13,13
2014,Ulric,M,100,0,13,13
2014,Umaiza,F,100,13,0,13
2014,Urvi,F,100,13,0,13
2014,Vadim,M,100,0,13,13
2014,Valeri,F,100,13,0,13
2014,Vallen,M,100,0,13,13
2014,Valyn,F,100,13,0,13
2014,Vannessa,F,100,13,0,13
2014,Vanshika,F,100,13,0,13
2014,Varvara,F,100,13,0,13
2014,Velma,F,100,13,0,13
2014,Vian,M,100,0,13,13
2014,Vicki,F,100,13,0,13
2014,Victorya,F,100,13,0,13
2014,Vihana,F,100,13,0,13
2014,Vishwa,M,100,0,13,13
2014,Vivica,F,100,13,0,13
2014,Viyaan,M,100,0,13,13
2014,Washington,M,100,0,13,13
2014,Webster,M,100,0,13,13
2014,Whittaker,M,100,0,13,13
2014,Willoughby,F,54,7,6,13
2014,Winnifred,F,100,13,0,13
2014,Wrenley,F,100,13,0,13
2014,Wylan,M,100,0,13,13
2014,Xerxes,M,100,0,13,13
2014,Xyler,M,100,0,13,13
2014,Yailin,F,100,13,0,13
2014,Yailyn,F,100,13,0,13
2014,Yaman,M,100,0,13,13
2014,Yanitza,F,100,13,0,13
2014,Yeiren,M,100,0,13,13
2014,Yerachmiel,M,100,0,13,13
2014,Yerick,M,100,0,13,13
2014,Yeslin,F,100,13,0,13
2014,Yisel,F,100,13,0,13
2014,Yonas,M,100,0,13,13
2014,Yordi,M,100,0,13,13
2014,Yordy,M,100,0,13,13
2014,Youssouf,M,100,0,13,13
2014,Yu,M,62,5,8,13
2014,Yuriana,F,100,13,0,13
2014,Zae,M,100,0,13,13
2014,Zafar,M,100,0,13,13
2014,Zafirah,F,100,13,0,13
2014,Zailen,M,100,0,13,13
2014,Zamani,F,54,7,6,13
2014,Zameer,M,100,0,13,13
2014,Zanayah,F,100,13,0,13
2014,Zandria,F,100,13,0,13
2014,Zarielle,F,100,13,0,13
2014,Zayven,M,100,0,13,13
2014,Zelena,F,100,13,0,13
2014,Zerek,M,100,0,13,13
2014,Ziyanna,F,100,13,0,13
2014,Zoella,F,100,13,0,13
2014,Zoraya,F,100,13,0,13
2014,Zowie,F,100,13,0,13
2014,Zyairah,F,100,13,0,13
2014,Zykeria,F,100,13,0,13
2014,Zylee,F,100,13,0,13
2014,Zyniah,F,100,13,0,13
2014,Zyron,M,100,0,13,13
2014,Aaila,F,100,12,0,12
2014,Aaima,F,100,12,0,12
2014,Aalaysia,F,100,12,0,12
2014,Aalivia,F,100,12,0,12
2014,Aaniya,F,100,12,0,12
2014,Aashka,F,100,12,0,12
2014,Aashrith,M,100,0,12,12
2014,Abbiegail,F,100,12,0,12
2014,Abdalla,M,100,0,12,12
2014,Abdulrahim,M,100,0,12,12
2014,Abegail,F,100,12,0,12
2014,Adalea,F,100,12,0,12
2014,Adalinn,F,100,12,0,12
2014,Adams,M,100,0,12,12
2014,Adarsh,M,100,0,12,12
2014,Addaleigh,F,100,12,0,12
2014,Adelai,F,100,12,0,12
2014,Adelei,F,100,12,0,12
2014,Adiba,F,100,12,0,12
2014,Adisynn,F,100,12,0,12
2014,Adja,F,100,12,0,12
2014,Adlyn,F,100,12,0,12
2014,Adryel,M,100,0,12,12
2014,Advith,M,100,0,12,12
2014,Ahmiyah,F,100,12,0,12
2014,Ahmod,M,100,0,12,12
2014,Aide,F,100,12,0,12
2014,Aidee,F,100,12,0,12
2014,Aideen,F,58,7,5,12
2014,Aidel,F,100,12,0,12
2014,Aireanna,F,100,12,0,12
2014,Airyanna,F,100,12,0,12
2014,Aivan,M,100,0,12,12
2014,Ajanae,F,100,12,0,12
2014,Ajooni,F,100,12,0,12
2014,Akeira,F,100,12,0,12
2014,Aki,M,58,5,7,12
2014,Akio,M,100,0,12,12
2014,Akyra,F,100,12,0,12
2014,Alakai,M,100,0,12,12
2014,Alayja,F,100,12,0,12
2014,Alazar,M,100,0,12,12
2014,Albin,M,100,0,12,12
2014,Aleanna,F,100,12,0,12
2014,Alee,F,100,12,0,12
2014,Aleecia,F,100,12,0,12
2014,Aleeha,F,100,12,0,12
2014,Aleli,F,100,12,0,12
2014,Alenah,F,100,12,0,12
2014,Alexandar,M,100,0,12,12
2014,Alexios,M,100,0,12,12
2014,Aleysha,F,100,12,0,12
2014,Alezander,M,100,0,12,12
2014,Aliani,F,100,12,0,12
2014,Alianny,F,100,12,0,12
2014,Alicea,F,100,12,0,12
2014,Alissia,F,100,12,0,12
2014,Alixandria,F,100,12,0,12
2014,Alla,F,100,12,0,12
2014,Alyanah,F,100,12,0,12
2014,Alyas,M,100,0,12,12
2014,Amariona,F,100,12,0,12
2014,Ambriel,F,100,12,0,12
2014,Ameiah,F,100,12,0,12
2014,Ameilia,F,100,12,0,12
2014,Ameliarose,F,100,12,0,12
2014,Amelio,M,100,0,12,12
2014,Amely,F,100,12,0,12
2014,Amirali,M,100,0,12,12
2014,Amyr,M,100,0,12,12
2014,Anah,F,100,12,0,12
2014,Analea,F,100,12,0,12
2014,Anberlyn,F,100,12,0,12
2014,Andry,M,100,0,12,12
2014,Aneesha,F,100,12,0,12
2014,Angelene,F,100,12,0,12
2014,Angeliyah,F,100,12,0,12
2014,Angelyna,F,100,12,0,12
2014,Anis,M,100,0,12,12
2014,Anisten,F,100,12,0,12
2014,Ankit,M,100,0,12,12
2014,Ankita,F,100,12,0,12
2014,Annahi,F,100,12,0,12
2014,Annalisia,F,100,12,0,12
2014,Annaya,F,100,12,0,12
2014,Annelle,F,100,12,0,12
2014,Annisten,F,100,12,0,12
2014,Anushree,F,100,12,0,12
2014,Arabel,F,100,12,0,12
2014,Arcadia,F,100,12,0,12
2014,Archit,M,100,0,12,12
2014,Arek,M,100,0,12,12
2014,Arelly,F,100,12,0,12
2014,Argelia,F,100,12,0,12
2014,Ariele,F,100,12,0,12
2014,Arienne,F,100,12,0,12
2014,Arlena,F,100,12,0,12
2014,Armanie,F,100,12,0,12
2014,Arpan,M,100,0,12,12
2014,Art,M,100,0,12,12
2014,Arth,M,100,0,12,12
2014,Aseneth,F,100,12,0,12
2014,Ashden,M,100,0,12,12
2014,Ashli,F,100,12,0,12
2014,Askari,M,100,0,12,12
2014,Astin,M,100,0,12,12
2014,Atalaya,F,100,12,0,12
2014,Athanasia,F,100,12,0,12
2014,Atiya,F,100,12,0,12
2014,Aureliana,F,100,12,0,12
2014,Avannah,F,100,12,0,12
2014,Avanni,F,100,12,0,12
2014,Aveer,M,100,0,12,12
2014,Averyanna,F,100,12,0,12
2014,Avien,M,100,0,12,12
2014,Avigdor,M,100,0,12,12
2014,Avilyn,F,100,12,0,12
2014,Aviraj,M,100,0,12,12
2014,Avonna,F,100,12,0,12
2014,Axtyn,M,100,0,12,12
2014,Axxel,M,100,0,12,12
2014,Ayani,F,100,12,0,12
2014,Aydden,M,100,0,12,12
2014,Ayiana,F,100,12,0,12
2014,Aylan,M,100,0,12,12
2014,Aylene,F,100,12,0,12
2014,Ayodeji,M,100,0,12,12
2014,Ayuub,M,100,0,12,12
2014,Ayvion,M,100,0,12,12
2014,Azaela,F,100,12,0,12
2014,Azaylah,F,100,12,0,12
2014,Azazel,M,100,0,12,12
2014,Azia,F,100,12,0,12
2014,Azyah,F,100,12,0,12
2014,Azyiah,F,100,12,0,12
2014,Bailei,F,100,12,0,12
2014,Bani,F,100,12,0,12
2014,Baraka,M,58,5,7,12
2014,Barrington,M,100,0,12,12
2014,Benigno,M,100,0,12,12
2014,Berish,M,100,0,12,12
2014,Bevin,F,100,12,0,12
2014,Beyla,F,100,12,0,12
2014,Blaiklee,F,100,12,0,12
2014,Boss,M,100,0,12,12
2014,Boyce,M,100,0,12,12
2014,Bradan,M,100,0,12,12
2014,Bradon,M,100,0,12,12
2014,Braxxton,M,100,0,12,12
2014,Brayah,F,100,12,0,12
2014,Brayln,M,100,0,12,12
2014,Brazos,M,100,0,12,12
2014,Brealyn,F,100,12,0,12
2014,Breken,M,100,0,12,12
2014,Brendin,M,100,0,12,12
2014,Breona,F,100,12,0,12
2014,Breyanna,F,100,12,0,12
2014,Bricelyn,F,100,12,0,12
2014,Brick,M,100,0,12,12
2014,Bristyn,F,100,12,0,12
2014,Brityn,F,100,12,0,12
2014,Brookelynne,F,100,12,0,12
2014,Brooklee,F,100,12,0,12
2014,Bryceton,M,100,0,12,12
2014,Bryella,F,100,12,0,12
2014,Bryna,F,100,12,0,12
2014,Brynden,M,100,0,12,12
2014,Bryndle,F,100,12,0,12
2014,Brynly,F,100,12,0,12
2014,Cadee,F,100,12,0,12
2014,Cadie,F,100,12,0,12
2014,Caira,F,100,12,0,12
2014,Caleesi,F,100,12,0,12
2014,Caliya,F,100,12,0,12
2014,Calvert,M,100,0,12,12
2014,Camara,F,100,12,0,12
2014,Camaya,F,100,12,0,12
2014,Cambelle,F,100,12,0,12
2014,Cambren,M,100,0,12,12
2014,Camira,F,100,12,0,12
2014,Candelario,M,100,0,12,12
2014,Caralee,F,100,12,0,12
2014,Caramia,F,100,12,0,12
2014,Cartel,M,100,0,12,12
2014,Casin,M,100,0,12,12
2014,Cassi,F,100,12,0,12
2014,Cassiopeia,F,100,12,0,12
2014,Casten,M,100,0,12,12
2014,Cayleen,F,100,12,0,12
2014,Cezar,M,100,0,12,12
2014,Chanan,M,100,0,12,12
2014,Chaniya,F,100,12,0,12
2014,Chassity,F,100,12,0,12
2014,Chayla,F,100,12,0,12
2014,Cherysh,F,100,12,0,12
2014,Chevi,F,100,12,0,12
2014,Chloeann,F,100,12,0,12
2014,Christophe,M,100,0,12,12
2014,Chynna,F,100,12,0,12
2014,Claribel,F,100,12,0,12
2014,Clary,F,100,12,0,12
2014,Cloie,F,100,12,0,12
2014,Conrado,M,100,0,12,12
2014,Constantino,M,100,0,12,12
2014,Corissa,F,100,12,0,12
2014,Corley,F,100,12,0,12
2014,Cosme,M,100,0,12,12
2014,Courtni,F,100,12,0,12
2014,Cowen,M,100,0,12,12
2014,Coye,M,100,0,12,12
2014,Crayton,M,100,0,12,12
2014,Cullan,M,100,0,12,12
2014,Cyle,M,100,0,12,12
2014,Cyriah,F,100,12,0,12
2014,Dacey,F,100,12,0,12
2014,Daeshawn,M,100,0,12,12
2014,Dailan,M,100,0,12,12
2014,Dalan,M,100,0,12,12
2014,Damarys,F,100,12,0,12
2014,Damilola,F,50,6,6,12
2014,Danylah,F,100,12,0,12
2014,Dareen,F,100,12,0,12
2014,Dareon,M,100,0,12,12
2014,Darianny,F,100,12,0,12
2014,Darragh,M,100,0,12,12
2014,Daud,M,100,0,12,12
2014,Daulton,M,100,0,12,12
2014,Davide,M,100,0,12,12
2014,Davontay,M,100,0,12,12
2014,Dawsen,M,100,0,12,12
2014,Dayanne,F,100,12,0,12
2014,Dayden,M,100,0,12,12
2014,Deaundre,M,100,0,12,12
2014,Delanee,F,100,12,0,12
2014,Delmy,F,100,12,0,12
2014,Delvon,M,100,0,12,12
2014,Demaria,F,100,12,0,12
2014,Demauri,M,100,0,12,12
2014,Demiah,F,100,12,0,12
2014,Denisha,F,100,12,0,12
2014,Derrik,M,100,0,12,12
2014,Destanie,F,100,12,0,12
2014,Deziree,F,100,12,0,12
2014,Dezlynn,F,100,12,0,12
2014,Deztiny,F,100,12,0,12
2014,Dhanush,M,100,0,12,12
2014,Diante,M,100,0,12,12
2014,Dimitrius,M,100,0,12,12
2014,Dimitry,M,100,0,12,12
2014,Dj,M,100,0,12,12
2014,Donzel,M,100,0,12,12
2014,Drako,M,100,0,12,12
2014,Drayke,M,100,0,12,12
2014,Drevon,M,100,0,12,12
2014,Dreyton,M,100,0,12,12
2014,Dyanna,F,100,12,0,12
2014,Ebba,F,100,12,0,12
2014,Eeshan,M,100,0,12,12
2014,Eion,M,100,0,12,12
2014,Eisele,F,100,12,0,12
2014,Elazar,M,100,0,12,12
2014,Elenna,F,100,12,0,12
2014,Elexa,F,100,12,0,12
2014,Elhadj,M,100,0,12,12
2014,Elih,M,100,0,12,12
2014,Elisea,F,100,12,0,12
2014,Ellanore,F,100,12,0,12
2014,Ellason,F,100,12,0,12
2014,Ellenore,F,100,12,0,12
2014,Elley,F,100,12,0,12
2014,Ellijah,M,100,0,12,12
2014,Ellionna,F,100,12,0,12
2014,Ellorie,F,100,12,0,12
2014,Elorah,F,100,12,0,12
2014,Elysha,F,100,12,0,12
2014,Emersynn,F,100,12,0,12
2014,Emilian,M,100,0,12,12
2014,Emiline,F,100,12,0,12
2014,Emilliano,M,100,0,12,12
2014,Eponine,F,100,12,0,12
2014,Erilyn,F,100,12,0,12
2014,Erinn,F,100,12,0,12
2014,Erioluwa,F,58,7,5,12
2014,Erron,M,100,0,12,12
2014,Esbeidy,F,100,12,0,12
2014,Esli,F,100,12,0,12
2014,Esra,F,100,12,0,12
2014,Etan,M,100,0,12,12
2014,Eudora,F,100,12,0,12
2014,Euna,F,100,12,0,12
2014,Eunique,F,100,12,0,12
2014,Evaluna,F,100,12,0,12
2014,Evania,F,100,12,0,12
2014,Everet,M,100,0,12,12
2014,Everlynn,F,100,12,0,12
2014,Exzavier,M,100,0,12,12
2014,Eyoel,M,100,0,12,12
2014,Ezreal,M,100,0,12,12
2014,Fadel,M,100,0,12,12
2014,Fancy,F,100,12,0,12
2014,Fariha,F,100,12,0,12
2014,Farris,M,100,0,12,12
2014,Fatiha,F,100,12,0,12
2014,Federica,F,100,12,0,12
2014,Feliciano,M,100,0,12,12
2014,Fergus,M,100,0,12,12
2014,Feven,F,100,12,0,12
2014,Fortune,M,58,5,7,12
2014,Gabi,F,100,12,0,12
2014,Garland,M,100,0,12,12
2014,Garvin,M,100,0,12,12
2014,Gatlyn,M,100,0,12,12
2014,Genelle,F,100,12,0,12
2014,Genoveva,F,100,12,0,12
2014,Gildardo,M,100,0,12,12
2014,Giles,M,100,0,12,12
2014,Giordana,F,100,12,0,12
2014,Girl,F,100,12,0,12
2014,Gissell,F,100,12,0,12
2014,Glenna,F,100,12,0,12
2014,Graycin,F,58,7,5,12
2014,Grayer,M,100,0,12,12
2014,Gresham,M,100,0,12,12
2014,Grethel,F,100,12,0,12
2014,Guilherme,M,100,0,12,12
2014,Gurshaan,M,100,0,12,12
2014,Gustave,M,100,0,12,12
2014,Gwynneth,F,100,12,0,12
2014,Haasini,F,100,12,0,12
2014,Hadden,M,100,0,12,12
2014,Hadessah,F,100,12,0,12
2014,Haidar,M,100,0,12,12
2014,Haifa,F,100,12,0,12
2014,Haivyn,F,100,12,0,12
2014,Hakan,M,100,0,12,12
2014,Halimah,F,100,12,0,12
2014,Haniyah,F,100,12,0,12
2014,Haroun,M,100,0,12,12
2014,Harriette,F,100,12,0,12
2014,Harshil,M,100,0,12,12
2014,Harvin,M,100,0,12,12
2014,Hayzlee,F,100,12,0,12
2014,Helana,F,100,12,0,12
2014,Hendricks,M,100,0,12,12
2014,Hennessey,F,100,12,0,12
2014,Henryk,M,100,0,12,12
2014,Herson,M,100,0,12,12
2014,Hewitt,M,100,0,12,12
2014,Hilinai,F,100,12,0,12
2014,Hridaan,M,100,0,12,12
2014,Huntleigh,F,100,12,0,12
2014,Huxton,M,100,0,12,12
2014,Iam,M,100,0,12,12
2014,Ilee,F,100,12,0,12
2014,Ilina,F,100,12,0,12
2014,Imri,F,50,6,6,12
2014,Inari,F,100,12,0,12
2014,Irwin,M,100,0,12,12
2014,Ivett,F,100,12,0,12
2014,Iylah,F,100,12,0,12
2014,Izeah,M,100,0,12,12
2014,Izen,M,100,0,12,12
2014,Izeyah,M,100,0,12,12
2014,Izmael,M,100,0,12,12
2014,Izzabell,F,100,12,0,12
2014,Jaccob,M,100,0,12,12
2014,Jadarian,M,100,0,12,12
2014,Jadence,F,100,12,0,12
2014,Jaedin,M,100,0,12,12
2014,Jaedynn,F,100,12,0,12
2014,Jaelene,F,100,12,0,12
2014,Jaelynne,F,100,12,0,12
2014,Jahliyah,F,100,12,0,12
2014,Jahvier,M,100,0,12,12
2014,Jailey,F,100,12,0,12
2014,Jakaylee,F,100,12,0,12
2014,Jakeb,M,100,0,12,12
2014,Jakin,M,100,0,12,12
2014,Jaking,M,100,0,12,12
2014,Jakyra,F,100,12,0,12
2014,Jalei,F,100,12,0,12
2014,Jamall,M,100,0,12,12
2014,Jamarkus,M,100,0,12,12
2014,Jamerson,M,100,0,12,12
2014,Jamilla,F,100,12,0,12
2014,Janaiya,F,100,12,0,12
2014,Jandel,M,100,0,12,12
2014,Janea,F,100,12,0,12
2014,Janeah,F,100,12,0,12
2014,Janelli,F,100,12,0,12
2014,Janson,M,100,0,12,12
2014,Jasaiah,M,100,0,12,12
2014,Jasie,F,100,12,0,12
2014,Jatavion,M,100,0,12,12
2014,Javid,M,100,0,12,12
2014,Javiel,M,100,0,12,12
2014,Jaxzen,M,100,0,12,12
2014,Jaycelyn,F,100,12,0,12
2014,Jayceona,F,100,12,0,12
2014,Jayjay,M,100,0,12,12
2014,Jaymere,M,100,0,12,12
2014,Jaysiah,M,100,0,12,12
2014,Jayzen,M,100,0,12,12
2014,Jazelyn,F,100,12,0,12
2014,Jazline,F,100,12,0,12
2014,Jd,M,100,0,12,12
2014,Jden,M,100,0,12,12
2014,Jennalyn,F,100,12,0,12
2014,Jeorgia,F,100,12,0,12
2014,Jeovanny,M,100,0,12,12
2014,Jeric,M,100,0,12,12
2014,Jerimyah,M,100,0,12,12
2014,Jerrin,M,100,0,12,12
2014,Jesalyn,F,100,12,0,12
2014,Jessamine,F,100,12,0,12
2014,Jessee,F,58,7,5,12
2014,Jewelia,F,100,12,0,12
2014,Jilliana,F,100,12,0,12
2014,Jocabed,F,100,12,0,12
2014,Jocie,F,100,12,0,12
2014,Johncarlo,M,100,0,12,12
2014,Johncarlos,M,100,0,12,12
2014,Johnse,M,100,0,12,12
2014,Jolisa,F,100,12,0,12
2014,Jonpaul,M,100,0,12,12
2014,Josefine,F,100,12,0,12
2014,Jovee,F,100,12,0,12
2014,Jovonni,M,100,0,12,12
2014,Joylynn,F,100,12,0,12
2014,Julieana,F,100,12,0,12
2014,Julionna,F,100,12,0,12
2014,Justo,M,100,0,12,12
2014,Kaaliyah,F,100,12,0,12
2014,Kaedan,M,100,0,12,12
2014,Kaelie,F,100,12,0,12
2014,Kahmya,F,100,12,0,12
2014,Kaiana,F,100,12,0,12
2014,Kaileah,F,100,12,0,12
2014,Kailia,F,100,12,0,12
2014,Kaiulani,F,100,12,0,12
2014,Kaladin,M,100,0,12,12
2014,Kalenna,F,100,12,0,12
2014,Kalik,M,100,0,12,12
2014,Kaliq,M,100,0,12,12
2014,Kallon,M,100,0,12,12
2014,Kaloni,F,100,12,0,12
2014,Kamarii,F,58,7,5,12
2014,Kamau,M,100,0,12,12
2014,Kamilia,F,100,12,0,12
2014,Kaniah,F,100,12,0,12
2014,Kanin,M,100,0,12,12
2014,Karmella,F,100,12,0,12
2014,Karyssa,F,100,12,0,12
2014,Kasra,M,100,0,12,12
2014,Kassi,F,100,12,0,12
2014,Kastle,M,100,0,12,12
2014,Katalea,F,100,12,0,12
2014,Katerine,F,100,12,0,12
2014,Katheryne,F,100,12,0,12
2014,Kathlyn,F,100,12,0,12
2014,Kati,F,100,12,0,12
2014,Katilyn,F,100,12,0,12
2014,Kattie,F,100,12,0,12
2014,Kayal,F,100,12,0,12
2014,Kaydn,M,100,0,12,12
2014,Kaylanni,F,100,12,0,12
2014,Kaylenn,F,100,12,0,12
2014,Kaylum,M,100,0,12,12
2014,Keaghan,M,100,0,12,12
2014,Keean,M,100,0,12,12
2014,Keena,F,100,12,0,12
2014,Keishawn,M,100,0,12,12
2014,Keisi,F,100,12,0,12
2014,Keivon,M,100,0,12,12
2014,Kelaiah,F,100,12,0,12
2014,Keleigh,F,100,12,0,12
2014,Kemonie,F,100,12,0,12
2014,Kendahl,F,100,12,0,12
2014,Kendry,M,100,0,12,12
2014,Kendryck,M,100,0,12,12
2014,Keno,M,100,0,12,12
2014,Kenson,M,100,0,12,12
2014,Kenyah,F,100,12,0,12
2014,Kermit,M,100,0,12,12
2014,Kervin,M,100,0,12,12
2014,Keshun,M,100,0,12,12
2014,Keymon,M,100,0,12,12
2014,Keymoni,F,100,12,0,12
2014,Khael,M,100,0,12,12
2014,Khalea,F,100,12,0,12
2014,Khamille,F,100,12,0,12
2014,Kharson,M,100,0,12,12
2014,Khyli,F,100,12,0,12
2014,Ki,M,100,0,12,12
2014,Kierre,M,100,0,12,12
2014,Kieryn,F,100,12,0,12
2014,Kila,F,100,12,0,12
2014,Kimberlin,F,100,12,0,12
2014,Kina,F,100,12,0,12
2014,Kincaid,M,100,0,12,12
2014,Kindred,F,50,6,6,12
2014,Kinslea,F,100,12,0,12
2014,Kinston,M,100,0,12,12
2014,Kiona,F,100,12,0,12
2014,Kipp,M,100,0,12,12
2014,Kirubel,M,100,0,12,12
2014,Kitt,F,50,6,6,12
2014,Kleigh,F,100,12,0,12
2014,Klohe,F,100,12,0,12
2014,Knixon,M,100,0,12,12
2014,Knolan,M,100,0,12,12
2014,Kodah,M,100,0,12,12
2014,Koleton,M,100,0,12,12
2014,Konnar,M,100,0,12,12
2014,Koralee,F,100,12,0,12
2014,Korver,M,100,0,12,12
2014,Krithi,F,100,12,0,12
2014,Krosby,M,100,0,12,12
2014,Krystiana,F,100,12,0,12
2014,Krystin,F,100,12,0,12
2014,Kwadwo,M,100,0,12,12
2014,Kyilee,F,100,12,0,12
2014,Kyleen,F,100,12,0,12
2014,Kyllian,M,100,0,12,12
2014,Kynslei,F,100,12,0,12
2014,Kypton,M,100,0,12,12
2014,Kyrese,M,100,0,12,12
2014,Laekyn,F,100,12,0,12
2014,Lailoni,F,100,12,0,12
2014,Laithan,M,100,0,12,12
2014,Laiylah,F,100,12,0,12
2014,Lamaria,F,100,12,0,12
2014,Lamin,M,100,0,12,12
2014,Lamine,M,100,0,12,12
2014,Lanea,F,100,12,0,12
2014,Lanier,M,58,5,7,12
2014,Laraya,F,100,12,0,12
2014,Latavia,F,100,12,0,12
2014,Laurent,M,100,0,12,12
2014,Lauriel,F,100,12,0,12
2014,Lavaya,F,100,12,0,12
2014,Lavontae,M,100,0,12,12
2014,Lay,F,58,7,5,12
2014,Layliana,F,100,12,0,12
2014,Leda,F,100,12,0,12
2014,Leelynd,M,100,0,12,12
2014,Leiani,F,100,12,0,12
2014,Lesean,M,100,0,12,12
2014,Letizia,F,100,12,0,12
2014,Lianah,F,100,12,0,12
2014,Liat,F,100,12,0,12
2014,Lida,F,100,12,0,12
2014,Life,F,50,6,6,12
2014,Lillieann,F,100,12,0,12
2014,Lin,F,100,12,0,12
2014,Lissa,F,100,12,0,12
2014,Lissandro,M,100,0,12,12
2014,Lofton,M,100,0,12,12
2014,Lonna,F,100,12,0,12
2014,Loreli,F,100,12,0,12
2014,Loriann,F,100,12,0,12
2014,Loxley,F,100,12,0,12
2014,Lucielle,F,100,12,0,12
2014,Lura,F,100,12,0,12
2014,Lydell,M,100,0,12,12
2014,Lydiana,F,100,12,0,12
2014,Lyndell,M,100,0,12,12
2014,Lyrique,F,100,12,0,12
2014,Lyssa,F,100,12,0,12
2014,Maanvi,F,100,12,0,12
2014,Maciah,M,58,5,7,12
2014,Mackensie,F,100,12,0,12
2014,Mackinley,F,58,7,5,12
2014,Macrae,M,100,0,12,12
2014,Madelene,F,100,12,0,12
2014,Madlyn,F,100,12,0,12
2014,Maebelle,F,100,12,0,12
2014,Maecie,F,100,12,0,12
2014,Maejor,M,100,0,12,12
2014,Magdalynn,F,100,12,0,12
2014,Magdiel,M,100,0,12,12
2014,Mahaley,F,100,12,0,12
2014,Mahealani,F,100,12,0,12
2014,Maheen,F,100,12,0,12
2014,Mahek,F,100,12,0,12
2014,Mahima,F,100,12,0,12
2014,Mahlet,F,100,12,0,12
2014,Maicol,M,100,0,12,12
2014,Maijor,M,100,0,12,12
2014,Majour,M,100,0,12,12
2014,Makailyn,F,100,12,0,12
2014,Makalyn,F,100,12,0,12
2014,Makani,M,100,0,12,12
2014,Makarios,M,100,0,12,12
2014,Makenleigh,F,100,12,0,12
2014,Mako,M,58,5,7,12
2014,Makyia,F,100,12,0,12
2014,Malanie,F,100,12,0,12
2014,Mansour,M,100,0,12,12
2014,Manu,M,100,0,12,12
2014,Marcanthony,M,100,0,12,12
2014,Mariann,F,100,12,0,12
2014,Marika,F,100,12,0,12
2014,Marilena,F,100,12,0,12
2014,Mariposa,F,100,12,0,12
2014,Markiyah,F,100,12,0,12
2014,Marlea,F,100,12,0,12
2014,Marleah,F,100,12,0,12
2014,Marqus,M,100,0,12,12
2014,Marvell,M,100,0,12,12
2014,Marybelle,F,100,12,0,12
2014,Marymargaret,F,100,12,0,12
2014,Mase,M,100,0,12,12
2014,Massimiliano,M,100,0,12,12
2014,Master,M,100,0,12,12
2014,Masud,M,100,0,12,12
2014,Matej,M,100,0,12,12
2014,Mattheus,M,100,0,12,12
2014,Mauri,F,58,7,5,12
2014,Mauriana,F,100,12,0,12
2014,Mavric,M,100,0,12,12
2014,Maycen,M,100,0,12,12
2014,Mayela,F,100,12,0,12
2014,Maysam,F,100,12,0,12
2014,Maziyah,F,100,12,0,12
2014,Mazzie,F,100,12,0,12
2014,Mckenley,F,100,12,0,12
2014,Meilech,M,100,0,12,12
2014,Miakoda,F,100,12,0,12
2014,Mialynn,F,100,12,0,12
2014,Micaella,F,100,12,0,12
2014,Miette,F,100,12,0,12
2014,Mihran,M,100,0,12,12
2014,Miia,F,100,12,0,12
2014,Mikka,F,100,12,0,12
2014,Milam,M,100,0,12,12
2014,Miliyah,F,100,12,0,12
2014,Miloh,M,100,0,12,12
2014,Miquel,M,100,0,12,12
2014,Mirai,F,100,12,0,12
2014,Mirakle,F,100,12,0,12
2014,Miran,M,100,0,12,12
2014,Miriah,F,100,12,0,12
2014,Miron,M,100,0,12,12
2014,Mishael,M,100,0,12,12
2014,Mkayla,F,100,12,0,12
2014,Montell,M,100,0,12,12
2014,Montserrath,F,100,12,0,12
2014,Montzerrat,F,100,12,0,12
2014,Mujahid,M,100,0,12,12
2014,Mung,M,100,0,12,12
2014,Mykenna,F,100,12,0,12
2014,Myrikal,F,100,12,0,12
2014,Nadalyn,F,100,12,0,12
2014,Nadelyn,F,100,12,0,12
2014,Nahshon,M,100,0,12,12
2014,Naiah,F,100,12,0,12
2014,Nalina,F,100,12,0,12
2014,Nalini,F,100,12,0,12
2014,Nalla,F,100,12,0,12
2014,Namiyah,F,100,12,0,12
2014,Nanette,F,100,12,0,12
2014,Naomii,F,100,12,0,12
2014,Nari,F,100,12,0,12
2014,Nasra,F,100,12,0,12
2014,Nataleah,F,100,12,0,12
2014,Nataliee,F,100,12,0,12
2014,Natalina,F,100,12,0,12
2014,Natanel,M,100,0,12,12
2014,Nataya,F,100,12,0,12
2014,Nathania,F,100,12,0,12
2014,Navah,F,100,12,0,12
2014,Naviah,F,100,12,0,12
2014,Nay,F,50,6,6,12
2014,Nayara,F,100,12,0,12
2014,Nayra,F,100,12,0,12
2014,Nayvie,F,100,12,0,12
2014,Nazaria,F,100,12,0,12
2014,Nazli,F,100,12,0,12
2014,Neftaly,M,100,0,12,12
2014,Nephi,M,100,0,12,12
2014,Nereida,F,100,12,0,12
2014,Niana,F,100,12,0,12
2014,Nickayla,F,100,12,0,12
2014,Nieko,M,100,0,12,12
2014,Nihaal,M,100,0,12,12
2014,Nilo,M,100,0,12,12
2014,Nivan,M,100,0,12,12
2014,Nixxon,M,100,0,12,12
2014,Niyana,F,100,12,0,12
2014,Noell,F,50,6,6,12
2014,Nohely,F,100,12,0,12
2014,Nohemy,F,100,12,0,12
2014,Noralyn,F,100,12,0,12
2014,Nuh,M,100,0,12,12
2014,Nurah,F,100,12,0,12
2014,Nyalee,F,100,12,0,12
2014,Nyana,F,100,12,0,12
2014,Nyelli,F,100,12,0,12
2014,Obi,M,100,0,12,12
2014,Ohanna,F,100,12,0,12
2014,Oliviarose,F,100,12,0,12
2014,Oliwia,F,100,12,0,12
2014,Oluwatofunmi,F,100,12,0,12
2014,Oluwatoni,F,100,12,0,12
2014,Omid,M,100,0,12,12
2014,Omkar,M,100,0,12,12
2014,Orhan,M,100,0,12,12
2014,Orian,M,100,0,12,12
2014,Owynn,M,58,5,7,12
2014,Padraic,M,100,0,12,12
2014,Patric,M,100,0,12,12
2014,Pennie,F,100,12,0,12
2014,Persais,F,100,12,0,12
2014,Petr,M,100,0,12,12
2014,Phil,M,100,0,12,12
2014,Philopateer,M,100,0,12,12
2014,Pricila,F,100,12,0,12
2014,Quashawn,M,100,0,12,12
2014,Rabia,F,100,12,0,12
2014,Radhika,F,100,12,0,12
2014,Raghad,F,100,12,0,12
2014,Rahiem,M,100,0,12,12
2014,Rahkeem,M,100,0,12,12
2014,Raia,F,100,12,0,12
2014,Raini,F,100,12,0,12
2014,Raley,F,100,12,0,12
2014,Rameen,F,100,12,0,12
2014,Ramyah,F,100,12,0,12
2014,Ranae,F,100,12,0,12
2014,Raphaella,F,100,12,0,12
2014,Rapheal,M,100,0,12,12
2014,Raseel,F,100,12,0,12
2014,Ravin,F,50,6,6,12
2014,Raydin,M,100,0,12,12
2014,Raylynne,F,100,12,0,12
2014,Rayon,M,100,0,12,12
2014,Raysean,M,100,0,12,12
2014,Reighlynn,F,100,12,0,12
2014,Reilyn,F,100,12,0,12
2014,Renn,M,100,0,12,12
2014,Rhaya,F,100,12,0,12
2014,Rhen,M,58,5,7,12
2014,Rhone,M,100,0,12,12
2014,Rien,M,58,5,7,12
2014,Rifka,F,100,12,0,12
2014,Rithik,M,100,0,12,12
2014,Rito,M,100,0,12,12
2014,Riyansh,M,100,0,12,12
2014,Roniya,F,100,12,0,12
2014,Roniyah,F,100,12,0,12
2014,Rosette,F,100,12,0,12
2014,Ryaan,M,100,0,12,12
2014,Sabastion,M,100,0,12,12
2014,Sajan,M,100,0,12,12
2014,Sakeena,F,100,12,0,12
2014,Saki,F,100,12,0,12
2014,Samad,M,100,0,12,12
2014,Samiha,F,100,12,0,12
2014,Sanae,F,100,12,0,12
2014,Sanford,M,100,0,12,12
2014,Sansa,F,100,12,0,12
2014,Sanyah,F,100,12,0,12
2014,Sanyia,F,100,12,0,12
2014,Saraiyah,F,100,12,0,12
2014,Satcha,F,100,12,0,12
2014,Saulo,M,100,0,12,12
2014,Sebastyan,M,100,0,12,12
2014,Secret,F,100,12,0,12
2014,Seiji,M,100,0,12,12
2014,Selby,F,58,7,5,12
2014,Selen,F,100,12,0,12
2014,Sema,F,100,12,0,12
2014,Sencere,M,100,0,12,12
2014,Serenidy,F,100,12,0,12
2014,Shade,M,100,0,12,12
2014,Shaliyah,F,100,12,0,12
2014,Shamarion,M,100,0,12,12
2014,Shams,F,100,12,0,12
2014,Shannel,F,100,12,0,12
2014,Shariya,F,100,12,0,12
2014,Sheikh,M,100,0,12,12
2014,Shelsea,F,100,12,0,12
2014,Sherif,M,100,0,12,12
2014,Sherilyn,F,100,12,0,12
2014,Sheyanne,F,100,12,0,12
2014,Sheza,F,100,12,0,12
2014,Shivaan,M,100,0,12,12
2014,Silje,F,100,12,0,12
2014,Sirus,M,100,0,12,12
2014,Siyah,F,100,12,0,12
2014,Solyana,F,100,12,0,12
2014,Sophiea,F,100,12,0,12
2014,Soriyah,F,100,12,0,12
2014,Starlynn,F,100,12,0,12
2014,Stephani,F,100,12,0,12
2014,Stuti,F,100,12,0,12
2014,Sumayya,F,100,12,0,12
2014,Sumner,M,100,0,12,12
2014,Suriyah,F,100,12,0,12
2014,Suzana,F,100,12,0,12
2014,Symphany,F,100,12,0,12
2014,Tacari,M,100,0,12,12
2014,Taedyn,M,58,5,7,12
2014,Taiyo,M,100,0,12,12
2014,Taleigha,F,100,12,0,12
2014,Taliana,F,100,12,0,12
2014,Tamarcus,M,100,0,12,12
2014,Tamina,F,100,12,0,12
2014,Taniela,M,100,0,12,12
2014,Taseen,M,100,0,12,12
2014,Tashvi,F,100,12,0,12
2014,Tatyanna,F,100,12,0,12
2014,Tavarus,M,100,0,12,12
2014,Tavi,F,100,12,0,12
2014,Tayana,F,100,12,0,12
2014,Tayanna,F,100,12,0,12
2014,Taygen,F,58,7,5,12
2014,Taysen,M,100,0,12,12
2014,Teairra,F,100,12,0,12
2014,Teddi,F,100,12,0,12
2014,Teller,M,100,0,12,12
2014,Thailand,M,100,0,12,12
2014,Thy,F,100,12,0,12
2014,Tinzley,F,100,12,0,12
2014,Tomoki,M,100,0,12,12
2014,Toran,M,100,0,12,12
2014,Torryn,F,100,12,0,12
2014,Traci,F,100,12,0,12
2014,Trek,M,100,0,12,12
2014,Treven,M,100,0,12,12
2014,Tyde,M,100,0,12,12
2014,Tylia,F,100,12,0,12
2014,Tyrie,M,100,0,12,12
2014,Tywon,M,100,0,12,12
2014,Ulyana,F,100,12,0,12
2014,Ulyses,M,100,0,12,12
2014,Vaden,M,100,0,12,12
2014,Vannah,F,100,12,0,12
2014,Venessa,F,100,12,0,12
2014,Vibhav,M,100,0,12,12
2014,Vidit,M,100,0,12,12
2014,Vina,F,100,12,0,12
2014,Viren,M,100,0,12,12
2014,Wil,M,100,0,12,12
2014,Wiliam,M,100,0,12,12
2014,Wilkes,M,100,0,12,12
2014,Winner,F,50,6,6,12
2014,Witt,M,100,0,12,12
2014,Wynnie,F,100,12,0,12
2014,Xandra,F,100,12,0,12
2014,Xandria,F,100,12,0,12
2014,Xaviera,F,100,12,0,12
2014,Xayvion,M,100,0,12,12
2014,Xian,M,100,0,12,12
2014,Xitlalli,F,100,12,0,12
2014,Xochilt,F,100,12,0,12
2014,Xoie,F,100,12,0,12
2014,Yacob,M,100,0,12,12
2014,Yarelly,F,100,12,0,12
2014,Yaritzel,F,100,12,0,12
2014,Yeva,F,100,12,0,12
2014,Yianni,M,100,0,12,12
2014,Yobani,M,100,0,12,12
2014,Yoltzin,M,58,5,7,12
2014,Yoseline,F,100,12,0,12
2014,Yossef,M,100,0,12,12
2014,Yoyo,F,100,12,0,12
2014,Yudith,F,100,12,0,12
2014,Yuliza,F,100,12,0,12
2014,Yussuf,M,100,0,12,12
2014,Zachari,M,100,0,12,12
2014,Zael,M,100,0,12,12
2014,Zahrah,F,100,12,0,12
2014,Zaraya,F,100,12,0,12
2014,Zavery,M,100,0,12,12
2014,Zawadi,F,100,12,0,12
2014,Zayana,F,100,12,0,12
2014,Zaylyn,F,58,7,5,12
2014,Zeeshan,M,100,0,12,12
2014,Zeniah,F,100,12,0,12
2014,Zhara,F,100,12,0,12
2014,Ziair,M,100,0,12,12
2014,Ziyonna,F,100,12,0,12
2014,Zoiey,F,100,12,0,12
2014,Zoltan,M,100,0,12,12
2014,Zorah,F,100,12,0,12
2014,Zorian,M,100,0,12,12
2014,Zymeir,M,100,0,12,12
2014,Zymire,M,100,0,12,12
2014,Aadil,M,100,0,11,11
2014,Aadvik,M,100,0,11,11
2014,Aaleeyah,F,100,11,0,11
2014,Aamani,F,100,11,0,11
2014,Aaran,M,100,0,11,11
2014,Aashika,F,100,11,0,11
2014,Aashrita,F,100,11,0,11
2014,Aayat,F,100,11,0,11
2014,Abagayle,F,100,11,0,11
2014,Abcde,F,100,11,0,11
2014,Abdiaziz,M,100,0,11,11
2014,Abdinasir,M,100,0,11,11
2014,Abdirizak,M,100,0,11,11
2014,Abdulraheem,M,100,0,11,11
2014,Abhimanyu,M,100,0,11,11
2014,Abriela,F,100,11,0,11
2014,Abrum,M,100,0,11,11
2014,Abyan,M,100,0,11,11
2014,Adain,M,100,0,11,11
2014,Adalis,F,100,11,0,11
2014,Adanya,F,100,11,0,11
2014,Addylynn,F,100,11,0,11
2014,Ademide,M,55,5,6,11
2014,Adeola,F,100,11,0,11
2014,Adilenne,F,100,11,0,11
2014,Adith,M,100,0,11,11
2014,Adiya,F,100,11,0,11
2014,Adorian,M,100,0,11,11
2014,Adriannah,F,100,11,0,11
2014,Adrie,F,100,11,0,11
2014,Advit,M,100,0,11,11
2014,Adyen,M,100,0,11,11
2014,Adylee,F,100,11,0,11
2014,Aeneas,M,100,0,11,11
2014,Africa,F,100,11,0,11
2014,Ahaana,F,100,11,0,11
2014,Ahilyn,F,100,11,0,11
2014,Ahlani,F,100,11,0,11
2014,Ahmaad,M,100,0,11,11
2014,Ahnika,F,100,11,0,11
2014,Ahonesty,F,100,11,0,11
2014,Aidah,F,100,11,0,11
2014,Aidana,F,100,11,0,11
2014,Ailed,F,100,11,0,11
2014,Ailie,F,100,11,0,11
2014,Ailis,F,100,11,0,11
2014,Ailsa,F,100,11,0,11
2014,Airalyn,F,100,11,0,11
2014,Airalynn,F,100,11,0,11
2014,Akia,F,100,11,0,11
2014,Akiera,F,100,11,0,11
2014,Akim,M,100,0,11,11
2014,Alabama,F,100,11,0,11
2014,Alandra,F,100,11,0,11
2014,Alandria,F,100,11,0,11
2014,Alarik,M,100,0,11,11
2014,Aldrich,M,100,0,11,11
2014,Alejo,M,100,0,11,11
2014,Alera,F,100,11,0,11
2014,Aletta,F,100,11,0,11
2014,Alexiz,M,100,0,11,11
2014,Alexxander,M,100,0,11,11
2014,Aliahna,F,100,11,0,11
2014,Alie,F,100,11,0,11
2014,Alis,F,100,11,0,11
2014,Alisher,M,100,0,11,11
2014,Alithia,F,100,11,0,11
2014,Aliviana,F,100,11,0,11
2014,Aloura,F,100,11,0,11
2014,Aloysius,M,100,0,11,11
2014,Alric,M,100,0,11,11
2014,Alvis,M,100,0,11,11
2014,Alyla,F,100,11,0,11
2014,Alyria,F,100,11,0,11
2014,Amando,M,100,0,11,11
2014,Amario,M,100,0,11,11
2014,Amarise,F,100,11,0,11
2014,Amariya,F,100,11,0,11
2014,Amaura,F,100,11,0,11
2014,Amayiah,F,100,11,0,11
2014,Ambellina,F,100,11,0,11
2014,Amberrose,F,100,11,0,11
2014,Ameia,F,100,11,0,11
2014,Ameri,F,100,11,0,11
2014,Americus,F,100,11,0,11
2014,Amiee,F,100,11,0,11
2014,Amiliana,F,100,11,0,11
2014,Amiree,F,100,11,0,11
2014,Amirr,M,100,0,11,11
2014,Amoria,F,100,11,0,11
2014,Amyri,F,100,11,0,11
2014,Anaaya,F,100,11,0,11
2014,Anahis,F,100,11,0,11
2014,Anaisa,F,100,11,0,11
2014,Analeya,F,100,11,0,11
2014,Analisse,F,100,11,0,11
2014,Andilyn,F,100,11,0,11
2014,Andrej,M,100,0,11,11
2014,Andreus,M,100,0,11,11
2014,Andrian,M,100,0,11,11
2014,Andriel,M,100,0,11,11
2014,Andyn,M,100,0,11,11
2014,Angelik,F,100,11,0,11
2014,Aniken,M,100,0,11,11
2014,Annalisse,F,100,11,0,11
2014,Anneli,F,100,11,0,11
2014,Anshi,F,100,11,0,11
2014,Anslie,F,100,11,0,11
2014,Anthoney,M,100,0,11,11
2014,Antionette,F,100,11,0,11
2014,Antonius,M,100,0,11,11
2014,Aqib,M,100,0,11,11
2014,Arabell,F,100,11,0,11
2014,Arad,M,100,0,11,11
2014,Araf,M,100,0,11,11
2014,Aransa,F,100,11,0,11
2014,Ardan,M,100,0,11,11
2014,Areen,F,100,11,0,11
2014,Arel,M,100,0,11,11
2014,Arelis,F,100,11,0,11
2014,Argenis,M,100,0,11,11
2014,Ariannie,F,100,11,0,11
2014,Arias,M,100,0,11,11
2014,Arielys,F,100,11,0,11
2014,Ariez,M,100,0,11,11
2014,Arihant,M,100,0,11,11
2014,Arish,M,100,0,11,11
2014,Ariyon,F,55,6,5,11
2014,Arjuna,M,100,0,11,11
2014,Armondo,M,100,0,11,11
2014,Arran,M,100,0,11,11
2014,Arshi,F,100,11,0,11
2014,Ary,M,55,5,6,11
2014,Aryahi,F,100,11,0,11
2014,Aser,M,100,0,11,11
2014,Ashani,F,100,11,0,11
2014,Ashaz,M,100,0,11,11
2014,Ashlan,F,100,11,0,11
2014,Ashrith,M,100,0,11,11
2014,Ashvik,M,100,0,11,11
2014,Asli,F,100,11,0,11
2014,Astyn,M,55,5,6,11
2014,Ata,M,100,0,11,11
2014,Atzel,M,100,0,11,11
2014,Aubrea,F,100,11,0,11
2014,Aubria,F,100,11,0,11
2014,Audreanna,F,100,11,0,11
2014,Aunika,F,100,11,0,11
2014,Avabella,F,100,11,0,11
2014,Avaiah,F,100,11,0,11
2014,Avanna,F,100,11,0,11
2014,Avarae,F,100,11,0,11
2014,Avarey,F,100,11,0,11
2014,Aveena,F,100,11,0,11
2014,Avenly,F,100,11,0,11
2014,Avishai,M,100,0,11,11
2014,Aviyana,F,100,11,0,11
2014,Azarah,F,100,11,0,11
2014,Azaya,F,100,11,0,11
2014,Azir,M,100,0,11,11
2014,Babacar,M,100,0,11,11
2014,Baldemar,M,100,0,11,11
2014,Balin,M,100,0,11,11
2014,Baneen,F,100,11,0,11
2014,Bannon,M,100,0,11,11
2014,Barack,M,100,0,11,11
2014,Bastien,M,100,0,11,11
2014,Batoul,F,100,11,0,11
2014,Baylea,F,100,11,0,11
2014,Bellany,F,100,11,0,11
2014,Benett,M,100,0,11,11
2014,Beni,F,55,6,5,11
2014,Bereket,M,100,0,11,11
2014,Bernabe,M,100,0,11,11
2014,Bessie,F,100,11,0,11
2014,Bethanny,F,100,11,0,11
2014,Bethsaida,F,100,11,0,11
2014,Bettina,F,100,11,0,11
2014,Beulah,F,100,11,0,11
2014,Bhavesh,M,100,0,11,11
2014,Binh,M,100,0,11,11
2014,Bixby,F,55,6,5,11
2014,Blaike,F,100,11,0,11
2014,Blakleigh,F,100,11,0,11
2014,Blanton,M,100,0,11,11
2014,Blimie,F,100,11,0,11
2014,Bonham,M,100,0,11,11
2014,Bralen,M,100,0,11,11
2014,Brasen,M,100,0,11,11
2014,Braylei,F,100,11,0,11
2014,Brazen,M,100,0,11,11
2014,Breezy,F,100,11,0,11
2014,Brekyn,F,100,11,0,11
2014,Brena,F,100,11,0,11
2014,Brendalynn,F,100,11,0,11
2014,Brenson,M,100,0,11,11
2014,Breylan,M,100,0,11,11
2014,Brezlin,M,55,5,6,11
2014,Brezlyn,F,100,11,0,11
2014,Briarrose,F,100,11,0,11
2014,Brieana,F,100,11,0,11
2014,Briela,F,100,11,0,11
2014,Briell,F,100,11,0,11
2014,Brinsley,F,100,11,0,11
2014,Brissia,F,100,11,0,11
2014,Bristyl,F,100,11,0,11
2014,Bruna,F,100,11,0,11
2014,Bryli,F,100,11,0,11
2014,Brynnly,F,100,11,0,11
2014,Bud,M,100,0,11,11
2014,Burkley,M,100,0,11,11
2014,Caedan,M,100,0,11,11
2014,Caidance,F,100,11,0,11
2014,Caige,M,100,0,11,11
2014,Cainen,M,100,0,11,11
2014,Caliegh,F,100,11,0,11
2014,Calixto,M,100,0,11,11
2014,Cambre,F,100,11,0,11
2014,Camerin,M,100,0,11,11
2014,Camile,F,100,11,0,11
2014,Cannen,M,100,0,11,11
2014,Caoilainn,F,100,11,0,11
2014,Caralina,F,100,11,0,11
2014,Caressa,F,100,11,0,11
2014,Cariana,F,100,11,0,11
2014,Carleen,F,100,11,0,11
2014,Carlei,F,100,11,0,11
2014,Carolann,F,100,11,0,11
2014,Carole,F,100,11,0,11
2014,Carrah,F,100,11,0,11
2014,Carsin,M,100,0,11,11
2014,Castin,M,100,0,11,11
2014,Caylyn,F,100,11,0,11
2014,Celene,F,100,11,0,11
2014,Celes,F,100,11,0,11
2014,Chaitra,F,100,11,0,11
2014,Chancelor,M,100,0,11,11
2014,Chani,F,100,11,0,11
2014,Channon,M,100,0,11,11
2014,Charlese,F,100,11,0,11
2014,Cheri,F,100,11,0,11
2014,Chrissa,F,100,11,0,11
2014,Christabelle,F,100,11,0,11
2014,Christo,M,100,0,11,11
2014,Chyla,F,100,11,0,11
2014,Cicely,F,100,11,0,11
2014,Cira,F,100,11,0,11
2014,Coal,M,100,0,11,11
2014,Coleston,M,100,0,11,11
2014,Colyn,M,100,0,11,11
2014,Corazon,F,100,11,0,11
2014,Cortlynn,F,100,11,0,11
2014,Courtnee,F,100,11,0,11
2014,Criss,M,100,0,11,11
2014,Crista,F,100,11,0,11
2014,Curry,M,100,0,11,11
2014,Curtiss,M,100,0,11,11
2014,Cybil,F,100,11,0,11
2014,Cyleigh,F,100,11,0,11
2014,Cyler,M,100,0,11,11
2014,Cyprian,M,100,0,11,11
2014,Daelin,M,100,0,11,11
2014,Daequan,M,100,0,11,11
2014,Dagen,M,100,0,11,11
2014,Dahiana,F,100,11,0,11
2014,Daiden,M,100,0,11,11
2014,Dalal,F,100,11,0,11
2014,Daniyla,F,100,11,0,11
2014,Danyella,F,100,11,0,11
2014,Darcey,F,100,11,0,11
2014,Darielys,F,100,11,0,11
2014,Dasan,M,100,0,11,11
2014,Daunte,M,100,0,11,11
2014,Davyon,M,100,0,11,11
2014,Dawid,M,100,0,11,11
2014,Daylee,F,100,11,0,11
2014,Daymond,M,100,0,11,11
2014,Dayzee,F,100,11,0,11
2014,Deaira,F,100,11,0,11
2014,Deavion,M,100,0,11,11
2014,Decarlos,M,100,0,11,11
2014,Deeanna,F,100,11,0,11
2014,Deejay,M,100,0,11,11
2014,Deem,F,100,11,0,11
2014,Del,M,100,0,11,11
2014,Delainee,F,100,11,0,11
2014,Delaynee,F,100,11,0,11
2014,Demia,F,100,11,0,11
2014,Demiana,F,100,11,0,11
2014,Dermot,M,100,0,11,11
2014,Derricka,F,100,11,0,11
2014,Derrin,M,100,0,11,11
2014,Derron,M,100,0,11,11
2014,Dervin,M,100,0,11,11
2014,Desmon,M,100,0,11,11
2014,Devanie,F,100,11,0,11
2014,Devanny,F,100,11,0,11
2014,Dhyani,F,100,11,0,11
2014,Dianely,F,100,11,0,11
2014,Diara,F,100,11,0,11
2014,Dieter,M,100,0,11,11
2014,Django,M,100,0,11,11
2014,Dniyah,F,100,11,0,11
2014,Dolan,M,100,0,11,11
2014,Dolton,M,100,0,11,11
2014,Dominiq,M,100,0,11,11
2014,Dontavius,M,100,0,11,11
2014,Dori,F,100,11,0,11
2014,Draden,M,100,0,11,11
2014,Dreshaun,M,100,0,11,11
2014,Durell,M,100,0,11,11
2014,Dwaine,M,100,0,11,11
2014,Dynver,F,100,11,0,11
2014,Eashan,M,100,0,11,11
2014,Edom,F,100,11,0,11
2014,Eibhlin,F,100,11,0,11
2014,Elany,F,100,11,0,11
2014,Elleah,F,100,11,0,11
2014,Ellianne,F,100,11,0,11
2014,Elliet,F,100,11,0,11
2014,Elric,M,100,0,11,11
2014,Emanuella,F,100,11,0,11
2014,Emilene,F,100,11,0,11
2014,Emillie,F,100,11,0,11
2014,Emillio,M,100,0,11,11
2014,Emmakate,F,100,11,0,11
2014,Emmerie,F,100,11,0,11
2014,Emmilia,F,100,11,0,11
2014,Emon,M,100,0,11,11
2014,Eriyah,F,100,11,0,11
2014,Estiven,M,100,0,11,11
2014,Esvin,M,100,0,11,11
2014,Evalin,F,100,11,0,11
2014,Evangelyne,F,100,11,0,11
2014,Evani,F,100,11,0,11
2014,Evelyna,F,100,11,0,11
2014,Fabianna,F,100,11,0,11
2014,Faduma,F,100,11,0,11
2014,Faelyn,F,100,11,0,11
2014,Fahd,M,100,0,11,11
2014,Fatmata,F,100,11,0,11
2014,Faythe,F,100,11,0,11
2014,Ferran,M,55,5,6,11
2014,Fidencio,M,100,0,11,11
2014,Filippo,M,100,0,11,11
2014,Fitzpatrick,M,100,0,11,11
2014,Fiza,F,100,11,0,11
2014,Fouad,M,100,0,11,11
2014,Franz,M,100,0,11,11
2014,Fraya,F,100,11,0,11
2014,Freda,F,100,11,0,11
2014,Fuller,M,100,0,11,11
2014,Gargi,F,100,11,0,11
2014,Gaurav,M,100,0,11,11
2014,Genavie,F,100,11,0,11
2014,Geovonni,M,100,0,11,11
2014,Ghali,M,100,0,11,11
2014,Gianlucas,M,100,0,11,11
2014,Glorianna,F,100,11,0,11
2014,Godson,M,100,0,11,11
2014,Gotti,M,100,0,11,11
2014,Greycen,M,100,0,11,11
2014,Griffith,M,100,0,11,11
2014,Grisel,F,100,11,0,11
2014,Guilianna,F,100,11,0,11
2014,Gunter,M,100,0,11,11
2014,Gurjot,F,55,6,5,11
2014,Gurkirat,F,55,6,5,11
2014,Gyan,M,100,0,11,11
2014,Haadi,M,100,0,11,11
2014,Habeeb,M,100,0,11,11
2014,Haddi,F,100,11,0,11
2014,Haevyn,F,100,11,0,11
2014,Hajer,F,100,11,0,11
2014,Hanaan,F,100,11,0,11
2014,Hannelore,F,100,11,0,11
2014,Harel,M,100,0,11,11
2014,Harkirat,F,55,6,5,11
2014,Harveer,M,100,0,11,11
2014,Hasna,F,100,11,0,11
2014,Hasnain,M,100,0,11,11
2014,Hawi,F,100,11,0,11
2014,Hendryx,M,100,0,11,11
2014,Henlie,F,100,11,0,11
2014,Hinckley,M,100,0,11,11
2014,Hiroki,M,100,0,11,11
2014,Holston,M,100,0,11,11
2014,Hussam,M,100,0,11,11
2014,Ibn,M,100,0,11,11
2014,Ijeoma,F,100,11,0,11
2014,Ikechukwu,M,100,0,11,11
2014,Ikran,F,100,11,0,11
2014,Ilani,F,100,11,0,11
2014,Illyanna,F,100,11,0,11
2014,Imad,M,100,0,11,11
2014,Inaki,M,100,0,11,11
2014,Indra,F,100,11,0,11
2014,Ioan,M,100,0,11,11
2014,Ioane,M,100,0,11,11
2014,Ion,M,100,0,11,11
2014,Isom,M,100,0,11,11
2014,Issak,M,100,0,11,11
2014,Ivar,M,100,0,11,11
2014,Ivery,F,100,11,0,11
2014,Iviana,F,100,11,0,11
2014,Ivoree,F,100,11,0,11
2014,Ivyrose,F,100,11,0,11
2014,Iyad,M,100,0,11,11
2014,Izreal,M,100,0,11,11
2014,Izumi,F,100,11,0,11
2014,Jackelyne,F,100,11,0,11
2014,Jadden,M,100,0,11,11
2014,Jadee,F,100,11,0,11
2014,Jaeli,F,100,11,0,11
2014,Jaely,F,100,11,0,11
2014,Jahlani,M,55,5,6,11
2014,Jahson,M,100,0,11,11
2014,Jaianna,F,100,11,0,11
2014,Jaicion,M,100,0,11,11
2014,Jaicob,M,100,0,11,11
2014,Jaidin,M,100,0,11,11
2014,Jakelin,F,100,11,0,11
2014,Jakori,M,100,0,11,11
2014,Jaleeah,F,100,11,0,11
2014,Jamayah,F,100,11,0,11
2014,Jamera,F,100,11,0,11
2014,Jamiel,M,100,0,11,11
2014,Janalee,F,100,11,0,11
2014,Janayla,F,100,11,0,11
2014,Janee,F,100,11,0,11
2014,Jani,F,100,11,0,11
2014,Janoah,M,100,0,11,11
2014,Japji,F,100,11,0,11
2014,Jarian,M,100,0,11,11
2014,Jariya,F,100,11,0,11
2014,Jarret,M,100,0,11,11
2014,Jaseon,M,100,0,11,11
2014,Jasmarie,F,100,11,0,11
2014,Jaston,M,100,0,11,11
2014,Jasyah,M,100,0,11,11
2014,Javell,M,100,0,11,11
2014,Jaxden,M,100,0,11,11
2014,Jaycelynn,F,100,11,0,11
2014,Jaycieon,M,100,0,11,11
2014,Jaydien,M,100,0,11,11
2014,Jaylea,F,100,11,0,11
2014,Jaylena,F,100,11,0,11
2014,Jayleon,M,100,0,11,11
2014,Jaylia,F,100,11,0,11
2014,Jaymin,M,100,0,11,11
2014,Jazaya,F,100,11,0,11
2014,Jen,M,100,0,11,11
2014,Jenalyn,F,100,11,0,11
2014,Jenay,F,100,11,0,11
2014,Jeniya,F,100,11,0,11
2014,Jensy,M,55,5,6,11
2014,Jerelyn,F,100,11,0,11
2014,Jermain,M,100,0,11,11
2014,Jerold,M,100,0,11,11
2014,Jerren,M,100,0,11,11
2014,Jerrett,M,100,0,11,11
2014,Jerzy,F,55,6,5,11
2014,Jesly,F,100,11,0,11
2014,Jeslynn,F,100,11,0,11
2014,Jesselyn,F,100,11,0,11
2014,Jessen,M,100,0,11,11
2014,Jhanvi,F,100,11,0,11
2014,Jibran,M,100,0,11,11
2014,Jihan,F,55,6,5,11
2014,Jimi,M,100,0,11,11
2014,Joannah,F,100,11,0,11
2014,Jocee,F,100,11,0,11
2014,Jochebed,F,100,11,0,11
2014,Joeangel,M,100,0,11,11
2014,Joen,M,100,0,11,11
2014,Jolena,F,100,11,0,11
2014,Jolette,F,100,11,0,11
2014,Joley,F,100,11,0,11
2014,Jontavious,M,100,0,11,11
2014,Jordayn,F,100,11,0,11
2014,Jorgia,F,100,11,0,11
2014,Joriel,M,100,0,11,11
2014,Jubal,M,100,0,11,11
2014,Judas,M,100,0,11,11
2014,Jujhar,M,100,0,11,11
2014,Juli,F,100,11,0,11
2014,Junie,F,100,11,0,11
2014,Juniel,M,100,0,11,11
2014,Jurgen,M,100,0,11,11
2014,Jurnei,F,100,11,0,11
2014,Jvon,M,100,0,11,11
2014,Kadien,M,100,0,11,11
2014,Kahne,M,100,0,11,11
2014,Kaide,M,100,0,11,11
2014,Kaimani,M,100,0,11,11
2014,Kaizlee,F,100,11,0,11
2014,Kalisa,F,100,11,0,11
2014,Kalliopi,F,100,11,0,11
2014,Kalyan,M,100,0,11,11
2014,Kamel,M,100,0,11,11
2014,Kamen,M,100,0,11,11
2014,Kamera,F,100,11,0,11
2014,Kanav,M,100,0,11,11
2014,Kannan,M,100,0,11,11
2014,Karalee,F,100,11,0,11
2014,Kariann,F,100,11,0,11
2014,Karielle,F,100,11,0,11
2014,Karliah,F,100,11,0,11
2014,Karlynn,F,100,11,0,11
2014,Kashius,M,100,0,11,11
2014,Kassey,F,100,11,0,11
2014,Kastin,M,100,0,11,11
2014,Kataleena,F,100,11,0,11
2014,Katielynn,F,100,11,0,11
2014,Katina,F,100,11,0,11
2014,Kavan,M,100,0,11,11
2014,Kavir,M,100,0,11,11
2014,Kaygen,M,55,5,6,11
2014,Kayleena,F,100,11,0,11
2014,Kayston,M,100,0,11,11
2014,Kazia,F,100,11,0,11
2014,Kdyn,M,100,0,11,11
2014,Keanan,M,100,0,11,11
2014,Keeghan,M,100,0,11,11
2014,Kehinde,M,100,0,11,11
2014,Keifer,M,100,0,11,11
2014,Keiko,F,100,11,0,11
2014,Keliyah,F,100,11,0,11
2014,Kella,F,100,11,0,11
2014,Kellon,M,100,0,11,11
2014,Kelsei,F,100,11,0,11
2014,Kemal,M,100,0,11,11
2014,Kemp,M,100,0,11,11
2014,Kenady,F,100,11,0,11
2014,Kendle,M,55,5,6,11
2014,Kendrell,M,100,0,11,11
2014,Keng,M,100,0,11,11
2014,Kennen,M,100,0,11,11
2014,Kennidi,F,100,11,0,11
2014,Kennley,F,100,11,0,11
2014,Keone,M,100,0,11,11
2014,Kerigan,F,100,11,0,11
2014,Kerrick,M,100,0,11,11
2014,Ketzaly,F,100,11,0,11
2014,Keylie,F,100,11,0,11
2014,Keyly,F,100,11,0,11
2014,Keyontae,M,100,0,11,11
2014,Khadeejah,F,100,11,0,11
2014,Khalila,F,100,11,0,11
2014,Khamiya,F,100,11,0,11
2014,Khary,M,100,0,11,11
2014,Khloei,F,100,11,0,11
2014,Khoa,M,100,0,11,11
2014,Kiel,M,100,0,11,11
2014,Kienan,M,100,0,11,11
2014,Kilani,F,100,11,0,11
2014,Kimiyah,F,100,11,0,11
2014,Kingdom,M,100,0,11,11
2014,Kinze,F,100,11,0,11
2014,Kinzly,F,100,11,0,11
2014,Kisa,F,100,11,0,11
2014,Kiyoshi,M,100,0,11,11
2014,Kjerstin,F,100,11,0,11
2014,Kmarie,F,100,11,0,11
2014,Koden,M,100,0,11,11
2014,Kortland,M,100,0,11,11
2014,Korvin,M,100,0,11,11
2014,Kosisochukwu,F,100,11,0,11
2014,Koven,M,100,0,11,11
2014,Krishan,M,100,0,11,11
2014,Kristof,M,100,0,11,11
2014,Krystopher,M,100,0,11,11
2014,Kunal,M,100,0,11,11
2014,Kwaku,M,100,0,11,11
2014,Kyi,F,55,6,5,11
2014,Kyliyah,F,100,11,0,11
2014,Kynnadi,F,100,11,0,11
2014,Kyser,M,100,0,11,11
2014,Kyzen,M,100,0,11,11
2014,Lakiya,F,100,11,0,11
2014,Lalia,F,100,11,0,11
2014,Lanee,F,100,11,0,11
2014,Larell,M,100,0,11,11
2014,Latasha,F,100,11,0,11
2014,Latif,M,100,0,11,11
2014,Lauralye,F,100,11,0,11
2014,Lavayah,F,100,11,0,11
2014,Layaan,F,100,11,0,11
2014,Laydon,M,100,0,11,11
2014,Laysha,F,100,11,0,11
2014,Leahmarie,F,100,11,0,11
2014,Leannah,F,100,11,0,11
2014,Leeloo,F,100,11,0,11
2014,Leiden,M,100,0,11,11
2014,Leighanne,F,100,11,0,11
2014,Leilan,M,100,0,11,11
2014,Lelend,M,100,0,11,11
2014,Leomar,M,100,0,11,11
2014,Leonides,M,100,0,11,11
2014,Lexee,F,100,11,0,11
2014,Lexxi,F,100,11,0,11
2014,Liliah,F,100,11,0,11
2014,Liliahna,F,100,11,0,11
2014,Lillianah,F,100,11,0,11
2014,Lilyauna,F,100,11,0,11
2014,Lionardo,M,100,0,11,11
2014,Lisamarie,F,100,11,0,11
2014,Locklan,M,100,0,11,11
2014,Lona,F,100,11,0,11
2014,Loreen,F,100,11,0,11
2014,Lorne,M,100,0,11,11
2014,Loveah,F,100,11,0,11
2014,Lucifer,M,100,0,11,11
2014,Luisana,F,100,11,0,11
2014,Luken,M,100,0,11,11
2014,Lulia,F,100,11,0,11
2014,Lydiann,F,100,11,0,11
2014,Lyndie,F,100,11,0,11
2014,Macai,M,100,0,11,11
2014,Maclain,M,100,0,11,11
2014,Madai,F,100,11,0,11
2014,Madalyne,F,100,11,0,11
2014,Madiha,F,100,11,0,11
2014,Madlynn,F,100,11,0,11
2014,Madoc,M,100,0,11,11
2014,Maela,F,100,11,0,11
2014,Maelani,F,100,11,0,11
2014,Maeley,F,100,11,0,11
2014,Maeven,F,100,11,0,11
2014,Magda,F,100,11,0,11
2014,Mahum,F,100,11,0,11
2014,Maisha,F,100,11,0,11
2014,Mak,M,100,0,11,11
2014,Makaia,F,100,11,0,11
2014,Makell,M,100,0,11,11
2014,Makenah,F,100,11,0,11
2014,Makenzey,F,100,11,0,11
2014,Makinzi,F,100,11,0,11
2014,Makynli,F,100,11,0,11
2014,Malaiah,F,100,11,0,11
2014,Malakhai,M,100,0,11,11
2014,Malala,F,100,11,0,11
2014,Malan,F,100,11,0,11
2014,Maleiah,F,100,11,0,11
2014,Maleigh,F,100,11,0,11
2014,Maleny,F,100,11,0,11
2014,Manan,M,100,0,11,11
2014,Marabella,F,100,11,0,11
2014,Marijane,F,100,11,0,11
2014,Markanthony,M,100,0,11,11
2014,Marlaya,F,100,11,0,11
2014,Maryonna,F,100,11,0,11
2014,Masa,F,100,11,0,11
2014,Masie,F,100,11,0,11
2014,Mattew,M,100,0,11,11
2014,Maurilio,M,100,0,11,11
2014,Maveryk,M,100,0,11,11
2014,Maxum,M,100,0,11,11
2014,Mayce,F,100,11,0,11
2014,Mayes,M,100,0,11,11
2014,Mayjor,M,100,0,11,11
2014,Maylea,F,100,11,0,11
2014,Maymuna,F,100,11,0,11
2014,Meer,M,100,0,11,11
2014,Mel,M,55,5,6,11
2014,Melanye,F,100,11,0,11
2014,Meleana,F,100,11,0,11
2014,Melika,F,100,11,0,11
2014,Michelina,F,100,11,0,11
2014,Mickel,M,100,0,11,11
2014,Mieka,F,100,11,0,11
2014,Mikalah,F,100,11,0,11
2014,Mikeala,F,100,11,0,11
2014,Mikella,F,100,11,0,11
2014,Mikenzi,F,100,11,0,11
2014,Mikhaela,F,100,11,0,11
2014,Mikyah,F,100,11,0,11
2014,Mikylah,F,100,11,0,11
2014,Milanya,F,100,11,0,11
2014,Millianna,F,100,11,0,11
2014,Million,M,100,0,11,11
2014,Milos,M,100,0,11,11
2014,Mireyah,F,100,11,0,11
2014,Mishti,F,100,11,0,11
2014,Missy,F,100,11,0,11
2014,Mj,M,100,0,11,11
2014,Mkenzie,F,100,11,0,11
2014,Mohab,M,100,0,11,11
2014,Montanna,F,100,11,0,11
2014,Muadh,M,100,0,11,11
2014,Muath,M,100,0,11,11
2014,Muaz,M,100,0,11,11
2014,Murtaza,M,100,0,11,11
2014,Myesha,F,100,11,0,11
2014,Mykelti,F,100,11,0,11
2014,Mylene,F,100,11,0,11
2014,Mylez,M,100,0,11,11
2014,Mylon,M,100,0,11,11
2014,Myrakle,F,100,11,0,11
2014,Nachum,M,100,0,11,11
2014,Nadalie,F,100,11,0,11
2014,Naeema,F,100,11,0,11
2014,Naftoli,M,100,0,11,11
2014,Nain,M,100,0,11,11
2014,Naithan,M,100,0,11,11
2014,Naquan,M,100,0,11,11
2014,Narjis,F,100,11,0,11
2014,Nasiah,M,55,5,6,11
2014,Nasier,M,100,0,11,11
2014,Nasiyah,F,100,11,0,11
2014,Natalye,F,100,11,0,11
2014,Natanya,F,100,11,0,11
2014,Navaya,F,100,11,0,11
2014,Naveya,F,100,11,0,11
2014,Naviyah,F,100,11,0,11
2014,Nawaal,F,100,11,0,11
2014,Nayelie,F,100,11,0,11
2014,Nayson,M,100,0,11,11
2014,Neave,F,100,11,0,11
2014,Ned,M,100,0,11,11
2014,Neilan,M,100,0,11,11
2014,Neilani,F,100,11,0,11
2014,Nelli,F,100,11,0,11
2014,Neville,M,100,0,11,11
2014,Nickolaus,M,100,0,11,11
2014,Nickson,M,100,0,11,11
2014,Nikia,F,100,11,0,11
2014,Nikolette,F,100,11,0,11
2014,Nilan,M,100,0,11,11
2014,Nirav,M,100,0,11,11
2014,Noahjames,M,100,0,11,11
2014,Noraa,F,100,11,0,11
2014,Norrin,M,100,0,11,11
2014,Nuriya,F,100,11,0,11
2014,Nyanna,F,100,11,0,11
2014,Nyari,F,100,11,0,11
2014,Nyema,F,100,11,0,11
2014,Nygel,M,100,0,11,11
2014,Nyxon,M,100,0,11,11
2014,Obaloluwa,M,100,0,11,11
2014,Octavious,M,100,0,11,11
2014,Ohana,F,100,11,0,11
2014,Olena,F,100,11,0,11
2014,Oluwatomiwa,M,100,0,11,11
2014,Oluwatoniloba,F,55,6,5,11
2014,Omarian,M,100,0,11,11
2014,Oneal,M,100,0,11,11
2014,Oneil,M,100,0,11,11
2014,Onix,M,100,0,11,11
2014,Osborn,M,100,0,11,11
2014,Otoniel,M,100,0,11,11
2014,Paislei,F,100,11,0,11
2014,Paislynn,F,100,11,0,11
2014,Petros,M,100,0,11,11
2014,Peytyn,F,100,11,0,11
2014,Phiona,F,100,11,0,11
2014,Phong,M,100,0,11,11
2014,Piersen,M,100,0,11,11
2014,Porfirio,M,100,0,11,11
2014,Posy,F,100,11,0,11
2014,Pranay,M,100,0,11,11
2014,Priest,M,100,0,11,11
2014,Providence,F,100,11,0,11
2014,Purity,F,100,11,0,11
2014,Quantez,M,100,0,11,11
2014,Quintavious,M,100,0,11,11
2014,Quintrell,M,100,0,11,11
2014,Raden,M,100,0,11,11
2014,Raea,F,100,11,0,11
2014,Raeven,F,100,11,0,11
2014,Raffaele,M,100,0,11,11
2014,Rafferty,M,100,0,11,11
2014,Rai,M,100,0,11,11
2014,Raileigh,F,100,11,0,11
2014,Rainen,M,100,0,11,11
2014,Raivyn,F,100,11,0,11
2014,Raiza,F,100,11,0,11
2014,Rajah,M,100,0,11,11
2014,Rakayla,F,100,11,0,11
2014,Ramaya,F,100,11,0,11
2014,Ramie,F,55,6,5,11
2014,Ramzy,M,100,0,11,11
2014,Randee,F,55,6,5,11
2014,Rasean,M,100,0,11,11
2014,Rashed,M,100,0,11,11
2014,Rawad,M,100,0,11,11
2014,Rayel,M,55,5,6,11
2014,Raylea,F,100,11,0,11
2014,Rayley,F,100,11,0,11
2014,Raymone,M,100,0,11,11
2014,Raynav,M,100,0,11,11
2014,Razi,M,100,0,11,11
2014,Raziah,F,100,11,0,11
2014,Red,M,100,0,11,11
2014,Refoel,M,100,0,11,11
2014,Reha,F,100,11,0,11
2014,Reigna,F,100,11,0,11
2014,Riad,M,100,0,11,11
2014,Righteous,M,100,0,11,11
2014,Rilen,M,100,0,11,11
2014,Rilynne,F,100,11,0,11
2014,Ritisha,F,100,11,0,11
2014,Rorik,M,100,0,11,11
2014,Rosalba,F,100,11,0,11
2014,Rosalena,F,100,11,0,11
2014,Rosali,F,100,11,0,11
2014,Rosamaria,F,100,11,0,11
2014,Rosanne,F,100,11,0,11
2014,Roseann,F,100,11,0,11
2014,Roshawn,M,100,0,11,11
2014,Rubee,F,100,11,0,11
2014,Ruthvik,M,100,0,11,11
2014,Ryana,F,100,11,0,11
2014,Rydan,M,100,0,11,11
2014,Ryeleigh,F,100,11,0,11
2014,Ryelynn,F,100,11,0,11
2014,Rykar,M,100,0,11,11
2014,Saarah,F,100,11,0,11
2014,Saavi,F,100,11,0,11
2014,Sael,M,100,0,11,11
2014,Sahalie,F,100,11,0,11
2014,Sahory,F,100,11,0,11
2014,Saima,F,100,11,0,11
2014,Salahuddin,M,100,0,11,11
2014,Saliah,F,100,11,0,11
2014,Samarra,F,100,11,0,11
2014,Samauri,F,55,6,5,11
2014,Samik,M,100,0,11,11
2014,Samyuktha,F,100,11,0,11
2014,Santi,M,100,0,11,11
2014,Santo,M,100,0,11,11
2014,Sanye,F,100,11,0,11
2014,Sarahgrace,F,100,11,0,11
2014,Saumya,F,100,11,0,11
2014,Savayah,F,100,11,0,11
2014,Savi,F,100,11,0,11
2014,Sefora,F,100,11,0,11
2014,Sergei,M,100,0,11,11
2014,Serra,F,100,11,0,11
2014,Shaheem,M,100,0,11,11
2014,Shaima,F,100,11,0,11
2014,Shakayla,F,100,11,0,11
2014,Shakiya,F,100,11,0,11
2014,Shamel,M,100,0,11,11
2014,Shamon,M,100,0,11,11
2014,Shandon,M,100,0,11,11
2014,Shantelle,F,100,11,0,11
2014,Sharla,F,100,11,0,11
2014,Sharlotte,F,100,11,0,11
2014,Shawnee,F,100,11,0,11
2014,Shayley,F,100,11,0,11
2014,Shemuel,M,100,0,11,11
2014,Sheyenne,F,100,11,0,11
2014,Shuayb,M,100,0,11,11
2014,Shubh,M,100,0,11,11
2014,Shylynn,F,100,11,0,11
2014,Siaosi,M,100,0,11,11
2014,Siler,M,100,0,11,11
2014,Sirr,M,100,0,11,11
2014,Skyelyn,F,100,11,0,11
2014,Sohaib,M,100,0,11,11
2014,Sohail,M,100,0,11,11
2014,Sohana,F,100,11,0,11
2014,Soliyana,F,100,11,0,11
2014,Sriansh,M,100,0,11,11
2014,Sruthi,F,100,11,0,11
2014,Stanlee,M,100,0,11,11
2014,Starlet,F,100,11,0,11
2014,Steffen,M,100,0,11,11
2014,Stiven,M,100,0,11,11
2014,Suhail,M,100,0,11,11
2014,Sukhmani,F,100,11,0,11
2014,Suliman,M,100,0,11,11
2014,Suriah,F,100,11,0,11
2014,Sylvana,F,100,11,0,11
2014,Symon,M,100,0,11,11
2014,Symphoni,F,100,11,0,11
2014,Synthia,F,100,11,0,11
2014,Szymon,M,100,0,11,11
2014,Taden,M,100,0,11,11
2014,Taeya,F,100,11,0,11
2014,Tagg,M,100,0,11,11
2014,Tahmir,M,100,0,11,11
2014,Taja,F,100,11,0,11
2014,Taji,M,55,5,6,11
2014,Tajuan,M,100,0,11,11
2014,Takira,F,100,11,0,11
2014,Talise,F,100,11,0,11
2014,Tamzin,F,100,11,0,11
2014,Tanmay,M,100,0,11,11
2014,Taralyn,F,100,11,0,11
2014,Tariya,F,100,11,0,11
2014,Tashaun,M,100,0,11,11
2014,Tatym,F,100,11,0,11
2014,Tavis,M,100,0,11,11
2014,Tavoris,M,100,0,11,11
2014,Tayonna,F,100,11,0,11
2014,Terez,M,100,0,11,11
2014,Teron,M,100,0,11,11
2014,Terralyn,F,100,11,0,11
2014,Terrel,M,100,0,11,11
2014,Terriona,F,100,11,0,11
2014,Tessah,F,100,11,0,11
2014,Theon,M,100,0,11,11
2014,Thornton,M,100,0,11,11
2014,Tiannah,F,100,11,0,11
2014,Tiwatope,F,100,11,0,11
2014,Toa,M,100,0,11,11
2014,Tomasz,M,100,0,11,11
2014,Tovah,F,100,11,0,11
2014,Trany,F,100,11,0,11
2014,Trennon,M,100,0,11,11
2014,Treyce,M,100,0,11,11
2014,Tristain,M,100,0,11,11
2014,Tron,M,100,0,11,11
2014,Tsion,F,100,11,0,11
2014,Tyke,M,100,0,11,11
2014,Tylasia,F,100,11,0,11
2014,Tymere,M,100,0,11,11
2014,Tyreon,M,100,0,11,11
2014,Tyrice,M,100,0,11,11
2014,Tywan,M,100,0,11,11
2014,Ula,F,100,11,0,11
2014,Vaidehi,F,100,11,0,11
2014,Valora,F,100,11,0,11
2014,Vara,F,100,11,0,11
2014,Varnika,F,100,11,0,11
2014,Veralynn,F,100,11,0,11
2014,Vinnie,M,100,0,11,11
2014,Vitaly,M,100,0,11,11
2014,Vonn,M,100,0,11,11
2014,Waris,M,100,0,11,11
2014,Wendall,M,100,0,11,11
2014,Weslynn,F,100,11,0,11
2014,Wilford,M,100,0,11,11
2014,Willoh,F,100,11,0,11
2014,Winfield,M,100,0,11,11
2014,Winton,M,100,0,11,11
2014,Wyat,M,100,0,11,11
2014,Xairexis,F,100,11,0,11
2014,Xela,F,100,11,0,11
2014,Yaira,F,100,11,0,11
2014,Yancarlos,M,100,0,11,11
2014,Yang,M,100,0,11,11
2014,Yaquelin,F,100,11,0,11
2014,Yareliz,F,100,11,0,11
2014,Yaritzy,F,100,11,0,11
2014,Yazen,M,100,0,11,11
2014,Yenifer,F,100,11,0,11
2014,Yeraldin,F,100,11,0,11
2014,Yi,M,100,0,11,11
2014,Yoandry,M,100,0,11,11
2014,Yoav,M,100,0,11,11
2014,Yuli,F,100,11,0,11
2014,Yunis,M,100,0,11,11
2014,Yussef,M,100,0,11,11
2014,Yuto,M,100,0,11,11
2014,Yvanna,F,100,11,0,11
2014,Yzabelle,F,100,11,0,11
2014,Zabrina,F,100,11,0,11
2014,Zacardi,M,100,0,11,11
2014,Zacariah,M,100,0,11,11
2014,Zacheriah,M,100,0,11,11
2014,Zaheer,M,100,0,11,11
2014,Zaidin,M,100,0,11,11
2014,Zakhai,M,100,0,11,11
2014,Zakirah,F,100,11,0,11
2014,Zalea,F,100,11,0,11
2014,Zalmen,M,100,0,11,11
2014,Zareena,F,100,11,0,11
2014,Zaydrian,M,100,0,11,11
2014,Zayvien,M,100,0,11,11
2014,Zebulun,M,100,0,11,11
2014,Zekiel,M,100,0,11,11
2014,Zenaya,F,100,11,0,11
2014,Zeniyah,F,100,11,0,11
2014,Zhion,M,100,0,11,11
2014,Zionah,F,100,11,0,11
2014,Zitlaly,F,100,11,0,11
2014,Zoiee,F,100,11,0,11
2014,Zorawar,M,100,0,11,11
2014,Zurielle,F,100,11,0,11
2014,Zurri,F,100,11,0,11
2014,Zyhir,M,100,0,11,11
2014,Zykira,F,100,11,0,11
2014,Aaditri,F,100,10,0,10
2014,Aairah,F,100,10,0,10
2014,Aarilyn,F,100,10,0,10
2014,Aarron,M,100,0,10,10
2014,Aasir,M,100,0,10,10
2014,Aasiya,F,100,10,0,10
2014,Abdulahad,M,100,0,10,10
2014,Abelina,F,100,10,0,10
2014,Abiageal,F,100,10,0,10
2014,Abiola,F,100,10,0,10
2014,Abubacarr,M,100,0,10,10
2014,Adamarie,F,100,10,0,10
2014,Adar,F,50,5,5,10
2014,Adayah,F,100,10,0,10
2014,Addaline,F,100,10,0,10
2014,Addalynne,F,100,10,0,10
2014,Addilyne,F,100,10,0,10
2014,Addylin,F,100,10,0,10
2014,Adea,F,100,10,0,10
2014,Adelis,F,100,10,0,10
2014,Adisen,F,100,10,0,10
2014,Adreana,F,100,10,0,10
2014,Adylan,F,100,10,0,10
2014,Aedin,M,100,0,10,10
2014,Aella,F,100,10,0,10
2014,Afomia,F,100,10,0,10
2014,Agrim,M,100,0,10,10
2014,Ahlaya,F,100,10,0,10
2014,Ahmaya,F,100,10,0,10
2014,Ahmira,F,100,10,0,10
2014,Ahnyla,F,100,10,0,10
2014,Ahriana,F,100,10,0,10
2014,Aika,F,100,10,0,10
2014,Ailana,F,100,10,0,10
2014,Aimi,F,100,10,0,10
2014,Ainzlee,F,100,10,0,10
2014,Airen,M,100,0,10,10
2014,Aison,M,100,0,10,10
2014,Aiyanah,F,100,10,0,10
2014,Aiyonna,F,100,10,0,10
2014,Aizik,M,100,0,10,10
2014,Akila,F,100,10,0,10
2014,Akon,F,50,5,5,10
2014,Akyah,F,100,10,0,10
2014,Akylah,F,100,10,0,10
2014,Alaine,F,100,10,0,10
2014,Alayziah,F,100,10,0,10
2014,Albaraa,M,100,0,10,10
2014,Aldric,M,100,0,10,10
2014,Aleesha,F,100,10,0,10
2014,Aleksi,F,50,5,5,10
2014,Alexzandra,F,100,10,0,10
2014,Aleyla,F,100,10,0,10
2014,Aliena,F,100,10,0,10
2014,Aliviya,F,100,10,0,10
2014,Alixandra,F,100,10,0,10
2014,Alizeh,F,100,10,0,10
2014,Allessandra,F,100,10,0,10
2014,Alonni,F,100,10,0,10
2014,Alontae,M,100,0,10,10
2014,Alorah,F,100,10,0,10
2014,Alter,M,100,0,10,10
2014,Alyda,F,100,10,0,10
2014,Alylah,F,100,10,0,10
2014,Alynn,F,100,10,0,10
2014,Alyona,F,100,10,0,10
2014,Alyzza,F,100,10,0,10
2014,Amadea,F,100,10,0,10
2014,Amarian,M,100,0,10,10
2014,Amarien,M,100,0,10,10
2014,Amaurie,F,50,5,5,10
2014,Ambriella,F,100,10,0,10
2014,Ambrosio,M,100,0,10,10
2014,Amea,F,100,10,0,10
2014,Amenia,F,100,10,0,10
2014,Ameris,F,100,10,0,10
2014,Amiir,M,100,0,10,10
2014,Amilee,F,100,10,0,10
2014,Amilio,M,100,0,10,10
2014,Amish,M,100,0,10,10
2014,Amitiel,F,100,10,0,10
2014,Ammara,F,100,10,0,10
2014,Amoree,F,100,10,0,10
2014,Amorette,F,100,10,0,10
2014,Amrutha,F,100,10,0,10
2014,Amry,F,100,10,0,10
2014,Anaeli,F,100,10,0,10
2014,Anahla,F,100,10,0,10
2014,Anahli,F,100,10,0,10
2014,Anaijah,F,100,10,0,10
2014,Anaika,F,100,10,0,10
2014,Analaura,F,100,10,0,10
2014,Analei,F,100,10,0,10
2014,Analysia,F,100,10,0,10
2014,Analyssa,F,100,10,0,10
2014,Anamika,F,100,10,0,10
2014,Anaria,F,100,10,0,10
2014,Anarosa,F,100,10,0,10
2014,Anastasija,F,100,10,0,10
2014,Anastazja,F,100,10,0,10
2014,Anavey,F,100,10,0,10
2014,Ande,F,100,10,0,10
2014,Anelia,F,100,10,0,10
2014,Anella,F,100,10,0,10
2014,Angele,F,100,10,0,10
2014,Angeleen,F,100,10,0,10
2014,Angelisa,F,100,10,0,10
2014,Angelyne,F,100,10,0,10
2014,Anicia,F,100,10,0,10
2014,Anikka,F,100,10,0,10
2014,Annalissa,F,100,10,0,10
2014,Annalysa,F,100,10,0,10
2014,Annalyssa,F,100,10,0,10
2014,Annorah,F,100,10,0,10
2014,Anshu,F,100,10,0,10
2014,Antavious,M,100,0,10,10
2014,Antonios,M,100,0,10,10
2014,Aoki,F,100,10,0,10
2014,Aqeel,M,100,0,10,10
2014,Arcelia,F,100,10,0,10
2014,Archimedes,M,100,0,10,10
2014,Areeb,M,100,0,10,10
2014,Ariann,F,100,10,0,10
2014,Arinze,M,100,0,10,10
2014,Ario,M,100,0,10,10
2014,Arlando,M,100,0,10,10
2014,Arly,F,50,5,5,10
2014,Armonii,F,100,10,0,10
2014,Arno,M,100,0,10,10
2014,Arri,F,100,10,0,10
2014,Arrie,F,100,10,0,10
2014,Arrietty,F,100,10,0,10
2014,Arseniy,M,100,0,10,10
2014,Artemisia,F,100,10,0,10
2014,Artist,M,100,0,10,10
2014,Aryaan,M,100,0,10,10
2014,Aryav,M,100,0,10,10
2014,Aryssa,F,100,10,0,10
2014,Asenet,F,100,10,0,10
2014,Ashe,M,100,0,10,10
2014,Ashlen,F,100,10,0,10
2014,Ashon,M,100,0,10,10
2014,Ashyr,M,100,0,10,10
2014,Asil,F,50,5,5,10
2014,Asir,M,100,0,10,10
2014,Aspynn,F,100,10,0,10
2014,Athira,F,100,10,0,10
2014,Atlantis,F,100,10,0,10
2014,Aubery,F,100,10,0,10
2014,Audreyana,F,100,10,0,10
2014,Audriella,F,100,10,0,10
2014,Audrinna,F,100,10,0,10
2014,Aureliano,M,100,0,10,10
2014,Ausha,F,100,10,0,10
2014,Autry,F,50,5,5,10
2014,Autumnrose,F,100,10,0,10
2014,Avelino,M,100,0,10,10
2014,Averley,F,100,10,0,10
2014,Avrianna,F,100,10,0,10
2014,Avya,F,100,10,0,10
2014,Ayaana,F,100,10,0,10
2014,Ayad,M,100,0,10,10
2014,Aydian,M,100,0,10,10
2014,Ayianna,F,100,10,0,10
2014,Aymara,F,100,10,0,10
2014,Aymee,F,100,10,0,10
2014,Aysen,M,100,0,10,10
2014,Ayzlee,F,100,10,0,10
2014,Azalya,F,100,10,0,10
2014,Azani,F,100,10,0,10
2014,Azariel,M,100,0,10,10
2014,Azariya,F,100,10,0,10
2014,Azriella,F,100,10,0,10
2014,Azrielle,F,100,10,0,10
2014,Bae,F,100,10,0,10
2014,Baeleigh,F,100,10,0,10
2014,Baer,M,100,0,10,10
2014,Baraa,M,100,0,10,10
2014,Barnaby,M,100,0,10,10
2014,Bartholomew,M,100,0,10,10
2014,Basilio,M,100,0,10,10
2014,Bastion,M,100,0,10,10
2014,Batul,F,100,10,0,10
2014,Bebe,F,100,10,0,10
2014,Behati,F,100,10,0,10
2014,Beily,F,100,10,0,10
2014,Benjamyn,M,100,0,10,10
2014,Berit,F,100,10,0,10
2014,Betzalel,M,100,0,10,10
2014,Bijou,F,100,10,0,10
2014,Blaikley,F,100,10,0,10
2014,Blimi,F,100,10,0,10
2014,Blyss,F,100,10,0,10
2014,Bolton,M,100,0,10,10
2014,Bracen,M,100,0,10,10
2014,Braddox,M,100,0,10,10
2014,Braileigh,F,100,10,0,10
2014,Brance,M,100,0,10,10
2014,Braxdon,M,100,0,10,10
2014,Braxen,M,100,0,10,10
2014,Breeana,F,100,10,0,10
2014,Breella,F,100,10,0,10
2014,Brenae,F,100,10,0,10
2014,Brenan,M,100,0,10,10
2014,Brenlyn,F,100,10,0,10
2014,Brentyn,M,100,0,10,10
2014,Brettley,M,100,0,10,10
2014,Brianni,F,100,10,0,10
2014,Briellah,F,100,10,0,10
2014,Brightyn,F,100,10,0,10
2014,Briniyah,F,100,10,0,10
2014,Brinklee,F,100,10,0,10
2014,Brinly,F,100,10,0,10
2014,Brinn,F,100,10,0,10
2014,Briony,F,100,10,0,10
2014,Britlee,F,100,10,0,10
2014,Brittin,F,100,10,0,10
2014,Brix,M,100,0,10,10
2014,Brolin,M,100,0,10,10
2014,Bryanne,F,100,10,0,10
2014,Bryker,M,100,0,10,10
2014,Brylea,F,100,10,0,10
2014,Brynlyn,F,100,10,0,10
2014,Brysan,M,100,0,10,10
2014,Bryse,M,100,0,10,10
2014,Cadel,M,100,0,10,10
2014,Cadin,M,100,0,10,10
2014,Caelee,F,100,10,0,10
2014,Caileb,M,100,0,10,10
2014,Caleigha,F,100,10,0,10
2014,Calley,F,100,10,0,10
2014,Caraleigh,F,100,10,0,10
2014,Cartez,M,100,0,10,10
2014,Cashis,M,100,0,10,10
2014,Cashlyn,F,100,10,0,10
2014,Cassel,M,100,0,10,10
2014,Cathan,M,100,0,10,10
2014,Catia,F,100,10,0,10
2014,Cerena,F,100,10,0,10
2014,Chaden,M,100,0,10,10
2014,Chaniyah,F,100,10,0,10
2014,Channah,F,100,10,0,10
2014,Charla,F,100,10,0,10
2014,Charleen,F,100,10,0,10
2014,Chaselynn,F,100,10,0,10
2014,Chauncy,M,100,0,10,10
2014,Chavis,M,100,0,10,10
2014,Chelsi,F,100,10,0,10
2014,Chett,M,100,0,10,10
2014,Chi,F,100,10,0,10
2014,Chidi,M,100,0,10,10
2014,Chidozie,M,100,0,10,10
2014,Chosen,M,100,0,10,10
2014,Christalyn,F,100,10,0,10
2014,Christoper,M,100,0,10,10
2014,Christyan,M,100,0,10,10
2014,Christyana,F,100,10,0,10
2014,Chukwuebuka,M,100,0,10,10
2014,Cielle,F,100,10,0,10
2014,Cipriano,M,100,0,10,10
2014,Citlally,F,100,10,0,10
2014,Colm,M,100,0,10,10
2014,Conleigh,F,100,10,0,10
2014,Constantin,M,100,0,10,10
2014,Coraleigh,F,100,10,0,10
2014,Coralina,F,100,10,0,10
2014,Cristine,F,100,10,0,10
2014,Criston,M,100,0,10,10
2014,Crusoe,M,100,0,10,10
2014,Crystina,F,100,10,0,10
2014,Cullin,M,100,0,10,10
2014,Cung,M,100,0,10,10
2014,Cydnee,F,100,10,0,10
2014,Cylie,F,100,10,0,10
2014,Cyndi,F,100,10,0,10
2014,Cyris,M,100,0,10,10
2014,Czarina,F,100,10,0,10
2014,Dacian,M,100,0,10,10
2014,Daemyn,M,100,0,10,10
2014,Dahlila,F,100,10,0,10
2014,Dailon,M,100,0,10,10
2014,Daiquan,M,100,0,10,10
2014,Daiwik,M,100,0,10,10
2014,Dajon,M,100,0,10,10
2014,Dakai,M,100,0,10,10
2014,Dal,M,100,0,10,10
2014,Dalani,F,100,10,0,10
2014,Dalayah,F,100,10,0,10
2014,Dallys,F,100,10,0,10
2014,Dalynn,F,100,10,0,10
2014,Damin,M,100,0,10,10
2014,Danish,M,100,0,10,10
2014,Dannae,F,100,10,0,10
2014,Dannica,F,100,10,0,10
2014,Danniela,F,100,10,0,10
2014,Dannielle,F,100,10,0,10
2014,Darek,M,100,0,10,10
2014,Dari,F,100,10,0,10
2014,Dariona,F,100,10,0,10
2014,Darlah,F,100,10,0,10
2014,Darlyne,F,100,10,0,10
2014,Darriel,M,100,0,10,10
2014,Dashton,M,100,0,10,10
2014,Davonna,F,100,10,0,10
2014,Davonta,M,100,0,10,10
2014,Daylah,F,100,10,0,10
2014,Daylani,F,100,10,0,10
2014,Dayveon,M,100,0,10,10
2014,Deacan,M,100,0,10,10
2014,Deaire,M,100,0,10,10
2014,Deeya,F,100,10,0,10
2014,Dekayla,F,100,10,0,10
2014,Deklynn,F,100,10,0,10
2014,Delainy,F,100,10,0,10
2014,Demarious,M,100,0,10,10
2014,Demarrion,M,100,0,10,10
2014,Demba,M,100,0,10,10
2014,Dereka,F,100,10,0,10
2014,Derell,M,100,0,10,10
2014,Derreck,M,100,0,10,10
2014,Deserae,F,100,10,0,10
2014,Deslynn,F,100,10,0,10
2014,Desmin,M,100,0,10,10
2014,Destanee,F,100,10,0,10
2014,Devereaux,M,100,0,10,10
2014,Devesh,M,100,0,10,10
2014,Devlynn,F,100,10,0,10
2014,Dewitt,M,100,0,10,10
2014,Deyon,M,100,0,10,10
2014,Diala,F,100,10,0,10
2014,Djuna,F,100,10,0,10
2014,Domanick,M,100,0,10,10
2014,Dominga,F,100,10,0,10
2014,Dominika,F,100,10,0,10
2014,Dominyk,M,100,0,10,10
2014,Donavyn,M,100,0,10,10
2014,Dontre,M,100,0,10,10
2014,Dorthy,F,100,10,0,10
2014,Draxton,M,100,0,10,10
2014,Dray,M,100,0,10,10
2014,Draydon,M,100,0,10,10
2014,Draylen,M,100,0,10,10
2014,Dshawn,M,100,0,10,10
2014,Durham,M,100,0,10,10
2014,Eastynn,F,100,10,0,10
2014,Edi,M,100,0,10,10
2014,Eduar,M,100,0,10,10
2014,Eilam,M,100,0,10,10
2014,Eilidh,F,100,10,0,10
2014,Einar,M,100,0,10,10
2014,Ej,M,100,0,10,10
2014,Ejay,M,100,0,10,10
2014,Eknoor,F,100,10,0,10
2014,Elaria,F,100,10,0,10
2014,Elay,M,100,0,10,10
2014,Elayjah,F,100,10,0,10
2014,Elba,F,100,10,0,10
2014,Eleanna,F,100,10,0,10
2014,Elease,F,100,10,0,10
2014,Eligio,M,100,0,10,10
2014,Elira,F,100,10,0,10
2014,Elisandro,M,100,0,10,10
2014,Eliska,F,100,10,0,10
2014,Elita,F,100,10,0,10
2014,Elivia,F,100,10,0,10
2014,Ellayna,F,100,10,0,10
2014,Elliett,F,100,10,0,10
2014,Elmin,M,100,0,10,10
2014,Elohim,M,100,0,10,10
2014,Eluzer,M,100,0,10,10
2014,Elver,M,100,0,10,10
2014,Elwin,M,100,0,10,10
2014,Elye,M,100,0,10,10
2014,Elyna,F,100,10,0,10
2014,Emaya,F,100,10,0,10
2014,Emberley,F,100,10,0,10
2014,Emberlin,F,100,10,0,10
2014,Emelly,F,100,10,0,10
2014,Emelynn,F,100,10,0,10
2014,Emileah,F,100,10,0,10
2014,Emmajo,F,100,10,0,10
2014,Emmeri,F,100,10,0,10
2014,Emnet,F,100,10,0,10
2014,Emric,M,100,0,10,10
2014,Emrik,M,100,0,10,10
2014,Emunah,F,100,10,0,10
2014,Emylia,F,100,10,0,10
2014,Endya,F,100,10,0,10
2014,Enyla,F,100,10,0,10
2014,Enzley,F,100,10,0,10
2014,Eon,M,100,0,10,10
2014,Erandy,F,100,10,0,10
2014,Erionna,F,100,10,0,10
2014,Esaiah,M,100,0,10,10
2014,Eshani,F,100,10,0,10
2014,Essam,M,100,0,10,10
2014,Estee,F,100,10,0,10
2014,Etzio,M,100,0,10,10
2014,Eusebio,M,100,0,10,10
2014,Evalie,F,100,10,0,10
2014,Evalisse,F,100,10,0,10
2014,Evelette,F,100,10,0,10
2014,Evlynn,F,100,10,0,10
2014,Evrett,M,100,0,10,10
2014,Exavior,M,100,0,10,10
2014,Eyanna,F,100,10,0,10
2014,Eydan,M,100,0,10,10
2014,Eyva,F,100,10,0,10
2014,Fabrice,M,100,0,10,10
2014,Fadil,M,100,0,10,10
2014,Faithann,F,100,10,0,10
2014,Faizah,F,100,10,0,10
2014,Falak,F,100,10,0,10
2014,Fantasia,F,100,10,0,10
2014,Faryal,F,100,10,0,10
2014,Felton,M,100,0,10,10
2014,Fendi,F,100,10,0,10
2014,Fenris,M,100,0,10,10
2014,Finesse,F,50,5,5,10
2014,Florentino,M,100,0,10,10
2014,Folasade,F,100,10,0,10
2014,Foxx,M,100,0,10,10
2014,Fraser,M,100,0,10,10
2014,Gabryelle,F,100,10,0,10
2014,Garima,F,100,10,0,10
2014,Garon,M,100,0,10,10
2014,Gaspard,M,100,0,10,10
2014,Gayatri,F,100,10,0,10
2014,Gena,F,100,10,0,10
2014,General,M,100,0,10,10
2014,Giavanni,F,100,10,0,10
2014,Giulio,M,100,0,10,10
2014,Gizel,F,100,10,0,10
2014,Graciemae,F,100,10,0,10
2014,Gracious,F,100,10,0,10
2014,Grae,F,100,10,0,10
2014,Graelyn,F,100,10,0,10
2014,Graisen,M,100,0,10,10
2014,Graysyn,M,100,0,10,10
2014,Greenleigh,F,100,10,0,10
2014,Greenly,F,100,10,0,10
2014,Gurveer,M,100,0,10,10
2014,Hadriel,M,100,0,10,10
2014,Haidee,F,100,10,0,10
2014,Haili,F,100,10,0,10
2014,Halden,M,100,0,10,10
2014,Halei,F,100,10,0,10
2014,Halona,F,100,10,0,10
2014,Halyn,F,100,10,0,10
2014,Halynn,F,100,10,0,10
2014,Hanaa,F,100,10,0,10
2014,Hanish,M,100,0,10,10
2014,Hannan,F,100,10,0,10
2014,Harish,M,100,0,10,10
2014,Harmani,F,100,10,0,10
2014,Hartlynn,F,100,10,0,10
2014,Havisha,F,100,10,0,10
2014,Havoc,M,100,0,10,10
2014,Haylynn,F,100,10,0,10
2014,Haywood,M,100,0,10,10
2014,Hazem,M,100,0,10,10
2014,Hedy,F,100,10,0,10
2014,Henli,F,100,10,0,10
2014,Hephzibah,F,100,10,0,10
2014,Heran,F,100,10,0,10
2014,Herlinda,F,100,10,0,10
2014,Heron,M,100,0,10,10
2014,Heyden,M,100,0,10,10
2014,Himani,F,100,10,0,10
2014,Himmat,M,100,0,10,10
2014,Horatio,M,100,0,10,10
2014,Htoo,M,100,0,10,10
2014,Hunt,M,100,0,10,10
2014,Iara,F,100,10,0,10
2014,Ibtisam,F,100,10,0,10
2014,Icelynn,F,100,10,0,10
2014,Icker,M,100,0,10,10
2014,Idil,F,100,10,0,10
2014,Ido,M,100,0,10,10
2014,Idriss,M,100,0,10,10
2014,Ifeanyichukwu,M,100,0,10,10
2014,Ihan,M,100,0,10,10
2014,Ilany,F,100,10,0,10
2014,Iley,F,100,10,0,10
2014,Ilham,F,100,10,0,10
2014,Ilithyia,F,100,10,0,10
2014,Illa,F,100,10,0,10
2014,Imaad,M,100,0,10,10
2014,Imer,M,100,0,10,10
2014,Imraan,M,100,0,10,10
2014,Inigo,M,100,0,10,10
2014,Iniyan,M,100,0,10,10
2014,Insiya,F,100,10,0,10
2014,Isabellarose,F,100,10,0,10
2014,Isaiyah,M,100,0,10,10
2014,Ismerai,F,100,10,0,10
2014,Israelle,F,100,10,0,10
2014,Issachar,M,100,0,10,10
2014,Ita,F,100,10,0,10
2014,Itamar,M,100,0,10,10
2014,Iveth,F,100,10,0,10
2014,Ivin,M,100,0,10,10
2014,Ivo,M,100,0,10,10
2014,Ivon,F,50,5,5,10
2014,Izacc,M,100,0,10,10
2014,Izack,M,100,0,10,10
2014,Izaias,M,100,0,10,10
2014,Izekiel,M,100,0,10,10
2014,Izick,M,100,0,10,10
2014,Izza,F,100,10,0,10
2014,Jabar,M,100,0,10,10
2014,Jabarie,M,100,0,10,10
2014,Jacobey,M,100,0,10,10
2014,Jacyeon,M,100,0,10,10
2014,Jacyon,M,100,0,10,10
2014,Jaece,M,100,0,10,10
2014,Jaevin,M,100,0,10,10
2014,Jahkari,M,100,0,10,10
2014,Jahmel,M,100,0,10,10
2014,Jahniah,F,100,10,0,10
2014,Jahnyla,F,100,10,0,10
2014,Jaidence,F,100,10,0,10
2014,Jaidy,F,100,10,0,10
2014,Jailani,F,100,10,0,10
2014,Jaisen,M,100,0,10,10
2014,Jakeline,F,100,10,0,10
2014,Jakenzie,F,100,10,0,10
2014,Jalaiya,F,100,10,0,10
2014,Jalaiyah,F,100,10,0,10
2014,Jalila,F,100,10,0,10
2014,Jamara,F,100,10,0,10
2014,Jamarr,M,100,0,10,10
2014,Jamylah,F,100,10,0,10
2014,Jamyson,M,100,0,10,10
2014,Jannatul,F,100,10,0,10
2014,Jannie,F,100,10,0,10
2014,Jaquarius,M,100,0,10,10
2014,Jarrel,M,100,0,10,10
2014,Jaslynne,F,100,10,0,10
2014,Jasmeet,F,100,10,0,10
2014,Jasmynn,F,100,10,0,10
2014,Javarie,M,100,0,10,10
2014,Jaxan,M,100,0,10,10
2014,Jayciana,F,100,10,0,10
2014,Jaydy,F,100,10,0,10
2014,Jaylanni,F,100,10,0,10
2014,Jaythen,M,100,0,10,10
2014,Jayzion,M,100,0,10,10
2014,Jazayah,F,100,10,0,10
2014,Jaze,M,100,0,10,10
2014,Jazira,F,100,10,0,10
2014,Jeannine,F,100,10,0,10
2014,Jedd,M,100,0,10,10
2014,Jeily,F,100,10,0,10
2014,Jemari,M,100,0,10,10
2014,Jemel,M,100,0,10,10
2014,Jenayah,F,100,10,0,10
2014,Jenell,F,100,10,0,10
2014,Jeniffer,F,100,10,0,10
2014,Jenisis,F,100,10,0,10
2014,Jennavie,F,100,10,0,10
2014,Jennessy,F,100,10,0,10
2014,Jeraldine,F,100,10,0,10
2014,Jeramyah,M,100,0,10,10
2014,Jeran,M,100,0,10,10
2014,Jereme,M,100,0,10,10
2014,Jermichael,M,100,0,10,10
2014,Jermiyah,F,100,10,0,10
2014,Jerod,M,100,0,10,10
2014,Jevaeh,F,100,10,0,10
2014,Jhalil,M,100,0,10,10
2014,Jimma,F,100,10,0,10
2014,Jmari,M,100,0,10,10
2014,Joaquim,M,100,0,10,10
2014,Joby,M,100,0,10,10
2014,Joelynn,F,100,10,0,10
2014,Johanny,F,100,10,0,10
2014,Joliet,F,100,10,0,10
2014,Jolyn,F,100,10,0,10
2014,Josaphine,F,100,10,0,10
2014,Josean,M,100,0,10,10
2014,Josecarlos,M,100,0,10,10
2014,Josejuan,M,100,0,10,10
2014,Josilynn,F,100,10,0,10
2014,Joumana,F,100,10,0,10
2014,Jsiah,M,100,0,10,10
2014,Juandedios,M,100,0,10,10
2014,Jule,F,100,10,0,10
2014,Julianah,F,100,10,0,10
2014,Julion,M,100,0,10,10
2014,Julliana,F,100,10,0,10
2014,Jullien,M,100,0,10,10
2014,Jusiah,M,100,0,10,10
2014,Justino,M,100,0,10,10
2014,Jynesis,F,100,10,0,10
2014,Kabeer,M,100,0,10,10
2014,Kaceon,M,100,0,10,10
2014,Kadi,F,100,10,0,10
2014,Kaemon,M,100,0,10,10
2014,Kahlea,F,100,10,0,10
2014,Kaikea,M,100,0,10,10
2014,Kaileia,F,100,10,0,10
2014,Kairav,M,100,0,10,10
2014,Kais,M,100,0,10,10
2014,Kaj,M,100,0,10,10
2014,Kajsa,F,100,10,0,10
2014,Kaleab,M,100,0,10,10
2014,Kaleem,M,100,0,10,10
2014,Kaliannah,F,100,10,0,10
2014,Kalijah,M,100,0,10,10
2014,Kaliope,F,100,10,0,10
2014,Kallel,M,100,0,10,10
2014,Kalysta,F,100,10,0,10
2014,Kamala,F,100,10,0,10
2014,Kambrey,F,100,10,0,10
2014,Kamela,F,100,10,0,10
2014,Kameria,F,100,10,0,10
2014,Kammi,F,100,10,0,10
2014,Kanan,M,100,0,10,10
2014,Kanishka,F,100,10,0,10
2014,Karanveer,M,100,0,10,10
2014,Karmah,F,100,10,0,10
2014,Karri,F,100,10,0,10
2014,Kartik,M,100,0,10,10
2014,Kasai,M,100,0,10,10
2014,Kasidee,F,100,10,0,10
2014,Kassy,F,100,10,0,10
2014,Kataleyah,F,100,10,0,10
2014,Katarzyna,F,100,10,0,10
2014,Kathan,M,100,0,10,10
2014,Kawena,F,100,10,0,10
2014,Kaye,F,100,10,0,10
2014,Kayelyn,F,100,10,0,10
2014,Kayliah,F,100,10,0,10
2014,Kayliee,F,100,10,0,10
2014,Kayln,F,100,10,0,10
2014,Kaymarie,F,100,10,0,10
2014,Kaysi,F,100,10,0,10
2014,Kazuma,M,100,0,10,10
2014,Kden,M,100,0,10,10
2014,Keagon,M,100,0,10,10
2014,Keats,M,100,0,10,10
2014,Keen,M,100,0,10,10
2014,Keerthana,F,100,10,0,10
2014,Keiji,M,100,0,10,10
2014,Keiyon,M,100,0,10,10
2014,Kel,M,100,0,10,10
2014,Kelian,M,100,0,10,10
2014,Keriana,F,100,10,0,10
2014,Kervens,M,100,0,10,10
2014,Kesean,M,100,0,10,10
2014,Keslie,F,100,10,0,10
2014,Keva,F,100,10,0,10
2014,Keyasia,F,100,10,0,10
2014,Keyner,M,100,0,10,10
2014,Keyonte,M,100,0,10,10
2014,Khaira,F,100,10,0,10
2014,Khalise,F,100,10,0,10
2014,Khamora,F,100,10,0,10
2014,Khan,M,100,0,10,10
2014,Khani,M,100,0,10,10
2014,Kharlie,F,100,10,0,10
2014,Khayri,M,100,0,10,10
2014,Khian,M,100,0,10,10
2014,Khush,M,100,0,10,10
2014,Khyran,M,100,0,10,10
2014,Khyron,M,100,0,10,10
2014,Kiahna,F,100,10,0,10
2014,Kingson,M,100,0,10,10
2014,Kinzi,F,100,10,0,10
2014,Kioni,F,100,10,0,10
2014,Kipling,M,100,0,10,10
2014,Kiren,M,100,0,10,10
2014,Kiri,F,100,10,0,10
2014,Kirie,F,100,10,0,10
2014,Kirtan,M,100,0,10,10
2014,Klover,F,100,10,0,10
2014,Kobee,M,100,0,10,10
2014,Kolsyn,M,100,0,10,10
2014,Korin,F,50,5,5,10
2014,Kort,M,100,0,10,10
2014,Kortlynn,F,100,10,0,10
2014,Koston,M,100,0,10,10
2014,Kourtlynn,F,100,10,0,10
2014,Kratos,M,100,0,10,10
2014,Kristalyn,F,100,10,0,10
2014,Kristan,M,100,0,10,10
2014,Kru,M,100,0,10,10
2014,Kvon,M,100,0,10,10
2014,Kwynn,F,100,10,0,10
2014,Kyair,M,100,0,10,10
2014,Kyani,F,100,10,0,10
2014,Kyce,M,100,0,10,10
2014,Kyion,M,100,0,10,10
2014,Kylieann,F,100,10,0,10
2014,Kyonna,F,100,10,0,10
2014,Kyuss,M,100,0,10,10
2014,Ladon,M,100,0,10,10
2014,Laelani,F,100,10,0,10
2014,Laird,M,100,0,10,10
2014,Lakshya,F,50,5,5,10
2014,Lamara,F,100,10,0,10
2014,Lamon,M,100,0,10,10
2014,Lason,M,100,0,10,10
2014,Lateef,M,100,0,10,10
2014,Latifa,F,100,10,0,10
2014,Laureen,F,100,10,0,10
2014,Laylamarie,F,100,10,0,10
2014,Laylee,F,100,10,0,10
2014,Laylia,F,100,10,0,10
2014,Layloni,F,100,10,0,10
2014,Lazlo,M,100,0,10,10
2014,Leelyn,M,100,0,10,10
2014,Leenah,F,100,10,0,10
2014,Leiam,M,100,0,10,10
2014,Leilanee,F,100,10,0,10
2014,Leily,F,100,10,0,10
2014,Leim,M,100,0,10,10
2014,Lemon,F,100,10,0,10
2014,Leslye,F,100,10,0,10
2014,Levar,M,100,0,10,10
2014,Lewi,M,100,0,10,10
2014,Lezlie,F,100,10,0,10
2014,Liadan,F,100,10,0,10
2014,Liane,F,100,10,0,10
2014,Liela,F,100,10,0,10
2014,Lilac,F,100,10,0,10
2014,Lilja,F,100,10,0,10
2014,Lilliahna,F,100,10,0,10
2014,Linnaea,F,100,10,0,10
2014,Linwood,M,100,0,10,10
2014,Lionell,M,100,0,10,10
2014,Lizet,F,100,10,0,10
2014,Lj,M,100,0,10,10
2014,Loa,F,100,10,0,10
2014,Lochlin,M,100,0,10,10
2014,Londin,F,100,10,0,10
2014,Loralee,F,100,10,0,10
2014,Lorik,M,100,0,10,10
2014,Lorraina,F,100,10,0,10
2014,Lovie,F,100,10,0,10
2014,Lucelia,F,100,10,0,10
2014,Lucilla,F,100,10,0,10
2014,Lucillia,F,100,10,0,10
2014,Lucyann,F,100,10,0,10
2014,Lukis,M,100,0,10,10
2014,Luxe,F,100,10,0,10
2014,Luzelena,F,100,10,0,10
2014,Lycan,M,100,0,10,10
2014,Lyda,F,100,10,0,10
2014,Lynix,F,100,10,0,10
2014,Lynna,F,100,10,0,10
2014,Lynzee,F,100,10,0,10
2014,Lynzi,F,100,10,0,10
2014,Maan,M,100,0,10,10
2014,Maat,F,100,10,0,10
2014,Mabrey,F,100,10,0,10
2014,Macaria,F,100,10,0,10
2014,Mackenize,F,100,10,0,10
2014,Madasyn,F,100,10,0,10
2014,Maddeline,F,100,10,0,10
2014,Maddoxx,M,100,0,10,10
2014,Madolyn,F,100,10,0,10
2014,Madysin,F,100,10,0,10
2014,Maebel,F,100,10,0,10
2014,Magdelyn,F,100,10,0,10
2014,Magnum,M,100,0,10,10
2014,Mahmud,M,100,0,10,10
2014,Mahra,F,100,10,0,10
2014,Maico,M,100,0,10,10
2014,Maikel,M,100,0,10,10
2014,Mailin,F,100,10,0,10
2014,Mailynn,F,100,10,0,10
2014,Maizen,M,100,0,10,10
2014,Makalah,F,100,10,0,10
2014,Makayli,F,100,10,0,10
2014,Makenlie,F,100,10,0,10
2014,Makinleigh,F,100,10,0,10
2014,Makyiah,F,100,10,0,10
2014,Makyra,F,100,10,0,10
2014,Malee,F,100,10,0,10
2014,Maloni,F,100,10,0,10
2014,Malori,F,100,10,0,10
2014,Malvin,M,100,0,10,10
2014,Malya,F,100,10,0,10
2014,Manreet,F,100,10,0,10
2014,Mansoor,M,100,0,10,10
2014,Marayah,F,100,10,0,10
2014,Mariaisabel,F,100,10,0,10
2014,Mariame,F,100,10,0,10
2014,Marifer,F,100,10,0,10
2014,Marijose,F,100,10,0,10
2014,Marivel,F,100,10,0,10
2014,Markez,M,100,0,10,10
2014,Markia,F,100,10,0,10
2014,Markiya,F,100,10,0,10
2014,Marleni,F,100,10,0,10
2014,Marliyah,F,100,10,0,10
2014,Marlynn,F,100,10,0,10
2014,Martavion,M,100,0,10,10
2014,Marten,M,100,0,10,10
2014,Martino,M,100,0,10,10
2014,Maryclaire,F,100,10,0,10
2014,Maryfrances,F,100,10,0,10
2014,Maryiah,F,100,10,0,10
2014,Maryssa,F,100,10,0,10
2014,Massa,F,100,10,0,10
2014,Matheson,M,100,0,10,10
2014,Matthews,M,100,0,10,10
2014,Matylda,F,100,10,0,10
2014,Maurizio,M,100,0,10,10
2014,Maxden,M,100,0,10,10
2014,Maybrie,F,100,10,0,10
2014,Maylah,F,100,10,0,10
2014,Mayley,F,100,10,0,10
2014,Mayrani,F,100,10,0,10
2014,Maze,M,100,0,10,10
2014,Maziah,F,50,5,5,10
2014,Mazlyn,F,100,10,0,10
2014,Mckenleigh,F,100,10,0,10
2014,Mckenzye,F,100,10,0,10
2014,Mckinzee,F,100,10,0,10
2014,Meba,M,100,0,10,10
2014,Meiling,F,100,10,0,10
2014,Melat,F,100,10,0,10
2014,Melek,F,100,10,0,10
2014,Melenie,F,100,10,0,10
2014,Melis,F,100,10,0,10
2014,Meliya,F,100,10,0,10
2014,Meric,M,100,0,10,10
2014,Merly,F,100,10,0,10
2014,Mery,F,100,10,0,10
2014,Micco,M,100,0,10,10
2014,Michaelah,F,100,10,0,10
2014,Michaelanthony,M,100,0,10,10
2014,Mickie,F,100,10,0,10
2014,Mico,M,100,0,10,10
2014,Midas,M,100,0,10,10
2014,Mikaya,F,100,10,0,10
2014,Mikayah,F,100,10,0,10
2014,Mikenzy,F,100,10,0,10
2014,Mikiya,F,100,10,0,10
2014,Mikolaj,M,100,0,10,10
2014,Milanie,F,100,10,0,10
2014,Milanna,F,100,10,0,10
2014,Milany,F,100,10,0,10
2014,Mileigh,F,100,10,0,10
2014,Mili,F,100,10,0,10
2014,Miliah,F,100,10,0,10
2014,Milianna,F,100,10,0,10
2014,Mindel,F,100,10,0,10
2014,Mishelle,F,100,10,0,10
2014,Mithran,M,100,0,10,10
2014,Mohid,M,100,0,10,10
2014,Moishy,M,100,0,10,10
2014,Moncerrat,F,100,10,0,10
2014,Montavious,M,100,0,10,10
2014,Montel,M,100,0,10,10
2014,Moroni,M,100,0,10,10
2014,Moyinoluwa,F,100,10,0,10
2014,Muneeb,M,100,0,10,10
2014,Muneer,M,100,0,10,10
2014,Munirah,F,100,10,0,10
2014,My,F,100,10,0,10
2014,Myelle,F,100,10,0,10
2014,Mykael,M,100,0,10,10
2014,Mykiah,F,100,10,0,10
2014,Nabeeha,F,100,10,0,10
2014,Nadra,F,100,10,0,10
2014,Naeemah,F,100,10,0,10
2014,Naftula,M,100,0,10,10
2014,Nahia,F,100,10,0,10
2014,Nalin,M,100,0,10,10
2014,Nameer,M,100,0,10,10
2014,Nanami,F,100,10,0,10
2014,Nanea,F,100,10,0,10
2014,Naoki,M,100,0,10,10
2014,Nareh,F,100,10,0,10
2014,Naria,F,100,10,0,10
2014,Nasim,F,50,5,5,10
2014,Nasro,F,100,10,0,10
2014,Natale,F,50,5,5,10
2014,Navarro,M,100,0,10,10
2014,Nazari,F,50,5,5,10
2014,Neaveh,F,100,10,0,10
2014,Neelah,F,100,10,0,10
2014,Nehemie,F,100,10,0,10
2014,Nehemiyah,M,100,0,10,10
2014,Nelle,F,100,10,0,10
2014,Nesiah,F,100,10,0,10
2014,Nessiah,F,100,10,0,10
2014,Nesta,M,100,0,10,10
2014,Netanel,M,100,0,10,10
2014,Nevah,F,100,10,0,10
2014,Neya,F,100,10,0,10
2014,Nielle,F,100,10,0,10
2014,Niema,F,100,10,0,10
2014,Nigeria,F,100,10,0,10
2014,Niguel,M,100,0,10,10
2014,Nikky,F,100,10,0,10
2014,Nimo,F,100,10,0,10
2014,Nishanth,M,100,0,10,10
2014,Nishtha,F,100,10,0,10
2014,Nixen,M,100,0,10,10
2014,Nneoma,F,100,10,0,10
2014,Nohea,F,100,10,0,10
2014,Nohelia,F,100,10,0,10
2014,Nollie,F,100,10,0,10
2014,Novalyn,F,100,10,0,10
2014,Nusaiba,F,100,10,0,10
2014,Nusayba,F,100,10,0,10
2014,Nyeema,F,100,10,0,10
2014,Nylen,M,100,0,10,10
2014,Nzuri,F,100,10,0,10
2014,Oceanna,F,100,10,0,10
2014,Olajuwon,M,100,0,10,10
2014,Oluwajomiloju,F,100,10,0,10
2014,Oluwaseun,M,100,0,10,10
2014,Oluwateniola,F,100,10,0,10
2014,Ondine,F,100,10,0,10
2014,Oralia,F,100,10,0,10
2014,Orren,M,100,0,10,10
2014,Oseas,M,100,0,10,10
2014,Oshen,M,100,0,10,10
2014,Oslo,M,100,0,10,10
2014,Otilia,F,100,10,0,10
2014,Paeyton,F,100,10,0,10
2014,Parke,M,100,0,10,10
2014,Parley,M,100,0,10,10
2014,Parneet,F,100,10,0,10
2014,Pate,M,100,0,10,10
2014,Payzley,F,100,10,0,10
2014,Penelopi,F,100,10,0,10
2014,Pernell,M,100,0,10,10
2014,Persephonie,F,100,10,0,10
2014,Peterson,M,100,0,10,10
2014,Philopater,M,100,0,10,10
2014,Pio,M,100,0,10,10
2014,Piotr,M,100,0,10,10
2014,Pooja,F,100,10,0,10
2014,Powell,M,100,0,10,10
2014,Prabhav,M,100,0,10,10
2014,Prairie,F,100,10,0,10
2014,Prakriti,F,100,10,0,10
2014,Prapti,F,100,10,0,10
2014,Prosper,M,100,0,10,10
2014,Psalm,M,100,0,10,10
2014,Quinnton,M,100,0,10,10
2014,Quint,M,100,0,10,10
2014,Quintez,M,100,0,10,10
2014,Radin,M,100,0,10,10
2014,Rahima,F,100,10,0,10
2014,Rahm,M,100,0,10,10
2014,Rahsaan,M,100,0,10,10
2014,Rainie,F,100,10,0,10
2014,Raissa,F,100,10,0,10
2014,Raiven,F,100,10,0,10
2014,Raiyah,F,100,10,0,10
2014,Ramadan,M,100,0,10,10
2014,Ramani,F,100,10,0,10
2014,Ramata,F,100,10,0,10
2014,Ramere,M,100,0,10,10
2014,Ramesses,M,100,0,10,10
2014,Ramin,M,100,0,10,10
2014,Ranbir,M,100,0,10,10
2014,Randen,M,100,0,10,10
2014,Raphaela,F,100,10,0,10
2014,Rasheen,M,100,0,10,10
2014,Reata,F,100,10,0,10
2014,Reia,F,100,10,0,10
2014,Reilynn,F,100,10,0,10
2014,Reizy,F,100,10,0,10
2014,Remo,M,100,0,10,10
2014,Renesme,F,100,10,0,10
2014,Rhegan,F,100,10,0,10
2014,Rhemi,F,100,10,0,10
2014,Rhia,F,100,10,0,10
2014,Rhilee,F,100,10,0,10
2014,Rhilyn,F,100,10,0,10
2014,Riham,F,100,10,0,10
2014,Rishon,M,100,0,10,10
2014,Riyana,F,100,10,0,10
2014,Roddy,M,100,0,10,10
2014,Rodriquez,M,100,0,10,10
2014,Rogen,M,100,0,10,10
2014,Rollins,M,100,0,10,10
2014,Romaisa,F,100,10,0,10
2014,Romulo,M,100,0,10,10
2014,Ronith,M,100,0,10,10
2014,Ronon,M,100,0,10,10
2014,Rosalea,F,100,10,0,10
2014,Rosana,F,100,10,0,10
2014,Rosary,F,100,10,0,10
2014,Rosealee,F,100,10,0,10
2014,Rosibel,F,100,10,0,10
2014,Roslin,F,100,10,0,10
2014,Rulon,M,100,0,10,10
2014,Ruweyda,F,100,10,0,10
2014,Ryheem,M,100,0,10,10
2014,Rylenn,F,100,10,0,10
2014,Ryman,M,100,0,10,10
2014,Rynn,F,100,10,0,10
2014,Ryzen,M,100,0,10,10
2014,Saber,M,100,0,10,10
2014,Sabiha,F,100,10,0,10
2014,Sabriel,F,50,5,5,10
2014,Sabriya,F,100,10,0,10
2014,Sadaf,F,100,10,0,10
2014,Sadiemae,F,100,10,0,10
2014,Sadiyah,F,100,10,0,10
2014,Saesha,F,100,10,0,10
2014,Safi,M,100,0,10,10
2014,Safir,M,100,0,10,10
2014,Sagal,F,100,10,0,10
2014,Sahej,F,50,5,5,10
2014,Sahily,F,100,10,0,10
2014,Saia,F,100,10,0,10
2014,Sajid,M,100,0,10,10
2014,Sal,M,100,0,10,10
2014,Salima,F,100,10,0,10
2014,Saloma,F,100,10,0,10
2014,Samhitha,F,100,10,0,10
2014,Samil,M,100,0,10,10
2014,Samuell,M,100,0,10,10
2014,San,M,100,0,10,10
2014,Sanah,F,100,10,0,10
2014,Sanari,F,100,10,0,10
2014,Sanii,F,100,10,0,10
2014,Sanika,F,100,10,0,10
2014,Sanna,F,100,10,0,10
2014,Sanskriti,F,100,10,0,10
2014,Sanvika,F,100,10,0,10
2014,Sanyla,F,100,10,0,10
2014,Saquan,M,100,0,10,10
2014,Sarabella,F,100,10,0,10
2014,Sarahann,F,100,10,0,10
2014,Saraih,F,100,10,0,10
2014,Saranya,F,100,10,0,10
2014,Saraphina,F,100,10,0,10
2014,Sarika,F,100,10,0,10
2014,Sarinity,F,100,10,0,10
2014,Sarya,F,100,10,0,10
2014,Saryiah,F,100,10,0,10
2014,Saverio,M,100,0,10,10
2014,Savino,M,100,0,10,10
2014,Saw,M,100,0,10,10
2014,Scarlettrose,F,100,10,0,10
2014,Seidy,F,100,10,0,10
2014,Selenia,F,100,10,0,10
2014,Senay,M,100,0,10,10
2014,Sevin,M,100,0,10,10
2014,Shah,M,100,0,10,10
2014,Shakeem,M,100,0,10,10
2014,Shakil,M,100,0,10,10
2014,Shama,F,100,10,0,10
2014,Shamaya,F,100,10,0,10
2014,Sharleen,F,100,10,0,10
2014,Sharrod,M,100,0,10,10
2014,Shavon,F,50,5,5,10
2014,Shayn,M,100,0,10,10
2014,Shedrick,M,100,0,10,10
2014,Sheina,F,100,10,0,10
2014,Shelia,F,100,10,0,10
2014,Sheppard,M,100,0,10,10
2014,Sherri,F,100,10,0,10
2014,Sherwin,M,100,0,10,10
2014,Sheyli,F,100,10,0,10
2014,Shila,F,100,10,0,10
2014,Shivan,M,100,0,10,10
2014,Shiza,F,100,10,0,10
2014,Shresta,F,100,10,0,10
2014,Shruthi,F,100,10,0,10
2014,Shuaib,M,100,0,10,10
2014,Shun,M,100,0,10,10
2014,Shyheim,M,100,0,10,10
2014,Siddarth,M,100,0,10,10
2014,Sierrah,F,100,10,0,10
2014,Siomara,F,100,10,0,10
2014,Sisira,F,100,10,0,10
2014,Sitara,F,100,10,0,10
2014,Skiler,F,100,10,0,10
2014,Slayden,M,100,0,10,10
2014,Snigdha,F,100,10,0,10
2014,Sochi,F,100,10,0,10
2014,Socorro,F,100,10,0,10
2014,Socrates,M,100,0,10,10
2014,Sondra,F,100,10,0,10
2014,Sophianna,F,100,10,0,10
2014,Sophiarose,F,100,10,0,10
2014,Sorayah,F,100,10,0,10
2014,Soriah,F,100,10,0,10
2014,Soryn,F,50,5,5,10
2014,Spiro,M,100,0,10,10
2014,Sreya,F,100,10,0,10
2014,Srihitha,F,100,10,0,10
2014,Srija,F,100,10,0,10
2014,Stafford,M,100,0,10,10
2014,Stan,M,100,0,10,10
2014,Steffan,M,100,0,10,10
2014,Stephenie,F,100,10,0,10
2014,Stevee,F,100,10,0,10
2014,Stihl,M,100,0,10,10
2014,Stormee,F,100,10,0,10
2014,Subhana,F,100,10,0,10
2014,Suheb,M,100,0,10,10
2014,Suheyla,F,100,10,0,10
2014,Sulema,F,100,10,0,10
2014,Sumer,F,100,10,0,10
2014,Summerlyn,F,100,10,0,10
2014,Supriya,F,100,10,0,10
2014,Symere,M,100,0,10,10
2014,Syriana,F,100,10,0,10
2014,Taber,F,50,5,5,10
2014,Tabias,M,100,0,10,10
2014,Tailor,F,100,10,0,10
2014,Taiwo,F,50,5,5,10
2014,Taiya,F,100,10,0,10
2014,Taiyari,F,100,10,0,10
2014,Takeo,M,100,0,10,10
2014,Takia,F,100,10,0,10
2014,Takiya,F,100,10,0,10
2014,Takota,M,100,0,10,10
2014,Tallula,F,100,10,0,10
2014,Tamaria,F,100,10,0,10
2014,Tanis,M,100,0,10,10
2014,Tansy,F,100,10,0,10
2014,Tanylah,F,100,10,0,10
2014,Taquan,M,100,0,10,10
2014,Tarini,F,100,10,0,10
2014,Tawny,F,100,10,0,10
2014,Taylour,F,100,10,0,10
2014,Tejasvi,F,100,10,0,10
2014,Tekoa,M,100,0,10,10
2014,Temple,F,100,10,0,10
2014,Teniola,F,100,10,0,10
2014,Teodora,F,100,10,0,10
2014,Terance,M,100,0,10,10
2014,Terriah,F,100,10,0,10
2014,Teshawn,M,100,0,10,10
2014,Teyla,F,100,10,0,10
2014,Teyonna,F,100,10,0,10
2014,Thia,F,100,10,0,10
2014,Thierno,M,100,0,10,10
2014,Thomson,M,100,0,10,10
2014,Thoran,M,100,0,10,10
2014,Thorian,M,100,0,10,10
2014,Thorne,M,100,0,10,10
2014,Thorsten,M,100,0,10,10
2014,Tilda,F,100,10,0,10
2014,Tilia,F,100,10,0,10
2014,Timberlee,F,100,10,0,10
2014,Tinzlee,F,100,10,0,10
2014,Tipton,M,100,0,10,10
2014,Tivon,M,100,0,10,10
2014,Toluwanimi,F,100,10,0,10
2014,Toriana,F,100,10,0,10
2014,Torry,M,100,0,10,10
2014,Trayveon,M,100,0,10,10
2014,Treyveon,M,100,0,10,10
2014,Trusten,M,100,0,10,10
2014,Trygve,M,100,0,10,10
2014,Tynleigh,F,100,10,0,10
2014,Tynslee,F,100,10,0,10
2014,Tyquez,M,100,0,10,10
2014,Tyr,M,100,0,10,10
2014,Tyreece,M,100,0,10,10
2014,Tyrelle,M,100,0,10,10
2014,Uday,M,100,0,10,10
2014,Uziah,M,100,0,10,10
2014,Vadhir,M,100,0,10,10
2014,Vallerie,F,100,10,0,10
2014,Valley,F,100,10,0,10
2014,Vanden,M,100,0,10,10
2014,Venba,F,100,10,0,10
2014,Venezia,F,100,10,0,10
2014,Vi,F,100,10,0,10
2014,Vianka,F,100,10,0,10
2014,Victoriano,M,100,0,10,10
2014,Viha,F,100,10,0,10
2014,Vincy,F,100,10,0,10
2014,Vinicio,M,100,0,10,10
2014,Viraat,M,100,0,10,10
2014,Vitor,M,100,0,10,10
2014,Vitoria,F,100,10,0,10
2014,Viya,F,100,10,0,10
2014,Vrinda,F,100,10,0,10
2014,Wael,M,100,0,10,10
2014,Wassim,M,100,0,10,10
2014,Wayden,M,100,0,10,10
2014,Waylyn,M,100,0,10,10
2014,Westlee,M,100,0,10,10
2014,Whalen,M,100,0,10,10
2014,Wilhemina,F,100,10,0,10
2014,Winn,M,100,0,10,10
2014,Woody,M,100,0,10,10
2014,Wyeth,M,100,0,10,10
2014,Xabi,M,100,0,10,10
2014,Xachary,M,100,0,10,10
2014,Xaidyn,M,100,0,10,10
2014,Xaviar,M,100,0,10,10
2014,Xayla,F,100,10,0,10
2014,Xhaiden,M,100,0,10,10
2014,Yaden,M,100,0,10,10
2014,Yago,M,100,0,10,10
2014,Yahav,F,50,5,5,10
2014,Yarah,F,100,10,0,10
2014,Yaremi,F,100,10,0,10
2014,Yarieliz,F,100,10,0,10
2014,Yeila,F,100,10,0,10
2014,Yeira,F,100,10,0,10
2014,Yesly,F,100,10,0,10
2014,Yetzael,M,100,0,10,10
2014,Yiannis,M,100,0,10,10
2014,Yiran,F,50,5,5,10
2014,Yitzhak,M,100,0,10,10
2014,Yixuan,F,100,10,0,10
2014,Yorley,F,100,10,0,10
2014,Yosgart,M,100,0,10,10
2014,Yousra,F,100,10,0,10
2014,Yuval,M,100,0,10,10
2014,Zadrian,M,100,0,10,10
2014,Zaevion,M,100,0,10,10
2014,Zafir,M,100,0,10,10
2014,Zaharah,F,100,10,0,10
2014,Zahki,M,100,0,10,10
2014,Zaidy,F,100,10,0,10
2014,Zaim,M,100,0,10,10
2014,Zakariye,M,100,0,10,10
2014,Zakariyya,M,100,0,10,10
2014,Zakhia,F,100,10,0,10
2014,Zakyra,F,100,10,0,10
2014,Zaliah,F,100,10,0,10
2014,Zamariah,F,100,10,0,10
2014,Zamia,F,100,10,0,10
2014,Zanai,F,100,10,0,10
2014,Zareen,F,100,10,0,10
2014,Zarian,M,100,0,10,10
2014,Zaryan,M,100,0,10,10
2014,Zaryn,F,50,5,5,10
2014,Zaxton,M,100,0,10,10
2014,Zay,M,100,0,10,10
2014,Zayvin,M,100,0,10,10
2014,Zeal,M,100,0,10,10
2014,Zeba,F,100,10,0,10
2014,Zeenat,F,100,10,0,10
2014,Zeidy,F,100,10,0,10
2014,Zeniya,F,100,10,0,10
2014,Zeynab,F,100,10,0,10
2014,Zoeigh,F,100,10,0,10
2014,Zoeyann,F,100,10,0,10
2014,Zohair,M,100,0,10,10
2014,Zolee,F,100,10,0,10
2014,Zully,F,100,10,0,10
2014,Zurii,F,100,10,0,10
2014,Zyquan,M,100,0,10,10
2014,Zyrus,M,100,0,10,10
2014,Aabha,F,100,9,0,9
2014,Aadith,M,100,0,9,9
2014,Aadon,M,100,0,9,9
2014,Aaidyn,M,100,0,9,9
2014,Aakriti,F,100,9,0,9
2014,Aala,F,100,9,0,9
2014,Aalani,F,100,9,0,9
2014,Aalayna,F,100,9,0,9
2014,Aamna,F,100,9,0,9
2014,Aarianna,F,100,9,0,9
2014,Aarib,M,100,0,9,9
2014,Aariyana,F,100,9,0,9
2014,Aarnavi,F,100,9,0,9
2014,Aarsh,M,100,0,9,9
2014,Aaryanna,F,100,9,0,9
2014,Aasia,F,100,9,0,9
2014,Aayana,F,100,9,0,9
2014,Aaylah,F,100,9,0,9
2014,Aayliah,F,100,9,0,9
2014,Aaziyah,F,100,9,0,9
2014,Abbygayle,F,100,9,0,9
2014,Abdel,M,100,0,9,9
2014,Abdihafid,M,100,0,9,9
2014,Abdishakur,M,100,0,9,9
2014,Abdulkarim,M,100,0,9,9
2014,Abeni,F,100,9,0,9
2014,Abigaile,F,100,9,0,9
2014,Abrina,F,100,9,0,9
2014,Acelin,M,100,0,9,9
2014,Acsa,F,100,9,0,9
2014,Adagio,M,100,0,9,9
2014,Adalay,F,100,9,0,9
2014,Adalida,F,100,9,0,9
2014,Adalys,F,100,9,0,9
2014,Addley,F,100,9,0,9
2014,Adeliah,F,100,9,0,9
2014,Adena,F,100,9,0,9
2014,Aderinsola,F,100,9,0,9
2014,Adianna,F,100,9,0,9
2014,Adilyne,F,100,9,0,9
2014,Adilynne,F,100,9,0,9
2014,Adir,M,100,0,9,9
2014,Adit,M,100,0,9,9
2014,Adwita,F,100,9,0,9
2014,Adylen,F,100,9,0,9
2014,Adylynn,F,100,9,0,9
2014,Aerie,F,100,9,0,9
2014,Aerik,M,100,0,9,9
2014,Aerilynn,F,100,9,0,9
2014,Agape,F,100,9,0,9
2014,Ahking,M,100,0,9,9
2014,Ahmadou,M,100,0,9,9
2014,Ahmar,M,100,0,9,9
2014,Ahmarie,F,100,9,0,9
2014,Ahmyra,F,100,9,0,9
2014,Ahrian,M,100,0,9,9
2014,Ahriya,F,100,9,0,9
2014,Ahriyah,F,100,9,0,9
2014,Aily,F,100,9,0,9
2014,Aima,F,100,9,0,9
2014,Aimy,F,100,9,0,9
2014,Aishi,F,100,9,0,9
2014,Aislee,F,100,9,0,9
2014,Aivy,F,100,9,0,9
2014,Aiyannah,F,100,9,0,9
2014,Ajit,M,100,0,9,9
2014,Akbar,M,100,0,9,9
2014,Akela,F,100,9,0,9
2014,Akilan,M,100,0,9,9
2014,Akosua,F,100,9,0,9
2014,Akshath,M,100,0,9,9
2014,Akua,F,100,9,0,9
2014,Akul,M,100,0,9,9
2014,Alaeyah,F,100,9,0,9
2014,Aland,M,100,0,9,9
2014,Alanea,F,100,9,0,9
2014,Alanii,F,100,9,0,9
2014,Alante,M,100,0,9,9
2014,Alaria,F,100,9,0,9
2014,Alayzia,F,100,9,0,9
2014,Alcides,M,100,0,9,9
2014,Alekhya,F,100,9,0,9
2014,Aleksei,M,100,0,9,9
2014,Alese,F,100,9,0,9
2014,Aleshka,F,100,9,0,9
2014,Alexsandro,M,100,0,9,9
2014,Alexxia,F,100,9,0,9
2014,Aleynah,F,100,9,0,9
2014,Alianys,F,100,9,0,9
2014,Alic,M,100,0,9,9
2014,Alila,F,100,9,0,9
2014,Alita,F,100,9,0,9
2014,Alizayah,F,100,9,0,9
2014,Alliannah,F,100,9,0,9
2014,Allis,F,100,9,0,9
2014,Allona,F,100,9,0,9
2014,Allyse,F,100,9,0,9
2014,Aluna,F,100,9,0,9
2014,Alveena,F,100,9,0,9
2014,Alyaan,M,100,0,9,9
2014,Alyn,F,100,9,0,9
2014,Alyss,F,100,9,0,9
2014,Alyus,M,100,0,9,9
2014,Alyzabeth,F,100,9,0,9
2014,Amad,M,100,0,9,9
2014,Amana,F,100,9,0,9
2014,Amariz,F,100,9,0,9
2014,Amaryah,F,100,9,0,9
2014,Amberleigh,F,100,9,0,9
2014,Amberley,F,100,9,0,9
2014,Ambrea,F,100,9,0,9
2014,Ambrosia,F,100,9,0,9
2014,Ameah,F,100,9,0,9
2014,Ameliyah,F,100,9,0,9
2014,Amenah,F,100,9,0,9
2014,Ameriyah,F,100,9,0,9
2014,Amiayah,F,100,9,0,9
2014,Amiere,M,100,0,9,9
2014,Amiliano,M,100,0,9,9
2014,Amiliya,F,100,9,0,9
2014,Amillya,F,100,9,0,9
2014,Amiylah,F,100,9,0,9
2014,Amiyrah,F,100,9,0,9
2014,Ammi,F,100,9,0,9
2014,Amod,M,100,0,9,9
2014,Amrie,F,100,9,0,9
2014,Amrom,M,100,0,9,9
2014,Amyna,F,100,9,0,9
2014,Amyrie,F,100,9,0,9
2014,Anab,F,100,9,0,9
2014,Anabrenda,F,100,9,0,9
2014,Anael,F,100,9,0,9
2014,Anaja,F,100,9,0,9
2014,Anaka,F,100,9,0,9
2014,Analah,F,100,9,0,9
2014,Analena,F,100,9,0,9
2014,Anamari,F,100,9,0,9
2014,Anayaa,F,100,9,0,9
2014,Anayiah,F,100,9,0,9
2014,Anelisse,F,100,9,0,9
2014,Anelle,F,100,9,0,9
2014,Anett,F,100,9,0,9
2014,Angelgabriel,M,100,0,9,9
2014,Angelinne,F,100,9,0,9
2014,Angelmarie,F,100,9,0,9
2014,Aniel,M,100,0,9,9
2014,Anir,M,100,0,9,9
2014,Annaliah,F,100,9,0,9
2014,Annaliz,F,100,9,0,9
2014,Anthea,F,100,9,0,9
2014,Anubis,M,100,0,9,9
2014,Anush,M,100,0,9,9
2014,Anvay,M,100,0,9,9
2014,Anwitha,F,100,9,0,9
2014,Anzleigh,F,100,9,0,9
2014,Aodhan,M,100,0,9,9
2014,Aonesty,F,100,9,0,9
2014,Apollos,M,100,0,9,9
2014,Apphia,F,100,9,0,9
2014,Aqsa,F,100,9,0,9
2014,Arafat,M,100,0,9,9
2014,Araiza,F,100,9,0,9
2014,Arata,M,100,0,9,9
2014,Arber,M,100,0,9,9
2014,Areanna,F,100,9,0,9
2014,Areg,M,100,0,9,9
2014,Arica,F,100,9,0,9
2014,Arick,M,100,0,9,9
2014,Arietta,F,100,9,0,9
2014,Aristides,M,100,0,9,9
2014,Aritza,F,100,9,0,9
2014,Arlind,M,100,0,9,9
2014,Arlis,M,100,0,9,9
2014,Armany,M,100,0,9,9
2014,Armel,M,100,0,9,9
2014,Arnaldo,M,100,0,9,9
2014,Arriella,F,100,9,0,9
2014,Arsal,M,100,0,9,9
2014,Artie,M,100,0,9,9
2014,Arwin,M,100,0,9,9
2014,Aryanne,F,100,9,0,9
2014,Aryiana,F,100,9,0,9
2014,Astraea,F,100,9,0,9
2014,Atiyah,F,100,9,0,9
2014,Atlanta,F,100,9,0,9
2014,Aubreelynn,F,100,9,0,9
2014,Aubrianne,F,100,9,0,9
2014,Audrea,F,100,9,0,9
2014,Audreyann,F,100,9,0,9
2014,Audryana,F,100,9,0,9
2014,Audyn,F,100,9,0,9
2014,Aundraya,F,100,9,0,9
2014,Auriah,F,100,9,0,9
2014,Avaeh,F,100,9,0,9
2014,Avagail,F,100,9,0,9
2014,Avangelina,F,100,9,0,9
2014,Aveion,M,100,0,9,9
2014,Avelardo,M,100,0,9,9
2014,Aveleen,F,100,9,0,9
2014,Averleigh,F,100,9,0,9
2014,Avianah,F,100,9,0,9
2014,Avienda,F,100,9,0,9
2014,Aviyanna,F,100,9,0,9
2014,Avontae,M,100,0,9,9
2014,Avorie,F,100,9,0,9
2014,Avyon,M,100,0,9,9
2014,Axiel,M,100,0,9,9
2014,Ayaz,M,100,0,9,9
2014,Aylana,F,100,9,0,9
2014,Aylina,F,100,9,0,9
2014,Aylyn,F,100,9,0,9
2014,Ayrah,F,100,9,0,9
2014,Ayyan,M,100,0,9,9
2014,Aza,F,100,9,0,9
2014,Azalynn,F,100,9,0,9
2014,Azarie,F,100,9,0,9
2014,Azarius,M,100,0,9,9
2014,Azarria,F,100,9,0,9
2014,Azayvion,M,100,0,9,9
2014,Azizah,F,100,9,0,9
2014,Azlaan,M,100,0,9,9
2014,Baird,M,100,0,9,9
2014,Bairon,M,100,0,9,9
2014,Baldomero,M,100,0,9,9
2014,Barak,M,100,0,9,9
2014,Bassel,M,100,0,9,9
2014,Bassheva,F,100,9,0,9
2014,Bassy,F,100,9,0,9
2014,Batu,M,100,0,9,9
2014,Bayah,F,100,9,0,9
2014,Baylon,M,100,0,9,9
2014,Baze,M,100,0,9,9
2014,Bearett,M,100,0,9,9
2014,Beautifull,F,100,9,0,9
2014,Belal,M,100,0,9,9
2014,Bell,F,100,9,0,9
2014,Bellatrix,F,100,9,0,9
2014,Belmin,M,100,0,9,9
2014,Benelli,F,100,9,0,9
2014,Berel,M,100,0,9,9
2014,Bessy,F,100,9,0,9
2014,Betul,F,100,9,0,9
2014,Betzabe,F,100,9,0,9
2014,Betzabeth,F,100,9,0,9
2014,Beyza,F,100,9,0,9
2014,Biagio,M,100,0,9,9
2014,Bijan,M,100,0,9,9
2014,Biruk,M,100,0,9,9
2014,Bishoy,M,100,0,9,9
2014,Blaiden,M,100,0,9,9
2014,Blayde,M,100,0,9,9
2014,Blazen,M,100,0,9,9
2014,Blessen,F,100,9,0,9
2014,Bodin,M,100,0,9,9
2014,Bohden,M,100,0,9,9
2014,Bond,M,100,0,9,9
2014,Bowyn,M,100,0,9,9
2014,Bradin,M,100,0,9,9
2014,Brailen,M,100,0,9,9
2014,Branston,M,100,0,9,9
2014,Brantson,M,100,0,9,9
2014,Brason,M,100,0,9,9
2014,Braylea,F,100,9,0,9
2014,Bre,F,100,9,0,9
2014,Breale,F,100,9,0,9
2014,Breena,F,100,9,0,9
2014,Breindy,F,100,9,0,9
2014,Breland,M,100,0,9,9
2014,Bretley,M,100,0,9,9
2014,Breyah,F,100,9,0,9
2014,Breyonna,F,100,9,0,9
2014,Breyton,M,100,0,9,9
2014,Bricia,F,100,9,0,9
2014,Brielyn,F,100,9,0,9
2014,Briggston,M,100,0,9,9
2014,Brigit,F,100,9,0,9
2014,Brinson,M,100,0,9,9
2014,Briona,F,100,9,0,9
2014,Brittanie,F,100,9,0,9
2014,Brycelynn,F,100,9,0,9
2014,Brydan,M,100,0,9,9
2014,Brynlei,F,100,9,0,9
2014,Bryonna,F,100,9,0,9
2014,Bryony,F,100,9,0,9
2014,Burak,M,100,0,9,9
2014,Caeleb,M,100,0,9,9
2014,Caeley,F,100,9,0,9
2014,California,F,100,9,0,9
2014,Calii,F,100,9,0,9
2014,Calirae,F,100,9,0,9
2014,Calirose,F,100,9,0,9
2014,Calisi,F,100,9,0,9
2014,Callaghan,M,100,0,9,9
2014,Calogero,M,100,0,9,9
2014,Camie,F,100,9,0,9
2014,Candido,M,100,0,9,9
2014,Capree,F,100,9,0,9
2014,Carbon,M,100,0,9,9
2014,Carman,F,100,9,0,9
2014,Carwyn,M,100,0,9,9
2014,Casanova,M,100,0,9,9
2014,Catalea,F,100,9,0,9
2014,Catalena,F,100,9,0,9
2014,Cathalina,F,100,9,0,9
2014,Cathrine,F,100,9,0,9
2014,Catrina,F,100,9,0,9
2014,Caymen,M,100,0,9,9
2014,Cayton,M,100,0,9,9
2014,Cecilee,F,100,9,0,9
2014,Cedella,F,100,9,0,9
2014,Ceili,F,100,9,0,9
2014,Chandon,M,100,0,9,9
2014,Chanley,F,100,9,0,9
2014,Chaos,M,100,0,9,9
2014,Charise,F,100,9,0,9
2014,Chaske,M,100,0,9,9
2014,Chaylee,F,100,9,0,9
2014,Cherrish,F,100,9,0,9
2014,Chesnee,F,100,9,0,9
2014,Cheylynn,F,100,9,0,9
2014,Chinmayi,F,100,9,0,9
2014,Christel,F,100,9,0,9
2014,Ciani,F,100,9,0,9
2014,Ciarra,F,100,9,0,9
2014,Ciella,F,100,9,0,9
2014,Cionna,F,100,9,0,9
2014,Clairabelle,F,100,9,0,9
2014,Clayten,M,100,0,9,9
2014,Columbus,M,100,0,9,9
2014,Copelynn,F,100,9,0,9
2014,Coralei,F,100,9,0,9
2014,Cordale,M,100,0,9,9
2014,Corine,F,100,9,0,9
2014,Corion,M,100,0,9,9
2014,Corry,M,100,0,9,9
2014,Couper,M,100,0,9,9
2014,Creedon,M,100,0,9,9
2014,Cressida,F,100,9,0,9
2014,Crewe,M,100,0,9,9
2014,Crystel,F,100,9,0,9
2014,Crystianna,F,100,9,0,9
2014,Cylan,M,100,0,9,9
2014,Cyson,M,100,0,9,9
2014,Dagmawi,M,100,0,9,9
2014,Dago,M,100,0,9,9
2014,Daianna,F,100,9,0,9
2014,Daiya,F,100,9,0,9
2014,Dajah,F,100,9,0,9
2014,Dalanie,F,100,9,0,9
2014,Dalayna,F,100,9,0,9
2014,Daleysha,F,100,9,0,9
2014,Daleyzah,F,100,9,0,9
2014,Dalina,F,100,9,0,9
2014,Daly,F,100,9,0,9
2014,Dalyah,F,100,9,0,9
2014,Dalyce,F,100,9,0,9
2014,Damyan,M,100,0,9,9
2014,Damyiah,F,100,9,0,9
2014,Danali,F,100,9,0,9
2014,Daneil,M,100,0,9,9
2014,Dangela,F,100,9,0,9
2014,Daniele,M,100,0,9,9
2014,Danil,M,100,0,9,9
2014,Danissa,F,100,9,0,9
2014,Danyah,F,100,9,0,9
2014,Danyal,M,100,0,9,9
2014,Danyell,F,100,9,0,9
2014,Danzig,M,100,0,9,9
2014,Daphna,F,100,9,0,9
2014,Darlynn,F,100,9,0,9
2014,Dartanian,M,100,0,9,9
2014,Daryna,F,100,9,0,9
2014,Daveigh,F,100,9,0,9
2014,Daveney,F,100,9,0,9
2014,Dawt,F,100,9,0,9
2014,Daxen,M,100,0,9,9
2014,Dayanni,F,100,9,0,9
2014,Dayceon,M,100,0,9,9
2014,Daysen,M,100,0,9,9
2014,Daziah,F,100,9,0,9
2014,Deakin,M,100,0,9,9
2014,Deangela,F,100,9,0,9
2014,Deashia,F,100,9,0,9
2014,Decari,M,100,0,9,9
2014,Decklen,M,100,0,9,9
2014,Deepika,F,100,9,0,9
2014,Dekhari,M,100,0,9,9
2014,Delanny,F,100,9,0,9
2014,Delayne,F,100,9,0,9
2014,Delroy,M,100,0,9,9
2014,Dema,F,100,9,0,9
2014,Demetrious,M,100,0,9,9
2014,Demonta,M,100,0,9,9
2014,Deniro,M,100,0,9,9
2014,Denzil,M,100,0,9,9
2014,Deona,F,100,9,0,9
2014,Deontre,M,100,0,9,9
2014,Derric,M,100,0,9,9
2014,Desarae,F,100,9,0,9
2014,Desirea,F,100,9,0,9
2014,Devaun,M,100,0,9,9
2014,Devory,F,100,9,0,9
2014,Deyana,F,100,9,0,9
2014,Deyani,F,100,9,0,9
2014,Deyonna,F,100,9,0,9
2014,Deyton,M,100,0,9,9
2014,Dezmin,M,100,0,9,9
2014,Dhillon,M,100,0,9,9
2014,Dhrithi,F,100,9,0,9
2014,Dhruti,F,100,9,0,9
2014,Diago,M,100,0,9,9
2014,Dim,F,100,9,0,9
2014,Dionysios,M,100,0,9,9
2014,Dmani,M,100,0,9,9
2014,Dom,M,100,0,9,9
2014,Dona,F,100,9,0,9
2014,Donatella,F,100,9,0,9
2014,Draeden,M,100,0,9,9
2014,Drayah,F,100,9,0,9
2014,Drayce,M,100,0,9,9
2014,Draycen,M,100,0,9,9
2014,Drequan,M,100,0,9,9
2014,Dunia,F,100,9,0,9
2014,Duron,M,100,0,9,9
2014,Dutchess,F,100,9,0,9
2014,Dvonte,M,100,0,9,9
2014,Dyamond,F,100,9,0,9
2014,Dylynn,F,100,9,0,9
2014,Eames,M,100,0,9,9
2014,Eberardo,M,100,0,9,9
2014,Ebrima,M,100,0,9,9
2014,Edahi,M,100,0,9,9
2014,Edgard,M,100,0,9,9
2014,Edmar,M,100,0,9,9
2014,Edrei,M,100,0,9,9
2014,Edyth,F,100,9,0,9
2014,Eeva,F,100,9,0,9
2014,Ege,M,100,0,9,9
2014,Egor,M,100,0,9,9
2014,Ehab,M,100,0,9,9
2014,Eilley,F,100,9,0,9
2014,Eirene,F,100,9,0,9
2014,Elaiza,F,100,9,0,9
2014,Elanora,F,100,9,0,9
2014,Eldar,M,100,0,9,9
2014,Eldridge,M,100,0,9,9
2014,Elham,F,100,9,0,9
2014,Elii,M,100,0,9,9
2014,Elion,M,100,0,9,9
2014,Eliu,M,100,0,9,9
2014,Eliz,F,100,9,0,9
2014,Elizandro,M,100,0,9,9
2014,Elkin,M,100,0,9,9
2014,Ellanie,F,100,9,0,9
2014,Ellea,F,100,9,0,9
2014,Ellenie,F,100,9,0,9
2014,Ellieann,F,100,9,0,9
2014,Elliona,F,100,9,0,9
2014,Ellisen,F,100,9,0,9
2014,Ellodie,F,100,9,0,9
2014,Elmira,F,100,9,0,9
2014,Elsey,F,100,9,0,9
2014,Elston,M,100,0,9,9
2014,Elyan,M,100,0,9,9
2014,Elyannah,F,100,9,0,9
2014,Elycia,F,100,9,0,9
2014,Emanuela,F,100,9,0,9
2014,Emera,F,100,9,0,9
2014,Emie,F,100,9,0,9
2014,Emmaclaire,F,100,9,0,9
2014,Emmajane,F,100,9,0,9
2014,Emmaleah,F,100,9,0,9
2014,Emmamarie,F,100,9,0,9
2014,Emmelina,F,100,9,0,9
2014,Emmette,M,100,0,9,9
2014,Enedina,F,100,9,0,9
2014,Enner,M,100,0,9,9
2014,Enslee,F,100,9,0,9
2014,Envi,F,100,9,0,9
2014,Ephrem,M,100,0,9,9
2014,Erikson,M,100,0,9,9
2014,Ermias,M,100,0,9,9
2014,Ernestine,F,100,9,0,9
2014,Errick,M,100,0,9,9
2014,Esly,F,100,9,0,9
2014,Essiah,M,100,0,9,9
2014,Estephania,F,100,9,0,9
2014,Estuardo,M,100,0,9,9
2014,Ethanjames,M,100,0,9,9
2014,Ettel,F,100,9,0,9
2014,Evanny,F,100,9,0,9
2014,Everlea,F,100,9,0,9
2014,Evonna,F,100,9,0,9
2014,Eyana,F,100,9,0,9
2014,Eyas,M,100,0,9,9
2014,Eylin,F,100,9,0,9
2014,Ezaiah,M,100,0,9,9
2014,Ezel,M,100,0,9,9
2014,Ezmay,F,100,9,0,9
2014,Faithmarie,F,100,9,0,9
2014,Farhiya,F,100,9,0,9
2014,Fate,F,100,9,0,9
2014,Faven,F,100,9,0,9
2014,Faylynn,F,100,9,0,9
2014,Febe,F,100,9,0,9
2014,Felisha,F,100,9,0,9
2014,Finna,F,100,9,0,9
2014,Finnbar,M,100,0,9,9
2014,Finneus,M,100,0,9,9
2014,Finnly,M,100,0,9,9
2014,Firdaus,F,100,9,0,9
2014,Florencio,M,100,0,9,9
2014,Flynt,M,100,0,9,9
2014,Francia,F,100,9,0,9
2014,Franck,M,100,0,9,9
2014,Frankee,F,100,9,0,9
2014,Frantz,M,100,0,9,9
2014,Frayda,F,100,9,0,9
2014,Frey,M,100,0,9,9
2014,Froilan,M,100,0,9,9
2014,Gabbie,F,100,9,0,9
2014,Gale,M,100,0,9,9
2014,Gamal,M,100,0,9,9
2014,Garielle,F,100,9,0,9
2014,Garrus,M,100,0,9,9
2014,Gavon,M,100,0,9,9
2014,Gavynn,M,100,0,9,9
2014,Geanna,F,100,9,0,9
2014,Genavive,F,100,9,0,9
2014,Gentri,F,100,9,0,9
2014,Georges,M,100,0,9,9
2014,Ghazi,M,100,0,9,9
2014,Giani,M,100,0,9,9
2014,Gianlucca,M,100,0,9,9
2014,Gilmer,M,100,0,9,9
2014,Ginnie,F,100,9,0,9
2014,Giorgi,M,100,0,9,9
2014,Gitel,F,100,9,0,9
2014,Giulian,M,100,0,9,9
2014,Grainger,M,100,0,9,9
2014,Graycelynn,F,100,9,0,9
2014,Graylen,M,100,0,9,9
2014,Gricelda,F,100,9,0,9
2014,Gwenneth,F,100,9,0,9
2014,Gwyn,F,100,9,0,9
2014,Haim,M,100,0,9,9
2014,Haitham,M,100,0,9,9
2014,Haloa,M,100,0,9,9
2014,Hamida,F,100,9,0,9
2014,Haniel,M,100,0,9,9
2014,Harshika,F,100,9,0,9
2014,Harshini,F,100,9,0,9
2014,Hasaan,M,100,0,9,9
2014,Haskell,M,100,0,9,9
2014,Hatem,M,100,0,9,9
2014,Hawra,F,100,9,0,9
2014,Haylin,F,100,9,0,9
2014,Haylyn,F,100,9,0,9
2014,Hazley,F,100,9,0,9
2014,Heaton,M,100,0,9,9
2014,Helaman,M,100,0,9,9
2014,Hendel,F,100,9,0,9
2014,Hendy,F,100,9,0,9
2014,Hesham,M,100,0,9,9
2014,Hila,F,100,9,0,9
2014,Hilde,F,100,9,0,9
2014,Hina,F,100,9,0,9
2014,Hoda,F,100,9,0,9
2014,Hollynn,F,100,9,0,9
2014,Hooria,F,100,9,0,9
2014,Hopelynn,F,100,9,0,9
2014,Howie,M,100,0,9,9
2014,Hughes,M,100,0,9,9
2014,Huntington,M,100,0,9,9
2014,Hyden,M,100,0,9,9
2014,Ibrohim,M,100,0,9,9
2014,Idrissa,M,100,0,9,9
2014,Iesha,F,100,9,0,9
2014,Ikeem,M,100,0,9,9
2014,Imunique,F,100,9,0,9
2014,Indianna,F,100,9,0,9
2014,Iolani,F,100,9,0,9
2014,Irelynd,F,100,9,0,9
2014,Irys,F,100,9,0,9
2014,Isaid,M,100,0,9,9
2014,Isaiha,M,100,0,9,9
2014,Ishaaq,M,100,0,9,9
2014,Isobella,F,100,9,0,9
2014,Itay,M,100,0,9,9
2014,Itzell,F,100,9,0,9
2014,Ivalee,F,100,9,0,9
2014,Izamar,F,100,9,0,9
2014,Izebella,F,100,9,0,9
2014,Izma,F,100,9,0,9
2014,Izsabella,F,100,9,0,9
2014,Izyan,M,100,0,9,9
2014,Izzie,F,100,9,0,9
2014,Jabarri,M,100,0,9,9
2014,Jabbar,M,100,0,9,9
2014,Jacai,M,100,0,9,9
2014,Jacks,M,100,0,9,9
2014,Jadeline,F,100,9,0,9
2014,Jader,M,100,0,9,9
2014,Jag,M,100,0,9,9
2014,Jahaan,M,100,0,9,9
2014,Jahaire,M,100,0,9,9
2014,Jahleah,F,100,9,0,9
2014,Jahlia,F,100,9,0,9
2014,Jahmar,M,100,0,9,9
2014,Jahmarion,M,100,0,9,9
2014,Jahmeer,M,100,0,9,9
2014,Jahnelle,F,100,9,0,9
2014,Jahsai,M,100,0,9,9
2014,Jaielle,F,100,9,0,9
2014,Jaileigh,F,100,9,0,9
2014,Jaimeson,M,100,0,9,9
2014,Jaiona,F,100,9,0,9
2014,Jairen,M,100,0,9,9
2014,Jakhia,F,100,9,0,9
2014,Jaklyn,F,100,9,0,9
2014,Jakyiah,F,100,9,0,9
2014,Jalana,F,100,9,0,9
2014,Jaleal,M,100,0,9,9
2014,Jaleyza,F,100,9,0,9
2014,Jalyiah,F,100,9,0,9
2014,Jamai,M,100,0,9,9
2014,Jamaica,F,100,9,0,9
2014,Jamarii,M,100,0,9,9
2014,Jamariya,F,100,9,0,9
2014,Jameah,F,100,9,0,9
2014,Jamen,M,100,0,9,9
2014,Jameon,M,100,0,9,9
2014,Jamiee,F,100,9,0,9
2014,Jamis,M,100,0,9,9
2014,Jamyrah,F,100,9,0,9
2014,Jandiel,M,100,0,9,9
2014,Janelis,F,100,9,0,9
2014,Janese,F,100,9,0,9
2014,Janetta,F,100,9,0,9
2014,Janisha,F,100,9,0,9
2014,Janissa,F,100,9,0,9
2014,Janthony,M,100,0,9,9
2014,Japhet,M,100,0,9,9
2014,Japleen,F,100,9,0,9
2014,Jari,M,100,0,9,9
2014,Jariana,F,100,9,0,9
2014,Jarielle,F,100,9,0,9
2014,Jaritza,F,100,9,0,9
2014,Jarvin,M,100,0,9,9
2014,Jaryah,F,100,9,0,9
2014,Jaskaran,M,100,0,9,9
2014,Jaskirat,F,100,9,0,9
2014,Jasnoor,F,100,9,0,9
2014,Javaeh,F,100,9,0,9
2014,Javarious,M,100,0,9,9
2014,Javoris,M,100,0,9,9
2014,Jayco,M,100,0,9,9
2014,Jaydem,M,100,0,9,9
2014,Jaymason,M,100,0,9,9
2014,Jaymir,M,100,0,9,9
2014,Jayona,F,100,9,0,9
2014,Jayston,M,100,0,9,9
2014,Jazae,F,100,9,0,9
2014,Jazari,F,100,9,0,9
2014,Jazon,M,100,0,9,9
2014,Jazzlene,F,100,9,0,9
2014,Jedaiah,M,100,0,9,9
2014,Jedrek,M,100,0,9,9
2014,Jeena,F,100,9,0,9
2014,Jehieli,F,100,9,0,9
2014,Jeiden,M,100,0,9,9
2014,Jenai,F,100,9,0,9
2014,Jenavee,F,100,9,0,9
2014,Jerilyn,F,100,9,0,9
2014,Jermy,M,100,0,9,9
2014,Jerney,F,100,9,0,9
2014,Jessah,F,100,9,0,9
2014,Jesseca,F,100,9,0,9
2014,Jessilynn,F,100,9,0,9
2014,Jeweliana,F,100,9,0,9
2014,Jinger,F,100,9,0,9
2014,Jinora,F,100,9,0,9
2014,Jissel,F,100,9,0,9
2014,Jiyah,F,100,9,0,9
2014,Jleigh,F,100,9,0,9
2014,Jniya,F,100,9,0,9
2014,Joandry,M,100,0,9,9
2014,Joanthony,M,100,0,9,9
2014,Jocsan,M,100,0,9,9
2014,Joden,M,100,0,9,9
2014,Joei,F,100,9,0,9
2014,Johnae,F,100,9,0,9
2014,Johnmark,M,100,0,9,9
2014,Johnrobert,M,100,0,9,9
2014,Jolissa,F,100,9,0,9
2014,Jonluke,M,100,0,9,9
2014,Jonnae,F,100,9,0,9
2014,Jonte,M,100,0,9,9
2014,Jonuel,M,100,0,9,9
2014,Joory,F,100,9,0,9
2014,Jorell,M,100,0,9,9
2014,Joren,M,100,0,9,9
2014,Jorjia,F,100,9,0,9
2014,Josenid,F,100,9,0,9
2014,Jossiel,M,100,0,9,9
2014,Joylyn,F,100,9,0,9
2014,Jozee,F,100,9,0,9
2014,Juanangel,M,100,0,9,9
2014,Juandaniel,M,100,0,9,9
2014,Judaea,F,100,9,0,9
2014,Julena,F,100,9,0,9
2014,Juliahna,F,100,9,0,9
2014,Juliani,F,100,9,0,9
2014,Julina,F,100,9,0,9
2014,Juliyah,F,100,9,0,9
2014,Kable,M,100,0,9,9
2014,Kaetlyn,F,100,9,0,9
2014,Kaevion,M,100,0,9,9
2014,Kaheem,M,100,0,9,9
2014,Kahiau,M,100,0,9,9
2014,Kahron,M,100,0,9,9
2014,Kaidynn,M,100,0,9,9
2014,Kaikane,M,100,0,9,9
2014,Kaisei,M,100,0,9,9
2014,Kaisey,F,100,9,0,9
2014,Kaitlynne,F,100,9,0,9
2014,Kalab,M,100,0,9,9
2014,Kalai,M,100,0,9,9
2014,Kalayla,F,100,9,0,9
2014,Kalirose,F,100,9,0,9
2014,Kalis,F,100,9,0,9
2014,Kaliyan,F,100,9,0,9
2014,Kalkidan,F,100,9,0,9
2014,Kalley,F,100,9,0,9
2014,Kalvyn,M,100,0,9,9
2014,Kamaile,F,100,9,0,9
2014,Kamarian,M,100,0,9,9
2014,Kameah,F,100,9,0,9
2014,Kameela,F,100,9,0,9
2014,Kamie,F,100,9,0,9
2014,Kanden,M,100,0,9,9
2014,Kanylah,F,100,9,0,9
2014,Kaoir,F,100,9,0,9
2014,Karagan,F,100,9,0,9
2014,Karelly,F,100,9,0,9
2014,Karolyna,F,100,9,0,9
2014,Karra,F,100,9,0,9
2014,Kasiya,F,100,9,0,9
2014,Kataleia,F,100,9,0,9
2014,Katalena,F,100,9,0,9
2014,Kathaleya,F,100,9,0,9
2014,Kaveah,F,100,9,0,9
2014,Kawan,M,100,0,9,9
2014,Kayelee,F,100,9,0,9
2014,Kayleeana,F,100,9,0,9
2014,Kayly,F,100,9,0,9
2014,Kaymen,M,100,0,9,9
2014,Kayn,M,100,0,9,9
2014,Kaynon,M,100,0,9,9
2014,Kayo,M,100,0,9,9
2014,Kaysha,F,100,9,0,9
2014,Kazuki,M,100,0,9,9
2014,Keefer,M,100,0,9,9
2014,Keelee,F,100,9,0,9
2014,Keilee,F,100,9,0,9
2014,Keilynn,F,100,9,0,9
2014,Keiron,M,100,0,9,9
2014,Kelcy,F,100,9,0,9
2014,Kellee,F,100,9,0,9
2014,Kelsen,M,100,0,9,9
2014,Kelso,M,100,0,9,9
2014,Kemely,F,100,9,0,9
2014,Kenaan,M,100,0,9,9
2014,Kendelle,F,100,9,0,9
2014,Kendi,F,100,9,0,9
2014,Kendrah,F,100,9,0,9
2014,Kenidee,F,100,9,0,9
2014,Kenidi,F,100,9,0,9
2014,Kensly,F,100,9,0,9
2014,Kentlee,F,100,9,0,9
2014,Keola,M,100,0,9,9
2014,Kerim,M,100,0,9,9
2014,Kerstin,F,100,9,0,9
2014,Kesley,F,100,9,0,9
2014,Kewan,M,100,0,9,9
2014,Keyaira,F,100,9,0,9
2014,Keyante,M,100,0,9,9
2014,Keyston,M,100,0,9,9
2014,Khaleed,M,100,0,9,9
2014,Khalib,M,100,0,9,9
2014,Khamia,F,100,9,0,9
2014,Khanh,F,100,9,0,9
2014,Khaylee,F,100,9,0,9
2014,Khilynn,F,100,9,0,9
2014,Khira,F,100,9,0,9
2014,Khiree,M,100,0,9,9
2014,Khup,M,100,0,9,9
2014,Khyia,F,100,9,0,9
2014,Khyrin,M,100,0,9,9
2014,Khyson,M,100,0,9,9
2014,Kiannah,F,100,9,0,9
2014,Kierah,F,100,9,0,9
2014,Kiira,F,100,9,0,9
2014,Kiki,F,100,9,0,9
2014,Kimbree,F,100,9,0,9
2014,Kimo,M,100,0,9,9
2014,Kindal,F,100,9,0,9
2014,Kingsly,M,100,0,9,9
2014,Kinly,F,100,9,0,9
2014,Kinlyn,F,100,9,0,9
2014,Kinslei,F,100,9,0,9
2014,Kiowa,M,100,0,9,9
2014,Kirat,F,100,9,0,9
2014,Kirkland,M,100,0,9,9
2014,Kirollos,M,100,0,9,9
2014,Kiyaan,M,100,0,9,9
2014,Klein,M,100,0,9,9
2014,Klyn,F,100,9,0,9
2014,Knightley,F,100,9,0,9
2014,Kobey,M,100,0,9,9
2014,Kohan,M,100,0,9,9
2014,Kohei,M,100,0,9,9
2014,Kohlson,M,100,0,9,9
2014,Kohner,M,100,0,9,9
2014,Kol,M,100,0,9,9
2014,Korrah,F,100,9,0,9
2014,Kowen,M,100,0,9,9
2014,Kriya,F,100,9,0,9
2014,Kunj,M,100,0,9,9
2014,Kutler,M,100,0,9,9
2014,Kyann,F,100,9,0,9
2014,Kycen,M,100,0,9,9
2014,Kyliana,F,100,9,0,9
2014,Kylii,F,100,9,0,9
2014,Kynan,M,100,0,9,9
2014,Kynzi,F,100,9,0,9
2014,Labib,M,100,0,9,9
2014,Labron,M,100,0,9,9
2014,Lachelle,F,100,9,0,9
2014,Laelia,F,100,9,0,9
2014,Laianna,F,100,9,0,9
2014,Lais,F,100,9,0,9
2014,Laker,M,100,0,9,9
2014,Lakia,F,100,9,0,9
2014,Lalani,F,100,9,0,9
2014,Lamario,M,100,0,9,9
2014,Lambert,M,100,0,9,9
2014,Lanay,F,100,9,0,9
2014,Lando,M,100,0,9,9
2014,Lanelle,F,100,9,0,9
2014,Lannah,F,100,9,0,9
2014,Larenz,M,100,0,9,9
2014,Lashun,M,100,0,9,9
2014,Latifah,F,100,9,0,9
2014,Latisha,F,100,9,0,9
2014,Lauralie,F,100,9,0,9
2014,Lauretta,F,100,9,0,9
2014,Lavaughn,M,100,0,9,9
2014,Laverne,M,100,0,9,9
2014,Layali,F,100,9,0,9
2014,Layanah,F,100,9,0,9
2014,Layann,F,100,9,0,9
2014,Laycie,F,100,9,0,9
2014,Layia,F,100,9,0,9
2014,Laylaa,F,100,9,0,9
2014,Laylana,F,100,9,0,9
2014,Layonna,F,100,9,0,9
2014,Leba,F,100,9,0,9
2014,Leeandre,M,100,0,9,9
2014,Leeum,M,100,0,9,9
2014,Lelaina,F,100,9,0,9
2014,Lennan,F,100,9,0,9
2014,Lenni,F,100,9,0,9
2014,Leoncio,M,100,0,9,9
2014,Leor,M,100,0,9,9
2014,Lesieli,F,100,9,0,9
2014,Leslee,F,100,9,0,9
2014,Letha,F,100,9,0,9
2014,Lety,F,100,9,0,9
2014,Levana,F,100,9,0,9
2014,Leven,M,100,0,9,9
2014,Lewin,M,100,0,9,9
2014,Lexander,M,100,0,9,9
2014,Liahna,F,100,9,0,9
2014,Libi,F,100,9,0,9
2014,Libni,F,100,9,0,9
2014,Liliani,F,100,9,0,9
2014,Lilit,F,100,9,0,9
2014,Lilliauna,F,100,9,0,9
2014,Lilliona,F,100,9,0,9
2014,Lillyian,F,100,9,0,9
2014,Lillyn,F,100,9,0,9
2014,Lineth,F,100,9,0,9
2014,Lissandra,F,100,9,0,9
2014,Lizabella,F,100,9,0,9
2014,Lizzeth,F,100,9,0,9
2014,Logun,M,100,0,9,9
2014,Lohith,M,100,0,9,9
2014,Loida,F,100,9,0,9
2014,Londynne,F,100,9,0,9
2014,Lord,M,100,0,9,9
2014,Lorea,F,100,9,0,9
2014,Loreley,F,100,9,0,9
2014,Lorelle,F,100,9,0,9
2014,Lorie,F,100,9,0,9
2014,Louann,F,100,9,0,9
2014,Loula,F,100,9,0,9
2014,Luccas,M,100,0,9,9
2014,Lucee,F,100,9,0,9
2014,Luciella,F,100,9,0,9
2014,Lun,F,100,9,0,9
2014,Luqmaan,M,100,0,9,9
2014,Luv,F,100,9,0,9
2014,Lwren,F,100,9,0,9
2014,Lydian,F,100,9,0,9
2014,Lylee,F,100,9,0,9
2014,Lynkin,M,100,0,9,9
2014,Lynnae,F,100,9,0,9
2014,Lyrah,F,100,9,0,9
2014,Maahir,M,100,0,9,9
2014,Macarius,M,100,0,9,9
2014,Macelyn,F,100,9,0,9
2014,Mackenzey,F,100,9,0,9
2014,Madalee,F,100,9,0,9
2014,Madalene,F,100,9,0,9
2014,Madex,M,100,0,9,9
2014,Madyn,F,100,9,0,9
2014,Maeby,F,100,9,0,9
2014,Maevis,F,100,9,0,9
2014,Magdaleno,M,100,0,9,9
2014,Maguire,M,100,0,9,9
2014,Mahrosh,F,100,9,0,9
2014,Maire,F,100,9,0,9
2014,Makailah,F,100,9,0,9
2014,Makale,M,100,0,9,9
2014,Makar,M,100,0,9,9
2014,Makayleigh,F,100,9,0,9
2014,Makhyla,F,100,9,0,9
2014,Makia,F,100,9,0,9
2014,Makila,F,100,9,0,9
2014,Makiyla,F,100,9,0,9
2014,Makynna,F,100,9,0,9
2014,Malaak,F,100,9,0,9
2014,Malae,F,100,9,0,9
2014,Malahki,M,100,0,9,9
2014,Malai,F,100,9,0,9
2014,Malayzia,F,100,9,0,9
2014,Maleea,F,100,9,0,9
2014,Maleki,M,100,0,9,9
2014,Malikah,F,100,9,0,9
2014,Maliyani,F,100,9,0,9
2014,Malkia,F,100,9,0,9
2014,Mallery,F,100,9,0,9
2014,Manoah,M,100,0,9,9
2014,Mansa,M,100,0,9,9
2014,Mar,F,100,9,0,9
2014,Maral,F,100,9,0,9
2014,Marciana,F,100,9,0,9
2014,Mariaclara,F,100,9,0,9
2014,Mariadejesus,F,100,9,0,9
2014,Marialuisa,F,100,9,0,9
2014,Mariamawit,F,100,9,0,9
2014,Maribell,F,100,9,0,9
2014,Marietou,F,100,9,0,9
2014,Marik,M,100,0,9,9
2014,Marilla,F,100,9,0,9
2014,Marine,F,100,9,0,9
2014,Mariyam,F,100,9,0,9
2014,Markale,M,100,0,9,9
2014,Markan,F,100,9,0,9
2014,Marloe,F,100,9,0,9
2014,Marquee,M,100,0,9,9
2014,Marshae,F,100,9,0,9
2014,Martinez,M,100,0,9,9
2014,Martyna,F,100,9,0,9
2014,Marven,M,100,0,9,9
2014,Masato,M,100,0,9,9
2014,Mashal,F,100,9,0,9
2014,Matalyn,F,100,9,0,9
2014,Mattalynn,F,100,9,0,9
2014,Mattelyn,F,100,9,0,9
2014,Mattheo,M,100,0,9,9
2014,Matviy,M,100,0,9,9
2014,Mauriah,F,100,9,0,9
2014,Maury,M,100,0,9,9
2014,Mavery,F,100,9,0,9
2014,Mawada,F,100,9,0,9
2014,Maxi,M,100,0,9,9
2014,Maycol,M,100,0,9,9
2014,Mayella,F,100,9,0,9
2014,Mayvis,F,100,9,0,9
2014,Mayzi,F,100,9,0,9
2014,Mazy,F,100,9,0,9
2014,Mckai,M,100,0,9,9
2014,Mckaylah,F,100,9,0,9
2014,Mclain,M,100,0,9,9
2014,Meha,F,100,9,0,9
2014,Mehak,F,100,9,0,9
2014,Melaine,F,100,9,0,9
2014,Meli,F,100,9,0,9
2014,Melida,F,100,9,0,9
2014,Mellany,F,100,9,0,9
2014,Mellody,F,100,9,0,9
2014,Meridith,F,100,9,0,9
2014,Merin,F,100,9,0,9
2014,Merissa,F,100,9,0,9
2014,Merna,F,100,9,0,9
2014,Meryn,F,100,9,0,9
2014,Metta,F,100,9,0,9
2014,Miaa,F,100,9,0,9
2014,Miaisabella,F,100,9,0,9
2014,Micael,M,100,0,9,9
2014,Michaelyn,F,100,9,0,9
2014,Mikelle,F,100,9,0,9
2014,Milad,M,100,0,9,9
2014,Milano,M,100,0,9,9
2014,Milca,F,100,9,0,9
2014,Mirra,F,100,9,0,9
2014,Mishal,F,100,9,0,9
2014,Misheel,F,100,9,0,9
2014,Mohib,M,100,0,9,9
2014,Moiz,M,100,0,9,9
2014,Momina,F,100,9,0,9
2014,Moo,M,100,0,9,9
2014,Morelia,F,100,9,0,9
2014,Motaz,M,100,0,9,9
2014,Muaad,M,100,0,9,9
2014,Mubashir,M,100,0,9,9
2014,Mukhtar,M,100,0,9,9
2014,Munachimso,F,100,9,0,9
2014,Muntas,F,100,9,0,9
2014,Mussie,M,100,0,9,9
2014,Mustaf,M,100,0,9,9
2014,Myalynn,F,100,9,0,9
2014,Myan,M,100,0,9,9
2014,Mykale,M,100,0,9,9
2014,Myleen,F,100,9,0,9
2014,Mylei,F,100,9,0,9
2014,Mylynn,F,100,9,0,9
2014,Myraa,F,100,9,0,9
2014,Myrtle,F,100,9,0,9
2014,Naama,F,100,9,0,9
2014,Naarah,F,100,9,0,9
2014,Naasir,M,100,0,9,9
2014,Naavya,F,100,9,0,9
2014,Naelani,F,100,9,0,9
2014,Nafisa,F,100,9,0,9
2014,Nai,F,100,9,0,9
2014,Naiden,M,100,0,9,9
2014,Naif,M,100,0,9,9
2014,Naija,F,100,9,0,9
2014,Nailani,F,100,9,0,9
2014,Naiyana,F,100,9,0,9
2014,Naja,F,100,9,0,9
2014,Najwa,F,100,9,0,9
2014,Nakul,M,100,0,9,9
2014,Nakyia,F,100,9,0,9
2014,Nakyla,F,100,9,0,9
2014,Naleigh,F,100,9,0,9
2014,Namine,F,100,9,0,9
2014,Namirah,F,100,9,0,9
2014,Namiya,F,100,9,0,9
2014,Namya,F,100,9,0,9
2014,Naol,M,100,0,9,9
2014,Naomee,F,100,9,0,9
2014,Nare,F,100,9,0,9
2014,Narissa,F,100,9,0,9
2014,Naryiah,F,100,9,0,9
2014,Naser,M,100,0,9,9
2014,Nasiya,F,100,9,0,9
2014,Nathon,M,100,0,9,9
2014,Natsumi,F,100,9,0,9
2014,Navey,F,100,9,0,9
2014,Navina,F,100,9,0,9
2014,Nayellie,F,100,9,0,9
2014,Naythen,M,100,0,9,9
2014,Nazariah,F,100,9,0,9
2014,Neenah,F,100,9,0,9
2014,Nektarios,M,100,0,9,9
2014,Neleh,F,100,9,0,9
2014,Nevae,F,100,9,0,9
2014,Nevena,F,100,9,0,9
2014,Newt,M,100,0,9,9
2014,Ngozi,F,100,9,0,9
2014,Nicolae,M,100,0,9,9
2014,Nicolaus,M,100,0,9,9
2014,Nidal,M,100,0,9,9
2014,Nimra,F,100,9,0,9
2014,Nivek,M,100,0,9,9
2014,Niyati,F,100,9,0,9
2014,Nobel,M,100,0,9,9
2014,Nolah,F,100,9,0,9
2014,Nolberto,M,100,0,9,9
2014,Nooh,M,100,0,9,9
2014,Noorah,F,100,9,0,9
2014,Noralee,F,100,9,0,9
2014,Norbert,M,100,0,9,9
2014,Novalei,F,100,9,0,9
2014,Nyaira,F,100,9,0,9
2014,Nymir,M,100,0,9,9
2014,Nyna,F,100,9,0,9
2014,Nyshawn,M,100,0,9,9
2014,Nyzier,M,100,0,9,9
2014,Oaklei,F,100,9,0,9
2014,Obie,M,100,0,9,9
2014,Octavion,M,100,0,9,9
2014,Ola,F,100,9,0,9
2014,Omauri,M,100,0,9,9
2014,Onica,F,100,9,0,9
2014,Onika,F,100,9,0,9
2014,Ontario,M,100,0,9,9
2014,Orchid,F,100,9,0,9
2014,Osama,M,100,0,9,9
2014,Osmond,M,100,0,9,9
2014,Owain,M,100,0,9,9
2014,Owin,M,100,0,9,9
2014,Oxford,M,100,0,9,9
2014,Paarth,M,100,0,9,9
2014,Paelyn,F,100,9,0,9
2014,Paizlie,F,100,9,0,9
2014,Pantera,F,100,9,0,9
2014,Parin,M,100,0,9,9
2014,Pariss,F,100,9,0,9
2014,Parthiv,M,100,0,9,9
2014,Paylin,F,100,9,0,9
2014,Payzlie,F,100,9,0,9
2014,Peityn,F,100,9,0,9
2014,Penelopy,F,100,9,0,9
2014,Peytan,F,100,9,0,9
2014,Phallon,F,100,9,0,9
2014,Philo,M,100,0,9,9
2014,Piers,M,100,0,9,9
2014,Pilot,M,100,0,9,9
2014,Pixie,F,100,9,0,9
2014,Pollyanna,F,100,9,0,9
2014,Prachi,F,100,9,0,9
2014,Pranika,F,100,9,0,9
2014,Preslei,F,100,9,0,9
2014,Pristine,F,100,9,0,9
2014,Priyah,F,100,9,0,9
2014,Qiana,F,100,9,0,9
2014,Quaniyah,F,100,9,0,9
2014,Quincee,F,100,9,0,9
2014,Quinnly,F,100,9,0,9
2014,Raeanne,F,100,9,0,9
2014,Raef,M,100,0,9,9
2014,Rafay,M,100,0,9,9
2014,Rafeal,M,100,0,9,9
2014,Raha,F,100,9,0,9
2014,Raidan,M,100,0,9,9
2014,Rainbow,F,100,9,0,9
2014,Rakel,F,100,9,0,9
2014,Ralphael,M,100,0,9,9
2014,Ralston,M,100,0,9,9
2014,Rasheeda,F,100,9,0,9
2014,Rasheem,M,100,0,9,9
2014,Raudel,M,100,0,9,9
2014,Raunak,M,100,0,9,9
2014,Rayelynn,F,100,9,0,9
2014,Raymere,M,100,0,9,9
2014,Raynie,F,100,9,0,9
2014,Rayvn,F,100,9,0,9
2014,Reanne,F,100,9,0,9
2014,Rebelle,F,100,9,0,9
2014,Reeya,F,100,9,0,9
2014,Regis,M,100,0,9,9
2014,Reigan,F,100,9,0,9
2014,Reika,F,100,9,0,9
2014,Reizel,F,100,9,0,9
2014,Rella,F,100,9,0,9
2014,Reynold,M,100,0,9,9
2014,Reznor,M,100,0,9,9
2014,Rhealynn,F,100,9,0,9
2014,Rhiya,F,100,9,0,9
2014,Rhiyan,F,100,9,0,9
2014,Rhyanna,F,100,9,0,9
2014,Rhylei,F,100,9,0,9
2014,Richardson,M,100,0,9,9
2014,Richy,M,100,0,9,9
2014,Rihana,F,100,9,0,9
2014,Rileyann,F,100,9,0,9
2014,Rishav,M,100,0,9,9
2014,Ritu,F,100,9,0,9
2014,Rixon,M,100,0,9,9
2014,Rixton,M,100,0,9,9
2014,Rmoni,F,100,9,0,9
2014,Rockford,M,100,0,9,9
2014,Rockland,M,100,0,9,9
2014,Roddrick,M,100,0,9,9
2014,Rodman,M,100,0,9,9
2014,Rodriguez,M,100,0,9,9
2014,Romance,M,100,0,9,9
2014,Romelia,F,100,9,0,9
2014,Romyn,M,100,0,9,9
2014,Ronel,M,100,0,9,9
2014,Rosabel,F,100,9,0,9
2014,Rosalynne,F,100,9,0,9
2014,Rosamund,F,100,9,0,9
2014,Roseanne,F,100,9,0,9
2014,Roselynne,F,100,9,0,9
2014,Rosha,F,100,9,0,9
2014,Royelle,F,100,9,0,9
2014,Ruairi,M,100,0,9,9
2014,Ruhee,F,100,9,0,9
2014,Ruqiya,F,100,9,0,9
2014,Ruya,F,100,9,0,9
2014,Ryce,M,100,0,9,9
2014,Ryett,M,100,0,9,9
2014,Saadia,F,100,9,0,9
2014,Saafir,M,100,0,9,9
2014,Saathvik,M,100,0,9,9
2014,Sabreen,F,100,9,0,9
2014,Sabriyah,F,100,9,0,9
2014,Sabryna,F,100,9,0,9
2014,Sada,F,100,9,0,9
2014,Sadiel,M,100,0,9,9
2014,Safiyya,F,100,9,0,9
2014,Saidy,F,100,9,0,9
2014,Saim,M,100,0,9,9
2014,Saket,M,100,0,9,9
2014,Sakinah,F,100,9,0,9
2014,Salia,F,100,9,0,9
2014,Samah,F,100,9,0,9
2014,Samai,F,100,9,0,9
2014,Samaj,M,100,0,9,9
2014,Samba,M,100,0,9,9
2014,Samiksha,F,100,9,0,9
2014,Samra,F,100,9,0,9
2014,Samrat,M,100,0,9,9
2014,Samuella,F,100,9,0,9
2014,Samus,F,100,9,0,9
2014,Sandi,F,100,9,0,9
2014,Saniyya,F,100,9,0,9
2014,Sanjith,M,100,0,9,9
2014,Santanna,F,100,9,0,9
2014,Sanylah,F,100,9,0,9
2014,Saphyra,F,100,9,0,9
2014,Sarabi,F,100,9,0,9
2014,Sarae,F,100,9,0,9
2014,Sareena,F,100,9,0,9
2014,Sargun,F,100,9,0,9
2014,Savir,M,100,0,9,9
2014,Sayana,F,100,9,0,9
2014,Sayed,M,100,0,9,9
2014,Sayvon,M,100,0,9,9
2014,Sebastin,M,100,0,9,9
2014,Seleen,F,100,9,0,9
2014,Seraj,M,100,0,9,9
2014,Seriyah,F,100,9,0,9
2014,Seva,F,100,9,0,9
2014,Seydou,M,100,0,9,9
2014,Shaarav,M,100,0,9,9
2014,Shahid,M,100,0,9,9
2014,Shahzain,M,100,0,9,9
2014,Shaine,M,100,0,9,9
2014,Shakiyah,F,100,9,0,9
2014,Shaleah,F,100,9,0,9
2014,Shaleigh,F,100,9,0,9
2014,Shalin,M,100,0,9,9
2014,Shalini,F,100,9,0,9
2014,Shamika,F,100,9,0,9
2014,Shanyah,F,100,9,0,9
2014,Shanyia,F,100,9,0,9
2014,Shara,F,100,9,0,9
2014,Sharbel,M,100,0,9,9
2014,Sharlette,F,100,9,0,9
2014,Sharlyn,F,100,9,0,9
2014,Shashank,M,100,0,9,9
2014,Shatha,F,100,9,0,9
2014,Sheccid,F,100,9,0,9
2014,Shenouda,M,100,0,9,9
2014,Sheri,F,100,9,0,9
2014,Shiori,F,100,9,0,9
2014,Shiya,F,100,9,0,9
2014,Shoaib,M,100,0,9,9
2014,Shota,M,100,0,9,9
2014,Shritha,F,100,9,0,9
2014,Shyra,F,100,9,0,9
2014,Sibylla,F,100,9,0,9
2014,Sidda,F,100,9,0,9
2014,Siddhan,M,100,0,9,9
2014,Simiyah,F,100,9,0,9
2014,Simrat,F,100,9,0,9
2014,Sircharles,M,100,0,9,9
2014,Sireen,F,100,9,0,9
2014,Siva,M,100,0,9,9
2014,Siyana,F,100,9,0,9
2014,Siyuan,M,100,0,9,9
2014,Skanda,M,100,0,9,9
2014,Skyleen,F,100,9,0,9
2014,Skyley,F,100,9,0,9
2014,Skyli,F,100,9,0,9
2014,Skyrah,F,100,9,0,9
2014,Slader,M,100,0,9,9
2014,Soane,M,100,0,9,9
2014,Solangel,F,100,9,0,9
2014,Sophiana,F,100,9,0,9
2014,Soraiya,F,100,9,0,9
2014,Sosie,F,100,9,0,9
2014,Sreekar,M,100,0,9,9
2014,Stasia,F,100,9,0,9
2014,Sterlin,M,100,0,9,9
2014,Stevon,M,100,0,9,9
2014,Stylez,M,100,0,9,9
2014,Suan,M,100,0,9,9
2014,Sudiksha,F,100,9,0,9
2014,Suheyb,M,100,0,9,9
2014,Sujal,M,100,0,9,9
2014,Sula,F,100,9,0,9
2014,Sultana,F,100,9,0,9
2014,Sumayo,F,100,9,0,9
2014,Surveen,F,100,9,0,9
2014,Sushant,M,100,0,9,9
2014,Symiah,F,100,9,0,9
2014,Syvanna,F,100,9,0,9
2014,Taavi,M,100,0,9,9
2014,Tabari,M,100,0,9,9
2014,Taeden,M,100,0,9,9
2014,Tahliah,F,100,9,0,9
2014,Tahsin,M,100,0,9,9
2014,Taisiya,F,100,9,0,9
2014,Tajah,F,100,9,0,9
2014,Takeshi,M,100,0,9,9
2014,Tal,M,100,0,9,9
2014,Talena,F,100,9,0,9
2014,Talina,F,100,9,0,9
2014,Talmadge,M,100,0,9,9
2014,Tanae,F,100,9,0,9
2014,Tanesha,F,100,9,0,9
2014,Tanilah,F,100,9,0,9
2014,Tanyia,F,100,9,0,9
2014,Tapanga,F,100,9,0,9
2014,Tariana,F,100,9,0,9
2014,Tarrance,M,100,0,9,9
2014,Tavyn,M,100,0,9,9
2014,Tayo,M,100,0,9,9
2014,Tayshon,M,100,0,9,9
2014,Taytem,F,100,9,0,9
2014,Teah,F,100,9,0,9
2014,Teancum,M,100,0,9,9
2014,Teia,F,100,9,0,9
2014,Teliah,F,100,9,0,9
2014,Temari,F,100,9,0,9
2014,Terren,M,100,0,9,9
2014,Terryon,M,100,0,9,9
2014,Thaleia,F,100,9,0,9
2014,Thanvi,F,100,9,0,9
2014,Thoren,M,100,0,9,9
2014,Tighe,M,100,0,9,9
2014,Tommaso,M,100,0,9,9
2014,Tommi,F,100,9,0,9
2014,Tonatiuh,M,100,0,9,9
2014,Tonia,F,100,9,0,9
2014,Tonny,M,100,0,9,9
2014,Travian,M,100,0,9,9
2014,Tres,M,100,0,9,9
2014,Trew,M,100,0,9,9
2014,Treyven,M,100,0,9,9
2014,Trezure,F,100,9,0,9
2014,Trixie,F,100,9,0,9
2014,Tulip,F,100,9,0,9
2014,Tulsi,F,100,9,0,9
2014,Tymier,M,100,0,9,9
2014,Tyriana,F,100,9,0,9
2014,Tyten,M,100,0,9,9
2014,Tzipporah,F,100,9,0,9
2014,Udy,F,100,9,0,9
2014,Urwa,F,100,9,0,9
2014,Uthman,M,100,0,9,9
2014,Vahan,M,100,0,9,9
2014,Val,M,100,0,9,9
2014,Vala,F,100,9,0,9
2014,Valena,F,100,9,0,9
2014,Vallery,F,100,9,0,9
2014,Valory,F,100,9,0,9
2014,Vaniah,F,100,9,0,9
2014,Vashawn,M,100,0,9,9
2014,Vayden,M,100,0,9,9
2014,Vedad,M,100,0,9,9
2014,Venecia,F,100,9,0,9
2014,Venna,F,100,9,0,9
2014,Via,F,100,9,0,9
2014,Vicenzo,M,100,0,9,9
2014,Vidalia,F,100,9,0,9
2014,Videl,F,100,9,0,9
2014,Viktoriya,F,100,9,0,9
2014,Vinayak,M,100,0,9,9
2014,Vincen,M,100,0,9,9
2014,Vitalia,F,100,9,0,9
2014,Vivyan,F,100,9,0,9
2014,Vu,M,100,0,9,9
2014,Vyolet,F,100,9,0,9
2014,Wally,M,100,0,9,9
2014,Wendi,F,100,9,0,9
2014,Weyland,M,100,0,9,9
2014,Whitleigh,F,100,9,0,9
2014,Windy,F,100,9,0,9
2014,Wise,M,100,0,9,9
2014,Wyland,M,100,0,9,9
2014,Wynton,M,100,0,9,9
2014,Xaivier,M,100,0,9,9
2014,Xavyer,M,100,0,9,9
2014,Xianna,F,100,9,0,9
2014,Xinyi,F,100,9,0,9
2014,Xylie,F,100,9,0,9
2014,Yachet,F,100,9,0,9
2014,Yafa,F,100,9,0,9
2014,Yaffa,F,100,9,0,9
2014,Yaileen,F,100,9,0,9
2014,Yailenys,F,100,9,0,9
2014,Yakelin,F,100,9,0,9
2014,Yanina,F,100,9,0,9
2014,Yanziel,M,100,0,9,9
2014,Yardley,F,100,9,0,9
2014,Yarimar,F,100,9,0,9
2014,Yashar,M,100,0,9,9
2014,Yaslyn,F,100,9,0,9
2014,Yates,M,100,0,9,9
2014,Yavier,M,100,0,9,9
2014,Yecheskel,M,100,0,9,9
2014,Yennifer,F,100,9,0,9
2014,Yeraldi,F,100,9,0,9
2014,Yida,M,100,0,9,9
2014,Yomar,M,100,0,9,9
2014,Yordan,M,100,0,9,9
2014,Yosiel,M,100,0,9,9
2014,Yotam,M,100,0,9,9
2014,Young,M,100,0,9,9
2014,Yue,F,100,9,0,9
2014,Yuka,F,100,9,0,9
2014,Yuta,M,100,0,9,9
2014,Yves,M,100,0,9,9
2014,Zacary,M,100,0,9,9
2014,Zackeriah,M,100,0,9,9
2014,Zaedon,M,100,0,9,9
2014,Zaelee,F,100,9,0,9
2014,Zahar,M,100,0,9,9
2014,Zamere,M,100,0,9,9
2014,Zamyiah,F,100,9,0,9
2014,Zaquan,M,100,0,9,9
2014,Zarra,F,100,9,0,9
2014,Zarriah,F,100,9,0,9
2014,Zaul,M,100,0,9,9
2014,Zayanna,F,100,9,0,9
2014,Zaydn,M,100,0,9,9
2014,Zayin,M,100,0,9,9
2014,Zayley,F,100,9,0,9
2014,Zaylia,F,100,9,0,9
2014,Zayliana,F,100,9,0,9
2014,Zein,M,100,0,9,9
2014,Zeki,M,100,0,9,9
2014,Zellie,F,100,9,0,9
2014,Zhoe,F,100,9,0,9
2014,Zimal,F,100,9,0,9
2014,Ziqi,F,100,9,0,9
2014,Ziyana,F,100,9,0,9
2014,Zoa,F,100,9,0,9
2014,Zoelynn,F,100,9,0,9
2014,Zoeyjane,F,100,9,0,9
2014,Zoii,F,100,9,0,9
2014,Zoli,F,100,9,0,9
2014,Zoraida,F,100,9,0,9
2014,Zoria,F,100,9,0,9
2014,Zubin,M,100,0,9,9
2014,Zuhair,M,100,0,9,9
2014,Zulma,F,100,9,0,9
2014,Zyia,F,100,9,0,9
2014,Zyionna,F,100,9,0,9
2014,Zykerria,F,100,9,0,9
2014,Zyrion,M,100,0,9,9
2014,Aadan,M,100,0,8,8
2014,Aailyah,F,100,8,0,8
2014,Aaleigha,F,100,8,0,8
2014,Aaliyana,F,100,8,0,8
2014,Aariel,F,100,8,0,8
2014,Aarik,M,100,0,8,8
2014,Aashir,M,100,0,8,8
2014,Aavah,F,100,8,0,8
2014,Abanoub,M,100,0,8,8
2014,Abba,M,100,0,8,8
2014,Abdi,M,100,0,8,8
2014,Abdiqani,M,100,0,8,8
2014,Abdulrehman,M,100,0,8,8
2014,Abdurrehman,M,100,0,8,8
2014,Abeera,F,100,8,0,8
2014,Abriah,F,100,8,0,8
2014,Accalia,F,100,8,0,8
2014,Aceton,M,100,0,8,8
2014,Acheron,M,100,0,8,8
2014,Ackley,M,100,0,8,8
2014,Adaleen,F,100,8,0,8
2014,Adalei,F,100,8,0,8
2014,Adaleyza,F,100,8,0,8
2014,Adalyna,F,100,8,0,8
2014,Adamina,F,100,8,0,8
2014,Addalin,F,100,8,0,8
2014,Addi,F,100,8,0,8
2014,Addisson,F,100,8,0,8
2014,Adedamola,M,100,0,8,8
2014,Adell,F,100,8,0,8
2014,Adellyn,F,100,8,0,8
2014,Adhara,F,100,8,0,8
2014,Adhrith,M,100,0,8,8
2014,Adie,F,100,8,0,8
2014,Adila,F,100,8,0,8
2014,Adilen,F,100,8,0,8
2014,Admire,F,100,8,0,8
2014,Adolph,M,100,0,8,8
2014,Adonias,M,100,0,8,8
2014,Adriell,M,100,0,8,8
2014,Adriene,F,100,8,0,8
2014,Adrijana,F,100,8,0,8
2014,Aedric,M,100,0,8,8
2014,Afraz,M,100,0,8,8
2014,Agustus,M,100,0,8,8
2014,Ahmeer,M,100,0,8,8
2014,Ahylin,F,100,8,0,8
2014,Aidrik,M,100,0,8,8
2014,Aileana,F,100,8,0,8
2014,Aileene,F,100,8,0,8
2014,Aimsley,F,100,8,0,8
2014,Airis,F,100,8,0,8
2014,Ajayla,F,100,8,0,8
2014,Ajna,F,100,8,0,8
2014,Ajournee,F,100,8,0,8
2014,Akane,F,100,8,0,8
2014,Aketzaly,F,100,8,0,8
2014,Akoni,M,100,0,8,8
2014,Alaiyna,F,100,8,0,8
2014,Alaja,F,100,8,0,8
2014,Alannis,F,100,8,0,8
2014,Alanny,F,100,8,0,8
2014,Alano,M,100,0,8,8
2014,Alazae,F,100,8,0,8
2014,Alban,M,100,0,8,8
2014,Alberta,F,100,8,0,8
2014,Albino,M,100,0,8,8
2014,Albion,M,100,0,8,8
2014,Aleece,F,100,8,0,8
2014,Alegra,F,100,8,0,8
2014,Alegria,F,100,8,0,8
2014,Alene,F,100,8,0,8
2014,Alesa,F,100,8,0,8
2014,Alexio,M,100,0,8,8
2014,Aleyana,F,100,8,0,8
2014,Aleysa,F,100,8,0,8
2014,Aleyssa,F,100,8,0,8
2014,Alfie,M,100,0,8,8
2014,Algernon,M,100,0,8,8
2014,Alhasan,M,100,0,8,8
2014,Aliany,F,100,8,0,8
2014,Alioune,M,100,0,8,8
2014,Alithea,F,100,8,0,8
2014,Alius,M,100,0,8,8
2014,Aliviyah,F,100,8,0,8
2014,Aliyaah,F,100,8,0,8
2014,Aliz,F,100,8,0,8
2014,Alizaya,F,100,8,0,8
2014,Alizey,F,100,8,0,8
2014,Allante,M,100,0,8,8
2014,Allysen,F,100,8,0,8
2014,Allyzon,F,100,8,0,8
2014,Alonnie,F,100,8,0,8
2014,Alonte,M,100,0,8,8
2014,Aloria,F,100,8,0,8
2014,Alrik,M,100,0,8,8
2014,Altan,M,100,0,8,8
2014,Alwin,M,100,0,8,8
2014,Alxander,M,100,0,8,8
2014,Alyrica,F,100,8,0,8
2014,Alysen,F,100,8,0,8
2014,Alyxandra,F,100,8,0,8
2014,Alzahra,F,100,8,0,8
2014,Amaal,F,100,8,0,8
2014,Amabella,F,100,8,0,8
2014,Amadu,M,100,0,8,8
2014,Amahia,F,100,8,0,8
2014,Amair,M,100,0,8,8
2014,Amante,M,100,0,8,8
2014,Amarrah,F,100,8,0,8
2014,Amielia,F,100,8,0,8
2014,Amiliyah,F,100,8,0,8
2014,Amiria,F,100,8,0,8
2014,Amirykal,F,100,8,0,8
2014,Amjed,M,100,0,8,8
2014,Ammarie,F,100,8,0,8
2014,Ammie,F,100,8,0,8
2014,Amontae,M,100,0,8,8
2014,Amron,M,100,0,8,8
2014,Anahia,F,100,8,0,8
2014,Anaisabel,F,100,8,0,8
2014,Analiya,F,100,8,0,8
2014,Analya,F,100,8,0,8
2014,Anandi,F,100,8,0,8
2014,Anani,F,100,8,0,8
2014,Anar,M,100,0,8,8
2014,Andalyn,F,100,8,0,8
2014,Andalynn,F,100,8,0,8
2014,Andelynn,F,100,8,0,8
2014,Andriy,M,100,0,8,8
2014,Anecia,F,100,8,0,8
2014,Anele,F,100,8,0,8
2014,Aneli,F,100,8,0,8
2014,Anelis,F,100,8,0,8
2014,Anesa,F,100,8,0,8
2014,Aneth,F,100,8,0,8
2014,Angelice,F,100,8,0,8
2014,Angeliki,F,100,8,0,8
2014,Angelino,M,100,0,8,8
2014,Aniayah,F,100,8,0,8
2014,Anikah,F,100,8,0,8
2014,Aniketh,M,100,0,8,8
2014,Anira,F,100,8,0,8
2014,Anistynn,F,100,8,0,8
2014,Anjela,F,100,8,0,8
2014,Annaleia,F,100,8,0,8
2014,Annaley,F,100,8,0,8
2014,Annalin,F,100,8,0,8
2014,Annalis,F,100,8,0,8
2014,Annalucia,F,100,8,0,8
2014,Annalycia,F,100,8,0,8
2014,Annalysia,F,100,8,0,8
2014,Annalysse,F,100,8,0,8
2014,Annastacia,F,100,8,0,8
2014,Annaston,F,100,8,0,8
2014,Annel,F,100,8,0,8
2014,Anneth,F,100,8,0,8
2014,Annilee,F,100,8,0,8
2014,Annisa,F,100,8,0,8
2014,Annissa,F,100,8,0,8
2014,Annya,F,100,8,0,8
2014,Anquan,M,100,0,8,8
2014,Anselm,M,100,0,8,8
2014,Anterio,M,100,0,8,8
2014,Antwoine,M,100,0,8,8
2014,Anyela,F,100,8,0,8
2014,Anyelina,F,100,8,0,8
2014,Anyeline,F,100,8,0,8
2014,Anyely,F,100,8,0,8
2014,Apolo,M,100,0,8,8
2014,Arabela,F,100,8,0,8
2014,Arah,F,100,8,0,8
2014,Aralee,F,100,8,0,8
2014,Arayna,F,100,8,0,8
2014,Areebah,F,100,8,0,8
2014,Areia,F,100,8,0,8
2014,Arelyn,F,100,8,0,8
2014,Aretzy,F,100,8,0,8
2014,Arhianna,F,100,8,0,8
2014,Ariaunna,F,100,8,0,8
2014,Arieonna,F,100,8,0,8
2014,Arij,F,100,8,0,8
2014,Ariyelle,F,100,8,0,8
2014,Ariyona,F,100,8,0,8
2014,Arleene,F,100,8,0,8
2014,Armari,M,100,0,8,8
2014,Armina,F,100,8,0,8
2014,Armita,F,100,8,0,8
2014,Arnavi,F,100,8,0,8
2014,Arne,M,100,0,8,8
2014,Arnika,F,100,8,0,8
2014,Arriah,F,100,8,0,8
2014,Arrionna,F,100,8,0,8
2014,Arriyah,F,100,8,0,8
2014,Arryanna,F,100,8,0,8
2014,Arslan,M,100,0,8,8
2014,Aryaa,F,100,8,0,8
2014,Aryona,F,100,8,0,8
2014,Ashdon,M,100,0,8,8
2014,Ashford,M,100,0,8,8
2014,Ashima,F,100,8,0,8
2014,Ashish,M,100,0,8,8
2014,Ashmi,F,100,8,0,8
2014,Ashya,F,100,8,0,8
2014,Asiana,F,100,8,0,8
2014,Aslin,F,100,8,0,8
2014,Asmara,F,100,8,0,8
2014,Astaria,F,100,8,0,8
2014,Astella,F,100,8,0,8
2014,Athyna,F,100,8,0,8
2014,Atika,F,100,8,0,8
2014,Attilio,M,100,0,8,8
2014,Aubrianah,F,100,8,0,8
2014,Audraya,F,100,8,0,8
2014,Audris,F,100,8,0,8
2014,Audryanna,F,100,8,0,8
2014,Augus,M,100,0,8,8
2014,Aulelei,F,100,8,0,8
2014,Aunesti,F,100,8,0,8
2014,Aunica,F,100,8,0,8
2014,Aurick,M,100,0,8,8
2014,Aurorah,F,100,8,0,8
2014,Aury,F,100,8,0,8
2014,Avahlynn,F,100,8,0,8
2014,Avalanna,F,100,8,0,8
2014,Avaleen,F,100,8,0,8
2014,Avaley,F,100,8,0,8
2014,Avalin,F,100,8,0,8
2014,Avamae,F,100,8,0,8
2014,Avel,M,100,0,8,8
2014,Avereigh,F,100,8,0,8
2014,Avey,F,100,8,0,8
2014,Avish,M,100,0,8,8
2014,Avra,F,100,8,0,8
2014,Awesome,M,100,0,8,8
2014,Axzel,M,100,0,8,8
2014,Ayaka,F,100,8,0,8
2014,Ayanni,F,100,8,0,8
2014,Aybel,M,100,0,8,8
2014,Aydeen,M,100,0,8,8
2014,Aydn,M,100,0,8,8
2014,Ayleigh,F,100,8,0,8
2014,Aythan,M,100,0,8,8
2014,Aythen,M,100,0,8,8
2014,Ayushman,M,100,0,8,8
2014,Azella,F,100,8,0,8
2014,Azyria,F,100,8,0,8
2014,Babyboy,M,100,0,8,8
2014,Bart,M,100,0,8,8
2014,Bartolo,M,100,0,8,8
2014,Basim,M,100,0,8,8
2014,Bassem,M,100,0,8,8
2014,Bautista,M,100,0,8,8
2014,Baxton,M,100,0,8,8
2014,Bayani,M,100,0,8,8
2014,Baylyn,F,100,8,0,8
2014,Belia,F,100,8,0,8
2014,Bellanie,F,100,8,0,8
2014,Bellarae,F,100,8,0,8
2014,Benjamine,M,100,0,8,8
2014,Berklie,F,100,8,0,8
2014,Bernadine,F,100,8,0,8
2014,Bess,F,100,8,0,8
2014,Bette,F,100,8,0,8
2014,Bexlee,F,100,8,0,8
2014,Bhakti,F,100,8,0,8
2014,Binah,F,100,8,0,8
2014,Bintu,F,100,8,0,8
2014,Bisan,F,100,8,0,8
2014,Bisma,F,100,8,0,8
2014,Blayre,F,100,8,0,8
2014,Boluwatife,F,100,8,0,8
2014,Brace,M,100,0,8,8
2014,Brawley,M,100,0,8,8
2014,Breauna,F,100,8,0,8
2014,Breaunna,F,100,8,0,8
2014,Breea,F,100,8,0,8
2014,Breely,F,100,8,0,8
2014,Breniyah,F,100,8,0,8
2014,Brexten,M,100,0,8,8
2014,Breyana,F,100,8,0,8
2014,Briant,M,100,0,8,8
2014,Briany,F,100,8,0,8
2014,Briceyda,F,100,8,0,8
2014,Brigston,M,100,0,8,8
2014,Brinda,F,100,8,0,8
2014,Brindle,F,100,8,0,8
2014,Brinlynn,F,100,8,0,8
2014,Brisia,F,100,8,0,8
2014,Britani,F,100,8,0,8
2014,Britlynn,F,100,8,0,8
2014,Briyah,F,100,8,0,8
2014,Briyit,F,100,8,0,8
2014,Brogen,M,100,0,8,8
2014,Bronsen,M,100,0,8,8
2014,Brynnlie,F,100,8,0,8
2014,Bryor,M,100,0,8,8
2014,Bryssa,F,100,8,0,8
2014,Brysten,M,100,0,8,8
2014,Burech,M,100,0,8,8
2014,Caffrey,M,100,0,8,8
2014,Cailan,M,100,0,8,8
2014,Caileen,F,100,8,0,8
2014,Caisley,F,100,8,0,8
2014,Cait,F,100,8,0,8
2014,Caldwell,M,100,0,8,8
2014,Calei,F,100,8,0,8
2014,Cammi,F,100,8,0,8
2014,Cammy,F,100,8,0,8
2014,Camyla,F,100,8,0,8
2014,Canelo,M,100,0,8,8
2014,Caniyah,F,100,8,0,8
2014,Cannan,M,100,0,8,8
2014,Caragh,F,100,8,0,8
2014,Cardin,M,100,0,8,8
2014,Caren,F,100,8,0,8
2014,Carin,F,100,8,0,8
2014,Carleah,F,100,8,0,8
2014,Carlia,F,100,8,0,8
2014,Caroleena,F,100,8,0,8
2014,Cashlynn,F,100,8,0,8
2014,Cassaundra,F,100,8,0,8
2014,Cavon,M,100,0,8,8
2014,Caylum,M,100,0,8,8
2014,Ceara,F,100,8,0,8
2014,Cecillia,F,100,8,0,8
2014,Celise,F,100,8,0,8
2014,Cephas,M,100,0,8,8
2014,Cerina,F,100,8,0,8
2014,Cesare,M,100,0,8,8
2014,Cesilia,F,100,8,0,8
2014,Chadrick,M,100,0,8,8
2014,Chai,F,100,8,0,8
2014,Chamar,M,100,0,8,8
2014,Chanah,F,100,8,0,8
2014,Chante,F,100,8,0,8
2014,Chanz,M,100,0,8,8
2014,Charish,F,100,8,0,8
2014,Charlii,F,100,8,0,8
2014,Chaska,M,100,0,8,8
2014,Chasyn,M,100,0,8,8
2014,Chen,M,100,0,8,8
2014,Chibuikem,M,100,0,8,8
2014,Chika,F,100,8,0,8
2014,Chinenye,F,100,8,0,8
2014,Chip,M,100,0,8,8
2014,Chiron,M,100,0,8,8
2014,Chrishaun,M,100,0,8,8
2014,Chrishelle,F,100,8,0,8
2014,Chrisley,F,100,8,0,8
2014,Chriss,M,100,0,8,8
2014,Christell,F,100,8,0,8
2014,Christionna,F,100,8,0,8
2014,Christobal,M,100,0,8,8
2014,Circe,F,100,8,0,8
2014,Cjay,M,100,0,8,8
2014,Clarita,F,100,8,0,8
2014,Cobain,M,100,0,8,8
2014,Coden,M,100,0,8,8
2014,Colbee,F,100,8,0,8
2014,Colee,F,100,8,0,8
2014,Colman,M,100,0,8,8
2014,Concetta,F,100,8,0,8
2014,Constantina,F,100,8,0,8
2014,Cope,M,100,0,8,8
2014,Copelan,M,100,0,8,8
2014,Corby,M,100,0,8,8
2014,Coretta,F,100,8,0,8
2014,Coreyon,M,100,0,8,8
2014,Corrado,M,100,0,8,8
2014,Court,M,100,0,8,8
2014,Couture,F,100,8,0,8
2014,Craven,M,100,0,8,8
2014,Crockett,M,100,0,8,8
2014,Crystiana,F,100,8,0,8
2014,Cylen,M,100,0,8,8
2014,Cypher,M,100,0,8,8
2014,Daedric,M,100,0,8,8
2014,Dahir,M,100,0,8,8
2014,Daimen,M,100,0,8,8
2014,Daina,F,100,8,0,8
2014,Daisymae,F,100,8,0,8
2014,Dakhari,M,100,0,8,8
2014,Dalana,F,100,8,0,8
2014,Dalayla,F,100,8,0,8
2014,Damara,F,100,8,0,8
2014,Damarious,M,100,0,8,8
2014,Damarko,M,100,0,8,8
2014,Dameir,M,100,0,8,8
2014,Damerion,M,100,0,8,8
2014,Damyla,F,100,8,0,8
2014,Danai,F,100,8,0,8
2014,Dangel,M,100,0,8,8
2014,Danikah,F,100,8,0,8
2014,Danner,M,100,0,8,8
2014,Danniella,F,100,8,0,8
2014,Dannilynn,F,100,8,0,8
2014,Dantrell,M,100,0,8,8
2014,Daoud,M,100,0,8,8
2014,Daralyn,F,100,8,0,8
2014,Darly,F,100,8,0,8
2014,Daryah,F,100,8,0,8
2014,Daryana,F,100,8,0,8
2014,Dauda,M,100,0,8,8
2014,Davell,M,100,0,8,8
2014,Davieon,M,100,0,8,8
2014,Davier,M,100,0,8,8
2014,Davinci,M,100,0,8,8
2014,Davine,F,100,8,0,8
2014,Daviona,F,100,8,0,8
2014,Daviyon,M,100,0,8,8
2014,Davyan,M,100,0,8,8
2014,Daymar,M,100,0,8,8
2014,Dayten,M,100,0,8,8
2014,Dayven,M,100,0,8,8
2014,Deandria,F,100,8,0,8
2014,Dechlan,M,100,0,8,8
2014,Deethya,F,100,8,0,8
2014,Deidra,F,100,8,0,8
2014,Deijah,F,100,8,0,8
2014,Dejanae,F,100,8,0,8
2014,Delan,M,100,0,8,8
2014,Delancey,F,100,8,0,8
2014,Delante,M,100,0,8,8
2014,Deleah,F,100,8,0,8
2014,Delight,F,100,8,0,8
2014,Deliliah,F,100,8,0,8
2014,Dell,M,100,0,8,8
2014,Delmer,M,100,0,8,8
2014,Delontae,M,100,0,8,8
2014,Delphina,F,100,8,0,8
2014,Delwin,M,100,0,8,8
2014,Delwyn,M,100,0,8,8
2014,Demarian,M,100,0,8,8
2014,Demilade,M,100,0,8,8
2014,Demon,M,100,0,8,8
2014,Denario,M,100,0,8,8
2014,Deniya,F,100,8,0,8
2014,Dennison,M,100,0,8,8
2014,Denyla,F,100,8,0,8
2014,Derriona,F,100,8,0,8
2014,Deshawna,F,100,8,0,8
2014,Deston,M,100,0,8,8
2014,Devanshi,F,100,8,0,8
2014,Devonna,F,100,8,0,8
2014,Devontay,M,100,0,8,8
2014,Dewan,M,100,0,8,8
2014,Dextin,M,100,0,8,8
2014,Dezlyn,F,100,8,0,8
2014,Dharius,M,100,0,8,8
2014,Dhruvin,M,100,0,8,8
2014,Dhyey,M,100,0,8,8
2014,Dillin,M,100,0,8,8
2014,Diogo,M,100,0,8,8
2014,Diona,F,100,8,0,8
2014,Dionel,M,100,0,8,8
2014,Diovanni,M,100,0,8,8
2014,Divit,M,100,0,8,8
2014,Dixielynn,F,100,8,0,8
2014,Dlyla,F,100,8,0,8
2014,Dmichael,M,100,0,8,8
2014,Doha,F,100,8,0,8
2014,Dominion,M,100,0,8,8
2014,Domnik,M,100,0,8,8
2014,Domonick,M,100,0,8,8
2014,Doniel,M,100,0,8,8
2014,Donoven,M,100,0,8,8
2014,Doren,M,100,0,8,8
2014,Dovie,F,100,8,0,8
2014,Doyle,M,100,0,8,8
2014,Drace,M,100,0,8,8
2014,Dreanna,F,100,8,0,8
2014,Dshaun,M,100,0,8,8
2014,Dudley,M,100,0,8,8
2014,Durant,M,100,0,8,8
2014,Dustie,F,100,8,0,8
2014,Dwan,M,100,0,8,8
2014,Dyami,M,100,0,8,8
2014,Dylin,F,100,8,0,8
2014,Dyron,M,100,0,8,8
2014,Earon,M,100,0,8,8
2014,Eathen,M,100,0,8,8
2014,Ebraheem,M,100,0,8,8
2014,Edda,F,100,8,0,8
2014,Edder,M,100,0,8,8
2014,Edeline,F,100,8,0,8
2014,Edilberto,M,100,0,8,8
2014,Edisson,M,100,0,8,8
2014,Edouard,M,100,0,8,8
2014,Edras,M,100,0,8,8
2014,Efrem,M,100,0,8,8
2014,Eilan,M,100,0,8,8
2014,Eislee,F,100,8,0,8
2014,Eissa,M,100,0,8,8
2014,Ekansh,M,100,0,8,8
2014,Elai,M,100,0,8,8
2014,Elek,M,100,0,8,8
2014,Elexus,F,100,8,0,8
2014,Eliahs,M,100,0,8,8
2014,Eliav,M,100,0,8,8
2014,Eline,F,100,8,0,8
2014,Elioenai,M,100,0,8,8
2014,Elizabelle,F,100,8,0,8
2014,Elizabeta,F,100,8,0,8
2014,Ellaree,F,100,8,0,8
2014,Elleni,F,100,8,0,8
2014,Ellenor,F,100,8,0,8
2014,Ellesyn,F,100,8,0,8
2014,Ellinore,F,100,8,0,8
2014,Elliza,F,100,8,0,8
2014,Ellsa,F,100,8,0,8
2014,Ellyette,F,100,8,0,8
2014,Eloni,F,100,8,0,8
2014,Elsee,F,100,8,0,8
2014,Elyzah,F,100,8,0,8
2014,Emanda,F,100,8,0,8
2014,Emanie,F,100,8,0,8
2014,Emanual,M,100,0,8,8
2014,Emerly,F,100,8,0,8
2014,Emerlyn,F,100,8,0,8
2014,Emeryn,F,100,8,0,8
2014,Emilianna,F,100,8,0,8
2014,Emilija,F,100,8,0,8
2014,Emilina,F,100,8,0,8
2014,Emira,F,100,8,0,8
2014,Emlyn,F,100,8,0,8
2014,Emmasofia,F,100,8,0,8
2014,Emmiline,F,100,8,0,8
2014,Empriss,F,100,8,0,8
2014,Emryn,F,100,8,0,8
2014,Emslee,F,100,8,0,8
2014,Enijah,F,100,8,0,8
2014,Ennis,M,100,0,8,8
2014,Enzio,M,100,0,8,8
2014,Epifanio,M,100,0,8,8
2014,Erek,M,100,0,8,8
2014,Erez,M,100,0,8,8
2014,Eriona,F,100,8,0,8
2014,Eriq,M,100,0,8,8
2014,Erryn,F,100,8,0,8
2014,Ervey,M,100,0,8,8
2014,Esta,F,100,8,0,8
2014,Esten,M,100,0,8,8
2014,Esteven,M,100,0,8,8
2014,Esti,F,100,8,0,8
2014,Eugenie,F,100,8,0,8
2014,Euriah,M,100,0,8,8
2014,Evalette,F,100,8,0,8
2014,Evanee,F,100,8,0,8
2014,Evangaline,F,100,8,0,8
2014,Eveleigh,F,100,8,0,8
2014,Evelio,M,100,0,8,8
2014,Evelynrose,F,100,8,0,8
2014,Everdeen,F,100,8,0,8
2014,Evert,M,100,0,8,8
2014,Evvie,F,100,8,0,8
2014,Eyla,F,100,8,0,8
2014,Eyonna,F,100,8,0,8
2014,Ezavier,M,100,0,8,8
2014,Ezekeil,M,100,0,8,8
2014,Fallou,M,100,0,8,8
2014,Fallynn,F,100,8,0,8
2014,Faraz,M,100,0,8,8
2014,Farheen,F,100,8,0,8
2014,Faron,M,100,0,8,8
2014,Fatemah,F,100,8,0,8
2014,Fatimazahra,F,100,8,0,8
2014,Faviola,F,100,8,0,8
2014,Fawaz,M,100,0,8,8
2014,Fortino,M,100,0,8,8
2014,Franceska,F,100,8,0,8
2014,Fransisco,M,100,0,8,8
2014,Fynleigh,F,100,8,0,8
2014,Gaberial,M,100,0,8,8
2014,Gable,M,100,0,8,8
2014,Gambit,M,100,0,8,8
2014,Gatlynn,M,100,0,8,8
2014,Gayathri,F,100,8,0,8
2014,Gedeon,M,100,0,8,8
2014,Geena,F,100,8,0,8
2014,Geet,F,100,8,0,8
2014,Gelena,F,100,8,0,8
2014,Gemari,M,100,0,8,8
2014,Genae,F,100,8,0,8
2014,Geonni,M,100,0,8,8
2014,Gerrod,M,100,0,8,8
2014,Ghalia,F,100,8,0,8
2014,Giah,F,100,8,0,8
2014,Gianno,M,100,0,8,8
2014,Gibril,M,100,0,8,8
2014,Ginevra,F,100,8,0,8
2014,Ginna,F,100,8,0,8
2014,Gioni,M,100,0,8,8
2014,Giovan,M,100,0,8,8
2014,Giovana,F,100,8,0,8
2014,Gissele,F,100,8,0,8
2014,Giuseppina,F,100,8,0,8
2014,Glendy,F,100,8,0,8
2014,Gracielynn,F,100,8,0,8
2014,Graclynn,F,100,8,0,8
2014,Graiden,M,100,0,8,8
2014,Granite,M,100,0,8,8
2014,Graylyn,F,100,8,0,8
2014,Grettell,F,100,8,0,8
2014,Greylan,M,100,0,8,8
2014,Greysin,M,100,0,8,8
2014,Griffon,M,100,0,8,8
2014,Gumaro,M,100,0,8,8
2014,Gunnison,M,100,0,8,8
2014,Gursirat,F,100,8,0,8
2014,Gustaf,M,100,0,8,8
2014,Hadar,F,100,8,0,8
2014,Haddy,F,100,8,0,8
2014,Hadelyn,F,100,8,0,8
2014,Hadlea,F,100,8,0,8
2014,Haidi,F,100,8,0,8
2014,Haizel,F,100,8,0,8
2014,Haja,F,100,8,0,8
2014,Halana,F,100,8,0,8
2014,Haleemah,F,100,8,0,8
2014,Hally,F,100,8,0,8
2014,Hamda,F,100,8,0,8
2014,Hamlet,M,100,0,8,8
2014,Hansika,F,100,8,0,8
2014,Haoyu,M,100,0,8,8
2014,Hardin,M,100,0,8,8
2014,Harith,M,100,0,8,8
2014,Haron,M,100,0,8,8
2014,Harrell,M,100,0,8,8
2014,Harshan,M,100,0,8,8
2014,Harshitha,F,100,8,0,8
2014,Haruma,M,100,0,8,8
2014,Harveen,F,100,8,0,8
2014,Hassen,M,100,0,8,8
2014,Haston,M,100,0,8,8
2014,Hatley,F,100,8,0,8
2014,Hattan,M,100,0,8,8
2014,Havah,F,100,8,0,8
2014,Hayato,M,100,0,8,8
2014,Hayla,F,100,8,0,8
2014,Haylo,F,100,8,0,8
2014,Hayvn,F,100,8,0,8
2014,Hazaiah,M,100,0,8,8
2014,Heela,F,100,8,0,8
2014,Helder,M,100,0,8,8
2014,Helem,F,100,8,0,8
2014,Hendry,M,100,0,8,8
2014,Hermes,M,100,0,8,8
2014,Herminio,M,100,0,8,8
2014,Heyli,F,100,8,0,8
2014,Hidaya,F,100,8,0,8
2014,Hiilani,F,100,8,0,8
2014,Hill,M,100,0,8,8
2014,Hiroto,M,100,0,8,8
2014,Hitesh,M,100,0,8,8
2014,Hobbes,M,100,0,8,8
2014,Holliday,F,100,8,0,8
2014,Hooper,M,100,0,8,8
2014,Husain,M,100,0,8,8
2014,Husam,M,100,0,8,8
2014,Hynlee,F,100,8,0,8
2014,Iaan,M,100,0,8,8
2014,Iana,F,100,8,0,8
2014,Ilai,M,100,0,8,8
2014,Ilea,F,100,8,0,8
2014,Ileanna,F,100,8,0,8
2014,Ileigh,F,100,8,0,8
2014,Iliza,F,100,8,0,8
2014,Illyria,F,100,8,0,8
2014,Ilynn,F,100,8,0,8
2014,Inas,F,100,8,0,8
2014,Indio,M,100,0,8,8
2014,Indiyah,F,100,8,0,8
2014,Inman,M,100,0,8,8
2014,Innocence,F,100,8,0,8
2014,Iriel,F,100,8,0,8
2014,Irisa,F,100,8,0,8
2014,Isabellamarie,F,100,8,0,8
2014,Isatou,F,100,8,0,8
2014,Isebella,F,100,8,0,8
2014,Ishanth,M,100,0,8,8
2014,Isibeal,F,100,8,0,8
2014,Islay,F,100,8,0,8
2014,Issam,M,100,0,8,8
2014,Itzayanna,F,100,8,0,8
2014,Ivannia,F,100,8,0,8
2014,Iyahna,F,100,8,0,8
2014,Izariah,F,100,8,0,8
2014,Izela,F,100,8,0,8
2014,Izzak,M,100,0,8,8
2014,Jaala,F,100,8,0,8
2014,Jacaden,M,100,0,8,8
2014,Jacayden,M,100,0,8,8
2014,Jacianna,F,100,8,0,8
2014,Jackman,M,100,0,8,8
2014,Jadamarie,F,100,8,0,8
2014,Jadesola,F,100,8,0,8
2014,Jadien,M,100,0,8,8
2014,Jaecob,M,100,0,8,8
2014,Jaecyon,M,100,0,8,8
2014,Jaeleah,F,100,8,0,8
2014,Jago,M,100,0,8,8
2014,Jahad,M,100,0,8,8
2014,Jahara,F,100,8,0,8
2014,Jahden,M,100,0,8,8
2014,Jahking,M,100,0,8,8
2014,Jahmire,M,100,0,8,8
2014,Jahn,M,100,0,8,8
2014,Jahnvi,F,100,8,0,8
2014,Jahnyah,F,100,8,0,8
2014,Jahzelle,F,100,8,0,8
2014,Jaicyon,M,100,0,8,8
2014,Jaimy,F,100,8,0,8
2014,Jaine,F,100,8,0,8
2014,Jaivyn,M,100,0,8,8
2014,Jaiyah,F,100,8,0,8
2014,Jakaila,F,100,8,0,8
2014,Jakeira,F,100,8,0,8
2014,Jaken,M,100,0,8,8
2014,Jaki,M,100,0,8,8
2014,Jakorian,M,100,0,8,8
2014,Jakory,M,100,0,8,8
2014,Jakyri,M,100,0,8,8
2014,Jalaina,F,100,8,0,8
2014,Jalayia,F,100,8,0,8
2014,Jaleen,F,100,8,0,8
2014,Jaleena,F,100,8,0,8
2014,Jalyric,F,100,8,0,8
2014,Jalysa,F,100,8,0,8
2014,Jamaar,M,100,0,8,8
2014,Jamahl,M,100,0,8,8
2014,Jamaine,M,100,0,8,8
2014,Jamare,M,100,0,8,8
2014,Jamareon,M,100,0,8,8
2014,Jamela,F,100,8,0,8
2014,Jamicheal,M,100,0,8,8
2014,Jamill,M,100,0,8,8
2014,Jammie,F,100,8,0,8
2014,Jamont,M,100,0,8,8
2014,Jamyria,F,100,8,0,8
2014,Jamyron,M,100,0,8,8
2014,Janaiah,F,100,8,0,8
2014,Janeen,F,100,8,0,8
2014,Janett,F,100,8,0,8
2014,Janetzy,F,100,8,0,8
2014,Janeya,F,100,8,0,8
2014,Janicia,F,100,8,0,8
2014,Janique,F,100,8,0,8
2014,Janisa,F,100,8,0,8
2014,Jannel,F,100,8,0,8
2014,Janziel,M,100,0,8,8
2014,Jaquon,M,100,0,8,8
2014,Jaray,M,100,0,8,8
2014,Jarielys,F,100,8,0,8
2014,Jasenia,F,100,8,0,8
2014,Jasier,M,100,0,8,8
2014,Jasmeen,F,100,8,0,8
2014,Jassmine,F,100,8,0,8
2014,Javaya,F,100,8,0,8
2014,Javelle,M,100,0,8,8
2014,Javone,M,100,0,8,8
2014,Jawan,M,100,0,8,8
2014,Jaxlynn,F,100,8,0,8
2014,Jayanthony,M,100,0,8,8
2014,Jaycub,M,100,0,8,8
2014,Jayliah,F,100,8,0,8
2014,Jaymien,M,100,0,8,8
2014,Jayriel,M,100,0,8,8
2014,Jayro,M,100,0,8,8
2014,Jayzon,M,100,0,8,8
2014,Jazale,F,100,8,0,8
2014,Jazara,F,100,8,0,8
2014,Jazir,M,100,0,8,8
2014,Jazmen,F,100,8,0,8
2014,Jazmere,F,100,8,0,8
2014,Jazyiah,F,100,8,0,8
2014,Jazzalynn,F,100,8,0,8
2014,Jazzy,F,100,8,0,8
2014,Jb,M,100,0,8,8
2014,Jceion,M,100,0,8,8
2014,Jefferey,M,100,0,8,8
2014,Jehiel,M,100,0,8,8
2014,Jemmah,F,100,8,0,8
2014,Jenah,F,100,8,0,8
2014,Jenaveve,F,100,8,0,8
2014,Jenice,F,100,8,0,8
2014,Jenin,F,100,8,0,8
2014,Jentzen,M,100,0,8,8
2014,Jeovany,M,100,0,8,8
2014,Jeramie,M,100,0,8,8
2014,Jeramih,M,100,0,8,8
2014,Jerek,M,100,0,8,8
2014,Jeri,F,100,8,0,8
2014,Jerik,M,100,0,8,8
2014,Jeriko,M,100,0,8,8
2014,Jermayne,M,100,0,8,8
2014,Jermel,M,100,0,8,8
2014,Jerni,F,100,8,0,8
2014,Jerric,M,100,0,8,8
2014,Jerriyah,F,100,8,0,8
2014,Jesiel,M,100,0,8,8
2014,Jessabelle,F,100,8,0,8
2014,Jesselle,F,100,8,0,8
2014,Jetzael,M,100,0,8,8
2014,Jeylah,F,100,8,0,8
2014,Jeyshangelise,F,100,8,0,8
2014,Jezabell,F,100,8,0,8
2014,Jezabella,F,100,8,0,8
2014,Jezlyn,F,100,8,0,8
2014,Jhace,M,100,0,8,8
2014,Jhostin,M,100,0,8,8
2014,Jhovanny,M,100,0,8,8
2014,Jiali,F,100,8,0,8
2014,Jiles,M,100,0,8,8
2014,Jisel,F,100,8,0,8
2014,Jishnu,M,100,0,8,8
2014,Jisselle,F,100,8,0,8
2014,Jivan,M,100,0,8,8
2014,Joas,M,100,0,8,8
2014,Jocilyn,F,100,8,0,8
2014,Joelly,F,100,8,0,8
2014,Johany,F,100,8,0,8
2014,Johndaniel,M,100,0,8,8
2014,Johnnae,F,100,8,0,8
2014,Johnston,M,100,0,8,8
2014,Johnwilliam,M,100,0,8,8
2014,Johonna,F,100,8,0,8
2014,Joia,F,100,8,0,8
2014,Joliana,F,100,8,0,8
2014,Joliyah,F,100,8,0,8
2014,Joncarlo,M,100,0,8,8
2014,Joncarlos,M,100,0,8,8
2014,Jonier,F,100,8,0,8
2014,Jontae,M,100,0,8,8
2014,Jordie,M,100,0,8,8
2014,Jordyan,F,100,8,0,8
2014,Jordynne,F,100,8,0,8
2014,Joslynne,F,100,8,0,8
2014,Jospeh,M,100,0,8,8
2014,Jossue,M,100,0,8,8
2014,Jourden,M,100,0,8,8
2014,Journiee,F,100,8,0,8
2014,Jovanie,M,100,0,8,8
2014,Jovaughn,M,100,0,8,8
2014,Jovin,M,100,0,8,8
2014,Jovita,F,100,8,0,8
2014,Jozey,F,100,8,0,8
2014,Joziyah,M,100,0,8,8
2014,Juandavid,M,100,0,8,8
2014,Juddson,M,100,0,8,8
2014,Judit,F,100,8,0,8
2014,Juliah,F,100,8,0,8
2014,Juliane,F,100,8,0,8
2014,Julianny,F,100,8,0,8
2014,Juliany,F,100,8,0,8
2014,Julyana,F,100,8,0,8
2014,Juman,F,100,8,0,8
2014,Jveon,M,100,0,8,8
2014,Kabria,F,100,8,0,8
2014,Kache,M,100,0,8,8
2014,Kadar,M,100,0,8,8
2014,Kaelum,M,100,0,8,8
2014,Kaeya,F,100,8,0,8
2014,Kaien,M,100,0,8,8
2014,Kaikoa,M,100,0,8,8
2014,Kailand,F,100,8,0,8
2014,Kailynne,F,100,8,0,8
2014,Kainoah,M,100,0,8,8
2014,Kaity,F,100,8,0,8
2014,Kaiyon,M,100,0,8,8
2014,Kalden,M,100,0,8,8
2014,Kaleeyah,F,100,8,0,8
2014,Kaleiah,F,100,8,0,8
2014,Kaloyan,M,100,0,8,8
2014,Kamariah,F,100,8,0,8
2014,Kamariya,F,100,8,0,8
2014,Kamarri,M,100,0,8,8
2014,Kamile,F,100,8,0,8
2014,Kammie,F,100,8,0,8
2014,Kania,F,100,8,0,8
2014,Kanya,F,100,8,0,8
2014,Kanyah,F,100,8,0,8
2014,Kap,M,100,0,8,8
2014,Kaplan,M,100,0,8,8
2014,Karalyne,F,100,8,0,8
2014,Karee,F,100,8,0,8
2014,Karenna,F,100,8,0,8
2014,Karimah,F,100,8,0,8
2014,Karlita,F,100,8,0,8
2014,Karmina,F,100,8,0,8
2014,Karmine,M,100,0,8,8
2014,Karmynn,F,100,8,0,8
2014,Karolyne,F,100,8,0,8
2014,Karthika,F,100,8,0,8
2014,Kasi,F,100,8,0,8
2014,Kaspar,M,100,0,8,8
2014,Kassem,M,100,0,8,8
2014,Kassim,M,100,0,8,8
2014,Kasten,M,100,0,8,8
2014,Katelina,F,100,8,0,8
2014,Kathie,F,100,8,0,8
2014,Kathlene,F,100,8,0,8
2014,Katrell,M,100,0,8,8
2014,Katrin,F,100,8,0,8
2014,Kaveh,M,100,0,8,8
2014,Kavian,M,100,0,8,8
2014,Kawthar,F,100,8,0,8
2014,Kayaan,M,100,0,8,8
2014,Kaybrie,F,100,8,0,8
2014,Kaydi,F,100,8,0,8
2014,Kayedence,F,100,8,0,8
2014,Kaylina,F,100,8,0,8
2014,Kayline,F,100,8,0,8
2014,Kayron,M,100,0,8,8
2014,Kaysee,F,100,8,0,8
2014,Kaysia,F,100,8,0,8
2014,Kayslee,F,100,8,0,8
2014,Kayzen,M,100,0,8,8
2014,Kazen,M,100,0,8,8
2014,Kazmir,M,100,0,8,8
2014,Keaden,M,100,0,8,8
2014,Keandra,F,100,8,0,8
2014,Kedar,M,100,0,8,8
2014,Keenen,M,100,0,8,8
2014,Keerthi,F,100,8,0,8
2014,Keimya,F,100,8,0,8
2014,Keirstyn,F,100,8,0,8
2014,Keiston,M,100,0,8,8
2014,Keita,M,100,0,8,8
2014,Kellyann,F,100,8,0,8
2014,Kelsa,F,100,8,0,8
2014,Kelty,F,100,8,0,8
2014,Kemaya,F,100,8,0,8
2014,Kemet,M,100,0,8,8
2014,Kemyah,F,100,8,0,8
2014,Kendre,M,100,0,8,8
2014,Kenlynn,F,100,8,0,8
2014,Kenni,F,100,8,0,8
2014,Kensei,M,100,0,8,8
2014,Kentrel,M,100,0,8,8
2014,Keonta,M,100,0,8,8
2014,Keontay,M,100,0,8,8
2014,Keria,F,100,8,0,8
2014,Kerina,F,100,8,0,8
2014,Kerolos,M,100,0,8,8
2014,Kesten,M,100,0,8,8
2014,Kevaughn,M,100,0,8,8
2014,Keyani,F,100,8,0,8
2014,Keylon,M,100,0,8,8
2014,Keyoni,F,100,8,0,8
2014,Kha,M,100,0,8,8
2014,Khadim,M,100,0,8,8
2014,Khailey,F,100,8,0,8
2014,Khalaya,F,100,8,0,8
2014,Khaleesia,F,100,8,0,8
2014,Khalon,M,100,0,8,8
2014,Khiana,F,100,8,0,8
2014,Khoen,M,100,0,8,8
2014,Khris,M,100,0,8,8
2014,Khyra,F,100,8,0,8
2014,Kiandra,F,100,8,0,8
2014,Kianni,F,100,8,0,8
2014,Kieara,F,100,8,0,8
2014,Kiele,F,100,8,0,8
2014,Kierin,M,100,0,8,8
2014,Kilan,M,100,0,8,8
2014,Kile,M,100,0,8,8
2014,Kimberleigh,F,100,8,0,8
2014,Kimbria,F,100,8,0,8
2014,Kimia,F,100,8,0,8
2014,Kincade,M,100,0,8,8
2014,Kinlynn,F,100,8,0,8
2014,Kinsli,F,100,8,0,8
2014,Kinzli,F,100,8,0,8
2014,Kionna,F,100,8,0,8
2014,Kiralynn,F,100,8,0,8
2014,Kiyanna,F,100,8,0,8
2014,Kiyara,F,100,8,0,8
2014,Klare,F,100,8,0,8
2014,Klarity,F,100,8,0,8
2014,Klark,M,100,0,8,8
2014,Klee,F,100,8,0,8
2014,Knoelle,F,100,8,0,8
2014,Knylah,F,100,8,0,8
2014,Koal,M,100,0,8,8
2014,Kobain,M,100,0,8,8
2014,Kohana,F,100,8,0,8
2014,Koki,M,100,0,8,8
2014,Konor,M,100,0,8,8
2014,Kordelia,F,100,8,0,8
2014,Kortnee,F,100,8,0,8
2014,Kortni,F,100,8,0,8
2014,Kourtnie,F,100,8,0,8
2014,Kovin,M,100,0,8,8
2014,Krayton,M,100,0,8,8
2014,Krina,F,100,8,0,8
2014,Krisalyn,F,100,8,0,8
2014,Krishika,F,100,8,0,8
2014,Kruthi,F,100,8,0,8
2014,Kseniya,F,100,8,0,8
2014,Kwesi,M,100,0,8,8
2014,Kydin,M,100,0,8,8
2014,Kyen,M,100,0,8,8
2014,Kyera,F,100,8,0,8
2014,Kylian,M,100,0,8,8
2014,Kylo,M,100,0,8,8
2014,Kynnlee,F,100,8,0,8
2014,Kyrion,M,100,0,8,8
2014,Kyros,M,100,0,8,8
2014,Laban,M,100,0,8,8
2014,Ladarious,M,100,0,8,8
2014,Laelle,F,100,8,0,8
2014,Lailie,F,100,8,0,8
2014,Lala,F,100,8,0,8
2014,Lamani,F,100,8,0,8
2014,Lamarkus,M,100,0,8,8
2014,Lamere,M,100,0,8,8
2014,Lamis,F,100,8,0,8
2014,Lanessa,F,100,8,0,8
2014,Laray,F,100,8,0,8
2014,Laritza,F,100,8,0,8
2014,Larose,F,100,8,0,8
2014,Laryn,F,100,8,0,8
2014,Latonya,F,100,8,0,8
2014,Lauran,F,100,8,0,8
2014,Laurelle,F,100,8,0,8
2014,Lavin,M,100,0,8,8
2014,Lavontay,M,100,0,8,8
2014,Lawayne,M,100,0,8,8
2014,Laylarose,F,100,8,0,8
2014,Layney,F,100,8,0,8
2014,Layza,F,100,8,0,8
2014,Leahanna,F,100,8,0,8
2014,Lealand,M,100,0,8,8
2014,Leandrew,M,100,0,8,8
2014,Leani,F,100,8,0,8
2014,Leddy,F,100,8,0,8
2014,Ledion,M,100,0,8,8
2014,Legen,M,100,0,8,8
2014,Leialoha,F,100,8,0,8
2014,Leib,M,100,0,8,8
2014,Leighlah,F,100,8,0,8
2014,Leilanii,F,100,8,0,8
2014,Leilanny,F,100,8,0,8
2014,Leisha,F,100,8,0,8
2014,Lenae,F,100,8,0,8
2014,Leniel,M,100,0,8,8
2014,Lenka,F,100,8,0,8
2014,Leonell,M,100,0,8,8
2014,Leonitus,M,100,0,8,8
2014,Leovanni,M,100,0,8,8
2014,Lera,F,100,8,0,8
2014,Les,M,100,0,8,8
2014,Levia,F,100,8,0,8
2014,Lexxie,F,100,8,0,8
2014,Leyani,F,100,8,0,8
2014,Leyden,M,100,0,8,8
2014,Leydi,F,100,8,0,8
2014,Liala,F,100,8,0,8
2014,Libbi,F,100,8,0,8
2014,Lidiya,F,100,8,0,8
2014,Lidya,F,100,8,0,8
2014,Lihanna,F,100,8,0,8
2014,Lilu,F,100,8,0,8
2014,Lilygrace,F,100,8,0,8
2014,Lima,F,100,8,0,8
2014,Linaya,F,100,8,0,8
2014,Liston,M,100,0,8,8
2014,Lium,M,100,0,8,8
2014,Livvie,F,100,8,0,8
2014,Liyanna,F,100,8,0,8
2014,Liyu,F,100,8,0,8
2014,Loay,M,100,0,8,8
2014,Lochlynn,F,100,8,0,8
2014,Loden,M,100,0,8,8
2014,Loie,F,100,8,0,8
2014,Loni,F,100,8,0,8
2014,Lonnell,M,100,0,8,8
2014,Lonny,M,100,0,8,8
2014,Lorel,F,100,8,0,8
2014,Lorianne,F,100,8,0,8
2014,Lorien,F,100,8,0,8
2014,Louisiana,F,100,8,0,8
2014,Lovelynn,F,100,8,0,8
2014,Loyalti,F,100,8,0,8
2014,Lucette,F,100,8,0,8
2014,Lucyna,F,100,8,0,8
2014,Luisantonio,M,100,0,8,8
2014,Lujane,F,100,8,0,8
2014,Lumi,F,100,8,0,8
2014,Lundynn,F,100,8,0,8
2014,Luzmarie,F,100,8,0,8
2014,Lyberti,F,100,8,0,8
2014,Lyliah,F,100,8,0,8
2014,Lyllah,F,100,8,0,8
2014,Lynnon,F,100,8,0,8
2014,Lyonel,M,100,0,8,8
2014,Lyricc,F,100,8,0,8
2014,Lysette,F,100,8,0,8
2014,Macari,M,100,0,8,8
2014,Macklen,M,100,0,8,8
2014,Macksen,M,100,0,8,8
2014,Maddisen,F,100,8,0,8
2014,Maddock,M,100,0,8,8
2014,Madelina,F,100,8,0,8
2014,Madicyn,F,100,8,0,8
2014,Maecy,F,100,8,0,8
2014,Maezie,F,100,8,0,8
2014,Mahalakshmi,F,100,8,0,8
2014,Maham,F,100,8,0,8
2014,Mahan,M,100,0,8,8
2014,Mahdiya,F,100,8,0,8
2014,Mahin,M,100,0,8,8
2014,Mahitha,F,100,8,0,8
2014,Mahreen,F,100,8,0,8
2014,Maicon,M,100,0,8,8
2014,Maikol,M,100,0,8,8
2014,Maisley,F,100,8,0,8
2014,Majeed,M,100,0,8,8
2014,Makaelah,F,100,8,0,8
2014,Makaiah,F,100,8,0,8
2014,Makailey,F,100,8,0,8
2014,Makaveli,M,100,0,8,8
2014,Makayah,F,100,8,0,8
2014,Makhiya,F,100,8,0,8
2014,Makinsey,F,100,8,0,8
2014,Makinzee,F,100,8,0,8
2014,Makinzy,F,100,8,0,8
2014,Makira,F,100,8,0,8
2014,Makylee,F,100,8,0,8
2014,Makynlie,F,100,8,0,8
2014,Malakie,M,100,0,8,8
2014,Maleeha,F,100,8,0,8
2014,Maleeka,F,100,8,0,8
2014,Maleik,M,100,0,8,8
2014,Maleiya,F,100,8,0,8
2014,Malekai,M,100,0,8,8
2014,Malini,F,100,8,0,8
2014,Malyia,F,100,8,0,8
2014,Malynn,F,100,8,0,8
2014,Manas,M,100,0,8,8
2014,Manases,M,100,0,8,8
2014,Manjot,M,100,0,8,8
2014,Mansur,M,100,0,8,8
2014,Manvir,M,100,0,8,8
2014,Marae,F,100,8,0,8
2014,Maranatha,F,100,8,0,8
2014,Margalit,F,100,8,0,8
2014,Margie,F,100,8,0,8
2014,Mariadelcarmen,F,100,8,0,8
2014,Marielis,F,100,8,0,8
2014,Marien,F,100,8,0,8
2014,Marigny,F,100,8,0,8
2014,Marilin,F,100,8,0,8
2014,Marily,F,100,8,0,8
2014,Markai,M,100,0,8,8
2014,Markhi,M,100,0,8,8
2014,Markon,M,100,0,8,8
2014,Marlenne,F,100,8,0,8
2014,Marsden,M,100,0,8,8
2014,Marshay,F,100,8,0,8
2014,Marshun,M,100,0,8,8
2014,Marvelous,M,100,0,8,8
2014,Marylyn,F,100,8,0,8
2014,Marypaz,F,100,8,0,8
2014,Masey,F,100,8,0,8
2014,Massiel,F,100,8,0,8
2014,Mathius,M,100,0,8,8
2014,Matison,F,100,8,0,8
2014,Matisse,F,100,8,0,8
2014,Matthijs,M,100,0,8,8
2014,Mattis,M,100,0,8,8
2014,Mattisyn,F,100,8,0,8
2014,Matyas,M,100,0,8,8
2014,Mavryck,M,100,0,8,8
2014,Maxie,F,100,8,0,8
2014,Maximiano,M,100,0,8,8
2014,Mayana,F,100,8,0,8
2014,Mayank,M,100,0,8,8
2014,Maygan,F,100,8,0,8
2014,Mayme,F,100,8,0,8
2014,Mayukh,M,100,0,8,8
2014,Mazal,F,100,8,0,8
2014,Mazey,F,100,8,0,8
2014,Mcarthur,M,100,0,8,8
2014,Mckinna,F,100,8,0,8
2014,Mckoy,M,100,0,8,8
2014,Mckynleigh,F,100,8,0,8
2014,Mckynlie,F,100,8,0,8
2014,Mechel,M,100,0,8,8
2014,Meekah,F,100,8,0,8
2014,Meerab,F,100,8,0,8
2014,Megumi,F,100,8,0,8
2014,Meilin,F,100,8,0,8
2014,Meilyn,F,100,8,0,8
2014,Meirav,F,100,8,0,8
2014,Meisha,F,100,8,0,8
2014,Meka,F,100,8,0,8
2014,Melo,M,100,0,8,8
2014,Meloney,F,100,8,0,8
2014,Mely,F,100,8,0,8
2014,Menelik,M,100,0,8,8
2014,Meri,F,100,8,0,8
2014,Meriah,F,100,8,0,8
2014,Merina,F,100,8,0,8
2014,Meshach,M,100,0,8,8
2014,Meziah,M,100,0,8,8
2014,Mi,F,100,8,0,8
2014,Mialani,F,100,8,0,8
2014,Mian,M,100,0,8,8
2014,Miani,F,100,8,0,8
2014,Mickael,M,100,0,8,8
2014,Miela,F,100,8,0,8
2014,Mihira,F,100,8,0,8
2014,Miken,M,100,0,8,8
2014,Milaina,F,100,8,0,8
2014,Milina,F,100,8,0,8
2014,Minah,F,100,8,0,8
2014,Minami,F,100,8,0,8
2014,Mirage,F,100,8,0,8
2014,Miray,F,100,8,0,8
2014,Mirelle,F,100,8,0,8
2014,Mitra,F,100,8,0,8
2014,Mitt,M,100,0,8,8
2014,Moayad,M,100,0,8,8
2014,Modesto,M,100,0,8,8
2014,Mohsen,M,100,0,8,8
2014,Molleigh,F,100,8,0,8
2014,Monalisa,F,100,8,0,8
2014,Montrel,M,100,0,8,8
2014,Moon,F,100,8,0,8
2014,Moriya,F,100,8,0,8
2014,Moustafa,M,100,0,8,8
2014,Moxon,M,100,0,8,8
2014,Munasar,M,100,0,8,8
2014,Muzamil,M,100,0,8,8
2014,Muzammil,M,100,0,8,8
2014,Mycal,M,100,0,8,8
2014,Mylena,F,100,8,0,8
2014,Mylia,F,100,8,0,8
2014,Mystic,F,100,8,0,8
2014,Nachmen,M,100,0,8,8
2014,Nadalynn,F,100,8,0,8
2014,Nadilyn,F,100,8,0,8
2014,Nagi,M,100,0,8,8
2014,Nahyan,M,100,0,8,8
2014,Nahzir,M,100,0,8,8
2014,Nainika,F,100,8,0,8
2014,Najib,M,100,0,8,8
2014,Nakita,F,100,8,0,8
2014,Nakyra,F,100,8,0,8
2014,Namiah,F,100,8,0,8
2014,Namit,M,100,0,8,8
2014,Nanci,F,100,8,0,8
2014,Nandi,F,100,8,0,8
2014,Nandika,F,100,8,0,8
2014,Narciso,M,100,0,8,8
2014,Nas,M,100,0,8,8
2014,Nastassia,F,100,8,0,8
2014,Natalea,F,100,8,0,8
2014,Natallia,F,100,8,0,8
2014,Natayla,F,100,8,0,8
2014,Nathalya,F,100,8,0,8
2014,Nathanel,M,100,0,8,8
2014,Navee,F,100,8,0,8
2014,Naydeen,F,100,8,0,8
2014,Nayef,M,100,0,8,8
2014,Naylee,F,100,8,0,8
2014,Naylin,F,100,8,0,8
2014,Nazim,M,100,0,8,8
2014,Nazly,F,100,8,0,8
2014,Nefertari,F,100,8,0,8
2014,Neilah,F,100,8,0,8
2014,Nene,F,100,8,0,8
2014,Neoma,F,100,8,0,8
2014,Neriya,F,100,8,0,8
2014,Netra,F,100,8,0,8
2014,Netta,F,100,8,0,8
2014,Neysa,F,100,8,0,8
2014,Neytiri,F,100,8,0,8
2014,Neziah,M,100,0,8,8
2014,Ngun,F,100,8,0,8
2014,Nhu,F,100,8,0,8
2014,Niaomi,F,100,8,0,8
2014,Nicanor,M,100,0,8,8
2014,Nicko,M,100,0,8,8
2014,Nieves,F,100,8,0,8
2014,Nijel,M,100,0,8,8
2014,Nikoletta,F,100,8,0,8
2014,Nilay,M,100,0,8,8
2014,Nilson,M,100,0,8,8
2014,Nio,M,100,0,8,8
2014,Nira,F,100,8,0,8
2014,Nithila,F,100,8,0,8
2014,Niyam,M,100,0,8,8
2014,Noami,F,100,8,0,8
2014,Noela,F,100,8,0,8
2014,Noelie,F,100,8,0,8
2014,Noire,F,100,8,0,8
2014,Nolynn,F,100,8,0,8
2014,Noni,F,100,8,0,8
2014,Noriyah,F,100,8,0,8
2014,Norlan,M,100,0,8,8
2014,Norvin,M,100,0,8,8
2014,Nouman,M,100,0,8,8
2014,Novelle,F,100,8,0,8
2014,Nyasha,F,100,8,0,8
2014,Nycole,F,100,8,0,8
2014,Nyella,F,100,8,0,8
2014,Nyila,F,100,8,0,8
2014,Nylaya,F,100,8,0,8
2014,Oaklan,M,100,0,8,8
2014,Oakli,F,100,8,0,8
2014,Oasis,F,100,8,0,8
2014,Oberon,M,100,0,8,8
2014,Oliveah,F,100,8,0,8
2014,Oluwafemi,M,100,0,8,8
2014,Olyver,M,100,0,8,8
2014,Omolola,F,100,8,0,8
2014,Onalee,F,100,8,0,8
2014,Onesty,F,100,8,0,8
2014,Onyinye,F,100,8,0,8
2014,Orien,M,100,0,8,8
2014,Ozil,M,100,0,8,8
2014,Ozric,M,100,0,8,8
2014,Paidyn,F,100,8,0,8
2014,Paislyn,F,100,8,0,8
2014,Pars,M,100,0,8,8
2014,Parys,F,100,8,0,8
2014,Pascale,F,100,8,0,8
2014,Pawel,M,100,0,8,8
2014,Paysley,F,100,8,0,8
2014,Payzli,F,100,8,0,8
2014,Pella,F,100,8,0,8
2014,Penley,F,100,8,0,8
2014,Penney,F,100,8,0,8
2014,Persephoni,F,100,8,0,8
2014,Phelix,M,100,0,8,8
2014,Pheona,F,100,8,0,8
2014,Pietra,F,100,8,0,8
2014,Piya,F,100,8,0,8
2014,Polette,F,100,8,0,8
2014,Poyraz,M,100,0,8,8
2014,Prabhnoor,F,100,8,0,8
2014,Pragya,F,100,8,0,8
2014,Pranita,F,100,8,0,8
2014,Prentis,M,100,0,8,8
2014,Preslyn,F,100,8,0,8
2014,Primo,M,100,0,8,8
2014,Prometheus,M,100,0,8,8
2014,Prosperity,F,100,8,0,8
2014,Psalms,M,100,0,8,8
2014,Qian,M,100,0,8,8
2014,Qirat,F,100,8,0,8
2014,Quamir,M,100,0,8,8
2014,Quillan,M,100,0,8,8
2014,Quinston,M,100,0,8,8
2014,Qusay,M,100,0,8,8
2014,Raaga,F,100,8,0,8
2014,Radiance,F,100,8,0,8
2014,Radlee,M,100,0,8,8
2014,Raelan,F,100,8,0,8
2014,Raely,F,100,8,0,8
2014,Rafan,M,100,0,8,8
2014,Rafeef,F,100,8,0,8
2014,Rahmah,F,100,8,0,8
2014,Raidon,M,100,0,8,8
2014,Raistlin,M,100,0,8,8
2014,Raman,M,100,0,8,8
2014,Ramiel,M,100,0,8,8
2014,Ramsay,M,100,0,8,8
2014,Ramyiah,F,100,8,0,8
2014,Ramzey,M,100,0,8,8
2014,Randyn,M,100,0,8,8
2014,Ranyah,F,100,8,0,8
2014,Rarity,F,100,8,0,8
2014,Raveena,F,100,8,0,8
2014,Ravneet,F,100,8,0,8
2014,Rawson,M,100,0,8,8
2014,Raymir,M,100,0,8,8
2014,Raynell,M,100,0,8,8
2014,Raynor,M,100,0,8,8
2014,Rayshun,M,100,0,8,8
2014,Rayson,M,100,0,8,8
2014,Reco,M,100,0,8,8
2014,Refugio,M,100,0,8,8
2014,Reine,F,100,8,0,8
2014,Remiel,M,100,0,8,8
2014,Renan,M,100,0,8,8
2014,Renezmee,F,100,8,0,8
2014,Reniah,F,100,8,0,8
2014,Renlee,F,100,8,0,8
2014,Reon,M,100,0,8,8
2014,Reston,M,100,0,8,8
2014,Rexx,M,100,0,8,8
2014,Reyah,F,100,8,0,8
2014,Reylin,F,100,8,0,8
2014,Rhona,F,100,8,0,8
2014,Riane,F,100,8,0,8
2014,Richa,F,100,8,0,8
2014,Rickson,M,100,0,8,8
2014,Ridgely,M,100,0,8,8
2014,Riel,M,100,0,8,8
2014,Rin,F,100,8,0,8
2014,Riordan,M,100,0,8,8
2014,Ritter,M,100,0,8,8
2014,Riviera,F,100,8,0,8
2014,Roaa,F,100,8,0,8
2014,Roc,M,100,0,8,8
2014,Roch,M,100,0,8,8
2014,Rockelle,F,100,8,0,8
2014,Rocklin,M,100,0,8,8
2014,Rody,M,100,0,8,8
2014,Roemello,M,100,0,8,8
2014,Rohith,M,100,0,8,8
2014,Roi,M,100,0,8,8
2014,Roiza,F,100,8,0,8
2014,Romio,M,100,0,8,8
2014,Romir,M,100,0,8,8
2014,Rondale,M,100,0,8,8
2014,Ronia,F,100,8,0,8
2014,Ronyn,M,100,0,8,8
2014,Rosabell,F,100,8,0,8
2014,Rosaleah,F,100,8,0,8
2014,Rosio,F,100,8,0,8
2014,Royalti,F,100,8,0,8
2014,Rozalie,F,100,8,0,8
2014,Roze,F,100,8,0,8
2014,Rozlin,F,100,8,0,8
2014,Rubyann,F,100,8,0,8
2014,Rucker,M,100,0,8,8
2014,Ruckus,M,100,0,8,8
2014,Rukia,F,100,8,0,8
2014,Ruqaya,F,100,8,0,8
2014,Ruthanna,F,100,8,0,8
2014,Ruthy,F,100,8,0,8
2014,Ruwayda,F,100,8,0,8
2014,Ryelan,M,100,0,8,8
2014,Ryelyn,F,100,8,0,8
2014,Rykin,M,100,0,8,8
2014,Ryleighann,F,100,8,0,8
2014,Ryliee,F,100,8,0,8
2014,Rylynne,F,100,8,0,8
2014,Ryn,F,100,8,0,8
2014,Ryze,M,100,0,8,8
2014,Saahil,M,100,0,8,8
2014,Saahir,M,100,0,8,8
2014,Saamir,M,100,0,8,8
2014,Saanya,F,100,8,0,8
2014,Sabien,M,100,0,8,8
2014,Sadhana,F,100,8,0,8
2014,Sadieann,F,100,8,0,8
2014,Sadye,F,100,8,0,8
2014,Saga,F,100,8,0,8
2014,Sahari,F,100,8,0,8
2014,Sahiba,F,100,8,0,8
2014,Sairah,F,100,8,0,8
2014,Saish,M,100,0,8,8
2014,Sajjad,M,100,0,8,8
2014,Salimata,F,100,8,0,8
2014,Samaa,F,100,8,0,8
2014,Samani,F,100,8,0,8
2014,Samariah,F,100,8,0,8
2014,Sameria,F,100,8,0,8
2014,Saminah,F,100,8,0,8
2014,Samwise,M,100,0,8,8
2014,Santiel,M,100,0,8,8
2014,Sanvitha,F,100,8,0,8
2014,Sanyiah,F,100,8,0,8
2014,Saphera,F,100,8,0,8
2014,Saphyre,F,100,8,0,8
2014,Sarriah,F,100,8,0,8
2014,Sartaj,M,100,0,8,8
2014,Saryn,F,100,8,0,8
2014,Savaya,F,100,8,0,8
2014,Savien,M,100,0,8,8
2014,Savio,M,100,0,8,8
2014,Savoy,M,100,0,8,8
2014,Savreen,F,100,8,0,8
2014,Savva,M,100,0,8,8
2014,Seanpatrick,M,100,0,8,8
2014,Sebrina,F,100,8,0,8
2014,Secilia,F,100,8,0,8
2014,Seema,F,100,8,0,8
2014,Sehej,F,100,8,0,8
2014,Seline,F,100,8,0,8
2014,Senan,M,100,0,8,8
2014,Sender,M,100,0,8,8
2014,Seniya,F,100,8,0,8
2014,Sephina,F,100,8,0,8
2014,Serana,F,100,8,0,8
2014,Setareh,F,100,8,0,8
2014,Sevanna,F,100,8,0,8
2014,Seynabou,F,100,8,0,8
2014,Shabnam,F,100,8,0,8
2014,Shaddai,F,100,8,0,8
2014,Shaden,M,100,0,8,8
2014,Shaelee,F,100,8,0,8
2014,Shaelin,F,100,8,0,8
2014,Shahzaib,M,100,0,8,8
2014,Shailah,F,100,8,0,8
2014,Shain,M,100,0,8,8
2014,Shambhavi,F,100,8,0,8
2014,Shameer,M,100,0,8,8
2014,Shamiah,F,100,8,0,8
2014,Shamyia,F,100,8,0,8
2014,Shanae,F,100,8,0,8
2014,Shanise,F,100,8,0,8
2014,Sharifa,F,100,8,0,8
2014,Sharyn,F,100,8,0,8
2014,Shayda,F,100,8,0,8
2014,Sherlock,M,100,0,8,8
2014,Sheva,F,100,8,0,8
2014,Shevelle,F,100,8,0,8
2014,Shikha,F,100,8,0,8
2014,Shireen,F,100,8,0,8
2014,Shivali,F,100,8,0,8
2014,Shloima,M,100,0,8,8
2014,Shlomie,M,100,0,8,8
2014,Shomari,M,100,0,8,8
2014,Shrenik,M,100,0,8,8
2014,Shreshta,F,100,8,0,8
2014,Shriyans,M,100,0,8,8
2014,Sibley,F,100,8,0,8
2014,Siddalee,F,100,8,0,8
2014,Sidrah,F,100,8,0,8
2014,Sigmund,M,100,0,8,8
2014,Silverio,M,100,0,8,8
2014,Simrit,F,100,8,0,8
2014,Sinahi,F,100,8,0,8
2014,Sinan,M,100,0,8,8
2014,Sincerity,F,100,8,0,8
2014,Sinclair,F,100,8,0,8
2014,Siniyah,F,100,8,0,8
2014,Siris,M,100,0,8,8
2014,Sirron,M,100,0,8,8
2014,Skarleth,F,100,8,0,8
2014,Skyanne,F,100,8,0,8
2014,Skylarr,F,100,8,0,8
2014,Skylei,F,100,8,0,8
2014,Skyra,F,100,8,0,8
2014,Slaton,M,100,0,8,8
2014,Smaya,F,100,8,0,8
2014,Smayan,M,100,0,8,8
2014,Soe,M,100,0,8,8
2014,Solene,F,100,8,0,8
2014,Soley,F,100,8,0,8
2014,Sovereign,M,100,0,8,8
2014,Spiros,M,100,0,8,8
2014,Sravya,F,100,8,0,8
2014,Sreeja,F,100,8,0,8
2014,Sreenidhi,F,100,8,0,8
2014,Srithik,M,100,0,8,8
2014,Sruly,M,100,0,8,8
2014,Stanislaw,M,100,0,8,8
2014,Starlette,F,100,8,0,8
2014,Starlin,M,100,0,8,8
2014,Stavroula,F,100,8,0,8
2014,Stephano,M,100,0,8,8
2014,Stevenson,M,100,0,8,8
2014,Sua,F,100,8,0,8
2014,Sugey,F,100,8,0,8
2014,Suha,F,100,8,0,8
2014,Suhailah,F,100,8,0,8
2014,Sumedh,M,100,0,8,8
2014,Summerlin,F,100,8,0,8
2014,Surabhi,F,100,8,0,8
2014,Suria,F,100,8,0,8
2014,Susy,F,100,8,0,8
2014,Suttyn,F,100,8,0,8
2014,Suvi,F,100,8,0,8
2014,Suyog,M,100,0,8,8
2014,Svanik,M,100,0,8,8
2014,Sy,M,100,0,8,8
2014,Syenna,F,100,8,0,8
2014,Symeon,M,100,0,8,8
2014,Symphonie,F,100,8,0,8
2014,Tadeusz,M,100,0,8,8
2014,Taejzon,M,100,0,8,8
2014,Taija,F,100,8,0,8
2014,Taila,F,100,8,0,8
2014,Taison,M,100,0,8,8
2014,Takyla,F,100,8,0,8
2014,Talasia,F,100,8,0,8
2014,Taliesin,M,100,0,8,8
2014,Taline,F,100,8,0,8
2014,Tallan,M,100,0,8,8
2014,Tamatoa,M,100,0,8,8
2014,Tanishi,F,100,8,0,8
2014,Tanuj,M,100,0,8,8
2014,Taraoluwa,F,100,8,0,8
2014,Taras,M,100,0,8,8
2014,Tavien,M,100,0,8,8
2014,Tavita,M,100,0,8,8
2014,Tawhid,M,100,0,8,8
2014,Taygan,F,100,8,0,8
2014,Taysha,F,100,8,0,8
2014,Taysia,F,100,8,0,8
2014,Taziyah,F,100,8,0,8
2014,Teeghan,F,100,8,0,8
2014,Tegh,M,100,0,8,8
2014,Teion,M,100,0,8,8
2014,Temidayo,M,100,0,8,8
2014,Temprence,F,100,8,0,8
2014,Teona,F,100,8,0,8
2014,Tereza,F,100,8,0,8
2014,Teriana,F,100,8,0,8
2014,Terrah,F,100,8,0,8
2014,Terrica,F,100,8,0,8
2014,Tex,M,100,0,8,8
2014,Thaddius,M,100,0,8,8
2014,Thailan,M,100,0,8,8
2014,Thaily,F,100,8,0,8
2014,Thaliah,F,100,8,0,8
2014,Tharon,M,100,0,8,8
2014,Theory,F,100,8,0,8
2014,Thienan,F,100,8,0,8
2014,Thu,F,100,8,0,8
2014,Tian,M,100,0,8,8
2014,Timberlynn,F,100,8,0,8
2014,Tin,M,100,0,8,8
2014,Tiya,F,100,8,0,8
2014,Tobechi,M,100,0,8,8
2014,Tonio,M,100,0,8,8
2014,Topher,M,100,0,8,8
2014,Toria,F,100,8,0,8
2014,Toula,F,100,8,0,8
2014,Tovi,M,100,0,8,8
2014,Trager,M,100,0,8,8
2014,Tramon,M,100,0,8,8
2014,Travaris,M,100,0,8,8
2014,Travelle,M,100,0,8,8
2014,Travers,M,100,0,8,8
2014,Traylen,M,100,0,8,8
2014,Traylon,M,100,0,8,8
2014,Traysen,M,100,0,8,8
2014,Trebor,M,100,0,8,8
2014,Trejure,F,100,8,0,8
2014,Trice,M,100,0,8,8
2014,Trishelle,F,100,8,0,8
2014,Truxton,M,100,0,8,8
2014,Tryniti,F,100,8,0,8
2014,Tryphena,F,100,8,0,8
2014,Tryton,M,100,0,8,8
2014,Tully,M,100,0,8,8
2014,Tuvia,M,100,0,8,8
2014,Tya,F,100,8,0,8
2014,Tyee,M,100,0,8,8
2014,Tyger,M,100,0,8,8
2014,Tyking,M,100,0,8,8
2014,Tymel,M,100,0,8,8
2014,Tynasia,F,100,8,0,8
2014,Tyne,F,100,8,0,8
2014,Tyray,M,100,0,8,8
2014,Tyrece,M,100,0,8,8
2014,Ulani,F,100,8,0,8
2014,Umaima,F,100,8,0,8
2014,Umer,M,100,0,8,8
2014,Umme,F,100,8,0,8
2014,Vana,F,100,8,0,8
2014,Vedh,M,100,0,8,8
2014,Velia,F,100,8,0,8
2014,Venelope,F,100,8,0,8
2014,Veronique,F,100,8,0,8
2014,Vic,M,100,0,8,8
2014,Vidhur,M,100,0,8,8
2014,Vidia,F,100,8,0,8
2014,Vidur,M,100,0,8,8
2014,Vika,F,100,8,0,8
2014,Vikrant,M,100,0,8,8
2014,Vitali,M,100,0,8,8
2014,Voss,M,100,0,8,8
2014,Wale,M,100,0,8,8
2014,Wallis,F,100,8,0,8
2014,Waniya,F,100,8,0,8
2014,Warda,F,100,8,0,8
2014,Warrior,M,100,0,8,8
2014,Wasim,M,100,0,8,8
2014,Waverley,F,100,8,0,8
2014,Wendel,M,100,0,8,8
2014,Werner,M,100,0,8,8
2014,Whitfield,M,100,0,8,8
2014,Whitton,M,100,0,8,8
2014,Wiktoria,F,100,8,0,8
2014,Wilian,M,100,0,8,8
2014,Willoe,F,100,8,0,8
2014,Worth,M,100,0,8,8
2014,Wright,M,100,0,8,8
2014,Wynona,F,100,8,0,8
2014,Xaine,M,100,0,8,8
2014,Xandar,M,100,0,8,8
2014,Xariah,F,100,8,0,8
2014,Xaylee,F,100,8,0,8
2014,Xayvier,M,100,0,8,8
2014,Xcaret,F,100,8,0,8
2014,Xola,F,100,8,0,8
2014,Xolani,F,100,8,0,8
2014,Xuan,F,100,8,0,8
2014,Xzariah,F,100,8,0,8
2014,Xzavien,M,100,0,8,8
2014,Xzayden,M,100,0,8,8
2014,Xzayvion,M,100,0,8,8
2014,Yaasir,M,100,0,8,8
2014,Yaelis,F,100,8,0,8
2014,Yaileny,F,100,8,0,8
2014,Yann,M,100,0,8,8
2014,Yarelli,F,100,8,0,8
2014,Yariah,F,100,8,0,8
2014,Yarixa,F,100,8,0,8
2014,Yaslynn,F,100,8,0,8
2014,Yatzari,F,100,8,0,8
2014,Yazlynn,F,100,8,0,8
2014,Yeily,F,100,8,0,8
2014,Yerai,M,100,0,8,8
2014,Yeremy,M,100,0,8,8
2014,Yian,M,100,0,8,8
2014,Yifan,M,100,0,8,8
2014,Yina,F,100,8,0,8
2014,Yita,F,100,8,0,8
2014,Yitta,F,100,8,0,8
2014,Yliana,F,100,8,0,8
2014,Yonael,M,100,0,8,8
2014,Yonason,M,100,0,8,8
2014,Yoriel,M,100,0,8,8
2014,Yosselin,F,100,8,0,8
2014,Yousof,M,100,0,8,8
2014,Yovanna,F,100,8,0,8
2014,Ytzel,F,100,8,0,8
2014,Yuika,F,100,8,0,8
2014,Yuliet,F,100,8,0,8
2014,Yulieth,F,100,8,0,8
2014,Yusha,M,100,0,8,8
2014,Yutong,F,100,8,0,8
2014,Yuxuan,M,100,0,8,8
2014,Yvan,M,100,0,8,8
2014,Zaahir,M,100,0,8,8
2014,Zabella,F,100,8,0,8
2014,Zaccheus,M,100,0,8,8
2014,Zackari,M,100,0,8,8
2014,Zaedin,M,100,0,8,8
2014,Zaeleigh,F,100,8,0,8
2014,Zaelin,M,100,0,8,8
2014,Zahaira,F,100,8,0,8
2014,Zahkai,M,100,0,8,8
2014,Zakira,F,100,8,0,8
2014,Zakya,F,100,8,0,8
2014,Zakyah,F,100,8,0,8
2014,Zakyia,F,100,8,0,8
2014,Zalena,F,100,8,0,8
2014,Zalie,F,100,8,0,8
2014,Zamauri,M,100,0,8,8
2014,Zandon,M,100,0,8,8
2014,Zandyn,M,100,0,8,8
2014,Zanylah,F,100,8,0,8
2014,Zarai,F,100,8,0,8
2014,Zaren,M,100,0,8,8
2014,Zarie,F,100,8,0,8
2014,Zarif,M,100,0,8,8
2014,Zarin,M,100,0,8,8
2014,Zaron,M,100,0,8,8
2014,Zasha,F,100,8,0,8
2014,Zayion,M,100,0,8,8
2014,Zayon,M,100,0,8,8
2014,Zayonna,F,100,8,0,8
2014,Zebedee,M,100,0,8,8
2014,Zeddicus,M,100,0,8,8
2014,Zee,M,100,0,8,8
2014,Zelah,F,100,8,0,8
2014,Zelene,F,100,8,0,8
2014,Zenith,M,100,0,8,8
2014,Zeph,M,100,0,8,8
2014,Zephyra,F,100,8,0,8
2014,Zepplin,M,100,0,8,8
2014,Zerina,F,100,8,0,8
2014,Zerrick,M,100,0,8,8
2014,Zeven,M,100,0,8,8
2014,Zeyd,M,100,0,8,8
2014,Zeyna,F,100,8,0,8
2014,Zhi,M,100,0,8,8
2014,Zilah,F,100,8,0,8
2014,Zimir,M,100,0,8,8
2014,Zira,F,100,8,0,8
2014,Zoeya,F,100,8,0,8
2014,Zohal,F,100,8,0,8
2014,Zona,F,100,8,0,8
2014,Zoriyah,F,100,8,0,8
2014,Zyad,M,100,0,8,8
2014,Zyheir,M,100,0,8,8
2014,Zykia,F,100,8,0,8
2014,Zymira,F,100,8,0,8
2014,Zynae,F,100,8,0,8
2014,Zyree,M,100,0,8,8
2014,Aadvika,F,100,7,0,7
2014,Aaleahya,F,100,7,0,7
2014,Aaliyahrose,F,100,7,0,7
2014,Aalya,F,100,7,0,7
2014,Aanaya,F,100,7,0,7
2014,Aanyah,F,100,7,0,7
2014,Aaqil,M,100,0,7,7
2014,Aariona,F,100,7,0,7
2014,Aason,M,100,0,7,7
2014,Aastha,F,100,7,0,7
2014,Aava,F,100,7,0,7
2014,Aavion,M,100,0,7,7
2014,Aayaan,M,100,0,7,7
2014,Abagale,F,100,7,0,7
2014,Abas,M,100,0,7,7
2014,Abbigael,F,100,7,0,7
2014,Abbriella,F,100,7,0,7
2014,Abdo,M,100,0,7,7
2014,Abdulkadir,M,100,0,7,7
2014,Abdur,M,100,0,7,7
2014,Abeeha,F,100,7,0,7
2014,Abernathy,F,100,7,0,7
2014,Abhijot,M,100,0,7,7
2014,Abrey,F,100,7,0,7
2014,Abu,M,100,0,7,7
2014,Ac,M,100,0,7,7
2014,Adalai,F,100,7,0,7
2014,Adalen,F,100,7,0,7
2014,Adaliene,F,100,7,0,7
2014,Adalise,F,100,7,0,7
2014,Adarian,M,100,0,7,7
2014,Adasha,F,100,7,0,7
2014,Adda,F,100,7,0,7
2014,Addalyne,F,100,7,0,7
2014,Addelynne,F,100,7,0,7
2014,Adden,M,100,0,7,7
2014,Addysin,F,100,7,0,7
2014,Ade,M,100,0,7,7
2014,Adelay,F,100,7,0,7
2014,Adelayde,F,100,7,0,7
2014,Adelee,F,100,7,0,7
2014,Adelinn,F,100,7,0,7
2014,Adhvaith,M,100,0,7,7
2014,Adhvika,F,100,7,0,7
2014,Adib,M,100,0,7,7
2014,Adilena,F,100,7,0,7
2014,Adisson,F,100,7,0,7
2014,Admir,M,100,0,7,7
2014,Adonna,F,100,7,0,7
2014,Adorabella,F,100,7,0,7
2014,Adrea,F,100,7,0,7
2014,Adriaan,M,100,0,7,7
2014,Adriauna,F,100,7,0,7
2014,Adrika,F,100,7,0,7
2014,Adrius,M,100,0,7,7
2014,Adriyanna,F,100,7,0,7
2014,Adwin,M,100,0,7,7
2014,Adwoa,F,100,7,0,7
2014,Aelyn,F,100,7,0,7
2014,Aelynn,F,100,7,0,7
2014,Aeralyn,F,100,7,0,7
2014,Aerion,M,100,0,7,7
2014,Aesha,F,100,7,0,7
2014,Afrah,F,100,7,0,7
2014,Afrin,F,100,7,0,7
2014,Agna,F,100,7,0,7
2014,Agostino,M,100,0,7,7
2014,Ahadu,M,100,0,7,7
2014,Ahja,F,100,7,0,7
2014,Ahlea,F,100,7,0,7
2014,Ahlias,M,100,0,7,7
2014,Ahliyah,F,100,7,0,7
2014,Ahmeir,M,100,0,7,7
2014,Ahmia,F,100,7,0,7
2014,Ahmina,F,100,7,0,7
2014,Ahniya,F,100,7,0,7
2014,Ahzaria,F,100,7,0,7
2014,Ahzir,M,100,0,7,7
2014,Aiana,F,100,7,0,7
2014,Aidaly,F,100,7,0,7
2014,Aidenjames,M,100,0,7,7
2014,Aiesha,F,100,7,0,7
2014,Aileena,F,100,7,0,7
2014,Ailen,F,100,7,0,7
2014,Ainhara,F,100,7,0,7
2014,Airah,F,100,7,0,7
2014,Aireana,F,100,7,0,7
2014,Aires,M,100,0,7,7
2014,Airlie,F,100,7,0,7
2014,Aisla,F,100,7,0,7
2014,Ajahni,M,100,0,7,7
2014,Ajan,M,100,0,7,7
2014,Ajeet,M,100,0,7,7
2014,Akaylah,F,100,7,0,7
2014,Akeela,F,100,7,0,7
2014,Akin,M,100,0,7,7
2014,Akito,M,100,0,7,7
2014,Alaan,M,100,0,7,7
2014,Alacia,F,100,7,0,7
2014,Alaija,F,100,7,0,7
2014,Alaira,F,100,7,0,7
2014,Alamin,M,100,0,7,7
2014,Alanya,F,100,7,0,7
2014,Alastor,M,100,0,7,7
2014,Alauni,F,100,7,0,7
2014,Alaysiah,F,100,7,0,7
2014,Alcide,M,100,0,7,7
2014,Alekai,M,100,0,7,7
2014,Alessander,M,100,0,7,7
2014,Alessandria,F,100,7,0,7
2014,Alexius,F,100,7,0,7
2014,Alezae,F,100,7,0,7
2014,Aliayah,F,100,7,0,7
2014,Alicyn,F,100,7,0,7
2014,Aliegha,F,100,7,0,7
2014,Alieu,M,100,0,7,7
2014,Aliha,F,100,7,0,7
2014,Alisse,F,100,7,0,7
2014,Alistar,M,100,0,7,7
2014,Aliyan,M,100,0,7,7
2014,Alizia,F,100,7,0,7
2014,Alizzon,F,100,7,0,7
2014,Aljohara,F,100,7,0,7
2014,Allahna,F,100,7,0,7
2014,Allaina,F,100,7,0,7
2014,Allanna,F,100,7,0,7
2014,Allia,F,100,7,0,7
2014,Allina,F,100,7,0,7
2014,Allyannah,F,100,7,0,7
2014,Allyiah,F,100,7,0,7
2014,Allyna,F,100,7,0,7
2014,Allysia,F,100,7,0,7
2014,Alman,M,100,0,7,7
2014,Almina,F,100,7,0,7
2014,Alper,M,100,0,7,7
2014,Alphonzo,M,100,0,7,7
2014,Alvie,M,100,0,7,7
2014,Alyia,F,100,7,0,7
2014,Alyxander,M,100,0,7,7
2014,Amali,F,100,7,0,7
2014,Amarea,F,100,7,0,7
2014,Amarius,M,100,0,7,7
2014,Amariyana,F,100,7,0,7
2014,Amaro,M,100,0,7,7
2014,Amayla,F,100,7,0,7
2014,Ambry,F,100,7,0,7
2014,Ameli,F,100,7,0,7
2014,Amelianna,F,100,7,0,7
2014,Amierah,F,100,7,0,7
2014,Amiliah,F,100,7,0,7
2014,Amily,F,100,7,0,7
2014,Amirjon,M,100,0,7,7
2014,Amitai,M,100,0,7,7
2014,Amma,F,100,7,0,7
2014,Ammiel,M,100,0,7,7
2014,Amoriah,F,100,7,0,7
2014,Amritha,F,100,7,0,7
2014,Amro,M,100,0,7,7
2014,Amylee,F,100,7,0,7
2014,Amyriah,F,100,7,0,7
2014,Anahlia,F,100,7,0,7
2014,Anaiz,F,100,7,0,7
2014,Analiza,F,100,7,0,7
2014,Analuisa,F,100,7,0,7
2014,Anan,M,100,0,7,7
2014,Anarah,F,100,7,0,7
2014,Anastacio,M,100,0,7,7
2014,Anaston,F,100,7,0,7
2014,Anavae,F,100,7,0,7
2014,Andras,M,100,0,7,7
2014,Andreina,F,100,7,0,7
2014,Andreu,M,100,0,7,7
2014,Andrielle,F,100,7,0,7
2014,Andrius,M,100,0,7,7
2014,Andrue,M,100,0,7,7
2014,Aneesah,F,100,7,0,7
2014,Aneira,F,100,7,0,7
2014,Aneri,F,100,7,0,7
2014,Aneyah,F,100,7,0,7
2014,Angalina,F,100,7,0,7
2014,Angelea,F,100,7,0,7
2014,Angeleena,F,100,7,0,7
2014,Angelisse,F,100,7,0,7
2014,Angelos,M,100,0,7,7
2014,Anibelle,F,100,7,0,7
2014,Anikin,M,100,0,7,7
2014,Anique,F,100,7,0,7
2014,Anise,F,100,7,0,7
2014,Anjani,F,100,7,0,7
2014,Annabellee,F,100,7,0,7
2014,Annais,F,100,7,0,7
2014,Annalayah,F,100,7,0,7
2014,Annalei,F,100,7,0,7
2014,Annalize,F,100,7,0,7
2014,Annibelle,F,100,7,0,7
2014,Anniemae,F,100,7,0,7
2014,Annzlee,F,100,7,0,7
2014,Anshul,M,100,0,7,7
2014,Antar,M,100,0,7,7
2014,Anthonee,M,100,0,7,7
2014,Anthonia,F,100,7,0,7
2014,Antonyo,M,100,0,7,7
2014,Antwine,M,100,0,7,7
2014,Anvit,M,100,0,7,7
2014,Anvith,M,100,0,7,7
2014,Anyliah,F,100,7,0,7
2014,Anzel,M,100,0,7,7
2014,Aquarius,M,100,0,7,7
2014,Aquinnah,F,100,7,0,7
2014,Aradia,F,100,7,0,7
2014,Araeya,F,100,7,0,7
2014,Aralia,F,100,7,0,7
2014,Araseli,F,100,7,0,7
2014,Arcadio,M,100,0,7,7
2014,Archan,M,100,0,7,7
2014,Archivaldo,M,100,0,7,7
2014,Ardell,M,100,0,7,7
2014,Ardella,F,100,7,0,7
2014,Areana,F,100,7,0,7
2014,Areil,F,100,7,0,7
2014,Arelie,F,100,7,0,7
2014,Aremi,F,100,7,0,7
2014,Ariebella,F,100,7,0,7
2014,Arieliz,F,100,7,0,7
2014,Arista,F,100,7,0,7
2014,Aristea,F,100,7,0,7
2014,Aristeo,M,100,0,7,7
2014,Ariyannah,F,100,7,0,7
2014,Arkan,M,100,0,7,7
2014,Arkham,M,100,0,7,7
2014,Arland,M,100,0,7,7
2014,Arlenne,F,100,7,0,7
2014,Aroosh,F,100,7,0,7
2014,Arriya,F,100,7,0,7
2014,Arriyanna,F,100,7,0,7
2014,Artemus,M,100,0,7,7
2014,Arvind,M,100,0,7,7
2014,Aryaman,M,100,0,7,7
2014,Aryann,F,100,7,0,7
2014,Aryash,M,100,0,7,7
2014,Aryka,F,100,7,0,7
2014,Aryon,M,100,0,7,7
2014,Aryus,M,100,0,7,7
2014,Asah,M,100,0,7,7
2014,Asahel,M,100,0,7,7
2014,Asahi,M,100,0,7,7
2014,Asar,M,100,0,7,7
2014,Asees,F,100,7,0,7
2014,Ashante,F,100,7,0,7
2014,Ashaunti,F,100,7,0,7
2014,Ashawn,M,100,0,7,7
2014,Ashelynn,F,100,7,0,7
2014,Asherah,F,100,7,0,7
2014,Ashmita,F,100,7,0,7
2014,Ason,M,100,0,7,7
2014,Asra,F,100,7,0,7
2014,Astor,M,100,0,7,7
2014,Atira,F,100,7,0,7
2014,Atzin,M,100,0,7,7
2014,Aubrina,F,100,7,0,7
2014,Audia,F,100,7,0,7
2014,Audreigh,F,100,7,0,7
2014,Audryna,F,100,7,0,7
2014,Augusten,M,100,0,7,7
2014,Aunah,F,100,7,0,7
2014,Aunalee,F,100,7,0,7
2014,Auren,M,100,0,7,7
2014,Auriya,F,100,7,0,7
2014,Auriyah,F,100,7,0,7
2014,Auryn,M,100,0,7,7
2014,Avalei,F,100,7,0,7
2014,Avanya,F,100,7,0,7
2014,Avea,F,100,7,0,7
2014,Aviyon,M,100,0,7,7
2014,Avlynn,F,100,7,0,7
2014,Avneesh,M,100,0,7,7
2014,Avonelle,F,100,7,0,7
2014,Avrian,M,100,0,7,7
2014,Avyonna,F,100,7,0,7
2014,Axis,M,100,0,7,7
2014,Ayalah,F,100,7,0,7
2014,Ayame,F,100,7,0,7
2014,Aydia,F,100,7,0,7
2014,Aydrianna,F,100,7,0,7
2014,Ayeza,F,100,7,0,7
2014,Ayli,F,100,7,0,7
2014,Ayme,F,100,7,0,7
2014,Aynara,F,100,7,0,7
2014,Ayomikun,M,100,0,7,7
2014,Ayren,M,100,0,7,7
2014,Ayveri,F,100,7,0,7
2014,Ayverie,F,100,7,0,7
2014,Ayza,F,100,7,0,7
2014,Azaelia,F,100,7,0,7
2014,Azalyn,F,100,7,0,7
2014,Azania,F,100,7,0,7
2014,Azarriah,F,100,7,0,7
2014,Azaylee,F,100,7,0,7
2014,Azon,M,100,0,7,7
2014,Azori,F,100,7,0,7
2014,Azya,F,100,7,0,7
2014,Baiden,M,100,0,7,7
2014,Baley,F,100,7,0,7
2014,Baptiste,M,100,0,7,7
2014,Bashar,M,100,0,7,7
2014,Basir,M,100,0,7,7
2014,Bathsheba,F,100,7,0,7
2014,Baye,F,100,7,0,7
2014,Beckhem,M,100,0,7,7
2014,Beckie,F,100,7,0,7
2014,Beka,M,100,0,7,7
2014,Bekah,F,100,7,0,7
2014,Belanna,F,100,7,0,7
2014,Bellami,F,100,7,0,7
2014,Bence,M,100,0,7,7
2014,Benedetto,M,100,0,7,7
2014,Benno,M,100,0,7,7
2014,Bentlei,F,100,7,0,7
2014,Bernardino,M,100,0,7,7
2014,Bertram,M,100,0,7,7
2014,Bethzaida,F,100,7,0,7
2014,Bhuvan,M,100,0,7,7
2014,Bibi,F,100,7,0,7
2014,Birch,M,100,0,7,7
2014,Blayz,M,100,0,7,7
2014,Bodyn,M,100,0,7,7
2014,Bostynn,F,100,7,0,7
2014,Braeson,M,100,0,7,7
2014,Braheem,M,100,0,7,7
2014,Bran,M,100,0,7,7
2014,Braniya,F,100,7,0,7
2014,Branten,M,100,0,7,7
2014,Braydenn,M,100,0,7,7
2014,Brayli,F,100,7,0,7
2014,Breandan,M,100,0,7,7
2014,Brenlynn,F,100,7,0,7
2014,Brenya,F,100,7,0,7
2014,Brex,M,100,0,7,7
2014,Brezlynn,F,100,7,0,7
2014,Bri,F,100,7,0,7
2014,Brialle,F,100,7,0,7
2014,Briauna,F,100,7,0,7
2014,Briceida,F,100,7,0,7
2014,Brig,M,100,0,7,7
2014,Brik,M,100,0,7,7
2014,Brinna,F,100,7,0,7
2014,Britny,F,100,7,0,7
2014,Briton,M,100,0,7,7
2014,Brittanya,F,100,7,0,7
2014,Brodin,M,100,0,7,7
2014,Brodric,M,100,0,7,7
2014,Broghan,M,100,0,7,7
2014,Broly,M,100,0,7,7
2014,Browning,M,100,0,7,7
2014,Bryah,F,100,7,0,7
2014,Brycon,M,100,0,7,7
2014,Bryland,M,100,0,7,7
2014,Brynnli,F,100,7,0,7
2014,Bukhari,M,100,0,7,7
2014,Burklee,F,100,7,0,7
2014,Byran,M,100,0,7,7
2014,Cabe,M,100,0,7,7
2014,Cadarius,M,100,0,7,7
2014,Cadden,M,100,0,7,7
2014,Cadon,M,100,0,7,7
2014,Caide,M,100,0,7,7
2014,Caidon,M,100,0,7,7
2014,Caily,F,100,7,0,7
2014,Caiyah,F,100,7,0,7
2014,Caleyah,F,100,7,0,7
2014,Calianne,F,100,7,0,7
2014,Calil,M,100,0,7,7
2014,Calliah,F,100,7,0,7
2014,Calysta,F,100,7,0,7
2014,Cambreigh,F,100,7,0,7
2014,Camdynn,F,100,7,0,7
2014,Camp,M,100,0,7,7
2014,Candida,F,100,7,0,7
2014,Caniya,F,100,7,0,7
2014,Capone,M,100,0,7,7
2014,Carabella,F,100,7,0,7
2014,Cardier,M,100,0,7,7
2014,Carles,M,100,0,7,7
2014,Carlisha,F,100,7,0,7
2014,Carlissa,F,100,7,0,7
2014,Carolee,F,100,7,0,7
2014,Carsynn,F,100,7,0,7
2014,Caselynn,F,100,7,0,7
2014,Cashden,M,100,0,7,7
2014,Cashmir,M,100,0,7,7
2014,Cashten,M,100,0,7,7
2014,Cashtyn,M,100,0,7,7
2014,Cataleah,F,100,7,0,7
2014,Catelaya,F,100,7,0,7
2014,Cateleya,F,100,7,0,7
2014,Cathaleya,F,100,7,0,7
2014,Catherina,F,100,7,0,7
2014,Cavalli,M,100,0,7,7
2014,Cavanaugh,M,100,0,7,7
2014,Caydan,M,100,0,7,7
2014,Caylei,F,100,7,0,7
2014,Caz,M,100,0,7,7
2014,Ceira,F,100,7,0,7
2014,Celestial,F,100,7,0,7
2014,Cem,M,100,0,7,7
2014,Cereniti,F,100,7,0,7
2014,Chamberlain,M,100,0,7,7
2014,Chan,M,100,0,7,7
2014,Chanie,F,100,7,0,7
2014,Chanson,M,100,0,7,7
2014,Chantell,F,100,7,0,7
2014,Chapel,F,100,7,0,7
2014,Chara,F,100,7,0,7
2014,Charisse,F,100,7,0,7
2014,Charlena,F,100,7,0,7
2014,Chaslynn,F,100,7,0,7
2014,Chenelle,F,100,7,0,7
2014,Cherif,M,100,0,7,7
2014,Chesnie,F,100,7,0,7
2014,Chianne,F,100,7,0,7
2014,Chibueze,M,100,0,7,7
2014,Chriselle,F,100,7,0,7
2014,Chrissette,F,100,7,0,7
2014,Christalynn,F,100,7,0,7
2014,Christiaan,M,100,0,7,7
2014,Christiane,F,100,7,0,7
2014,Chukwudi,M,100,0,7,7
2014,Chukwuma,M,100,0,7,7
2014,Chynah,F,100,7,0,7
2014,Cici,F,100,7,0,7
2014,Ciin,F,100,7,0,7
2014,Clairissa,F,100,7,0,7
2014,Clarabella,F,100,7,0,7
2014,Claritza,F,100,7,0,7
2014,Cleon,M,100,0,7,7
2014,Cletus,M,100,0,7,7
2014,Clodagh,F,100,7,0,7
2014,Coast,M,100,0,7,7
2014,Cobalt,M,100,0,7,7
2014,Cogan,M,100,0,7,7
2014,Cohyn,M,100,0,7,7
2014,Coleen,F,100,7,0,7
2014,Colesyn,M,100,0,7,7
2014,Colsten,M,100,0,7,7
2014,Concepcion,F,100,7,0,7
2014,Copelin,M,100,0,7,7
2014,Corde,M,100,0,7,7
2014,Coren,M,100,0,7,7
2014,Corian,M,100,0,7,7
2014,Corielle,F,100,7,0,7
2014,Corrigan,M,100,0,7,7
2014,Corwyn,M,100,0,7,7
2014,Corynne,F,100,7,0,7
2014,Courtez,M,100,0,7,7
2014,Cowan,M,100,0,7,7
2014,Crash,M,100,0,7,7
2014,Creedance,F,100,7,0,7
2014,Creeden,M,100,0,7,7
2014,Creston,M,100,0,7,7
2014,Crislyn,F,100,7,0,7
2014,Crist,M,100,0,7,7
2014,Cyanna,F,100,7,0,7
2014,Cyenna,F,100,7,0,7
2014,Cylah,F,100,7,0,7
2014,Cyrah,F,100,7,0,7
2014,Cyrena,F,100,7,0,7
2014,Dabney,F,100,7,0,7
2014,Daelan,M,100,0,7,7
2014,Daemian,M,100,0,7,7
2014,Daemien,M,100,0,7,7
2014,Daesha,F,100,7,0,7
2014,Daeton,M,100,0,7,7
2014,Daffne,F,100,7,0,7
2014,Dagon,M,100,0,7,7
2014,Dailah,F,100,7,0,7
2014,Dailany,F,100,7,0,7
2014,Dailee,F,100,7,0,7
2014,Daileen,F,100,7,0,7
2014,Daisa,F,100,7,0,7
2014,Daisee,F,100,7,0,7
2014,Daisi,F,100,7,0,7
2014,Dajanae,F,100,7,0,7
2014,Dakyla,F,100,7,0,7
2014,Daliana,F,100,7,0,7
2014,Dalicia,F,100,7,0,7
2014,Daliza,F,100,7,0,7
2014,Dallana,F,100,7,0,7
2014,Damain,M,100,0,7,7
2014,Damarri,M,100,0,7,7
2014,Damary,F,100,7,0,7
2014,Dameer,M,100,0,7,7
2014,Dametrius,M,100,0,7,7
2014,Damyia,F,100,7,0,7
2014,Damyra,F,100,7,0,7
2014,Danel,M,100,0,7,7
2014,Danger,M,100,0,7,7
2014,Danilah,F,100,7,0,7
2014,Danzel,M,100,0,7,7
2014,Daraly,F,100,7,0,7
2014,Darbi,F,100,7,0,7
2014,Dariany,F,100,7,0,7
2014,Darie,F,100,7,0,7
2014,Darionna,F,100,7,0,7
2014,Darline,F,100,7,0,7
2014,Darriana,F,100,7,0,7
2014,Darrious,M,100,0,7,7
2014,Darry,M,100,0,7,7
2014,Daryll,M,100,0,7,7
2014,Daryus,M,100,0,7,7
2014,Dashal,M,100,0,7,7
2014,Davonne,M,100,0,7,7
2014,Daxson,M,100,0,7,7
2014,Daxter,M,100,0,7,7
2014,Day,F,100,7,0,7
2014,Dayah,F,100,7,0,7
2014,Daylany,F,100,7,0,7
2014,Daylene,F,100,7,0,7
2014,Deandrew,M,100,0,7,7
2014,Deaven,M,100,0,7,7
2014,Debby,F,100,7,0,7
2014,Deckard,M,100,0,7,7
2014,Deep,M,100,0,7,7
2014,Deighton,M,100,0,7,7
2014,Deiondre,M,100,0,7,7
2014,Dejay,M,100,0,7,7
2014,Delasia,F,100,7,0,7
2014,Delsa,F,100,7,0,7
2014,Demetrie,M,100,0,7,7
2014,Demitria,F,100,7,0,7
2014,Demonie,M,100,0,7,7
2014,Demyah,F,100,7,0,7
2014,Denasia,F,100,7,0,7
2014,Denley,M,100,0,7,7
2014,Denna,F,100,7,0,7
2014,Deo,M,100,0,7,7
2014,Deondrae,M,100,0,7,7
2014,Deonni,F,100,7,0,7
2014,Deren,M,100,0,7,7
2014,Deriah,F,100,7,0,7
2014,Derren,M,100,0,7,7
2014,Derya,F,100,7,0,7
2014,Desaray,F,100,7,0,7
2014,Dessiah,F,100,7,0,7
2014,Destan,M,100,0,7,7
2014,Deucalion,M,100,0,7,7
2014,Devaeh,F,100,7,0,7
2014,Devoiry,F,100,7,0,7
2014,Devondre,M,100,0,7,7
2014,Deyjah,F,100,7,0,7
2014,Deylan,M,100,0,7,7
2014,Deymar,M,100,0,7,7
2014,Dezmen,M,100,0,7,7
2014,Dhatri,F,100,7,0,7
2014,Dhylan,M,100,0,7,7
2014,Diallo,M,100,0,7,7
2014,Diamante,M,100,0,7,7
2014,Dianey,F,100,7,0,7
2014,Diar,M,100,0,7,7
2014,Diarra,F,100,7,0,7
2014,Diksha,F,100,7,0,7
2014,Diland,M,100,0,7,7
2014,Dilcia,F,100,7,0,7
2014,Dio,M,100,0,7,7
2014,Dionta,M,100,0,7,7
2014,Divisha,F,100,7,0,7
2014,Divyansh,M,100,0,7,7
2014,Divyanshi,F,100,7,0,7
2014,Diyana,F,100,7,0,7
2014,Diyari,M,100,0,7,7
2014,Djeneba,F,100,7,0,7
2014,Dnyla,F,100,7,0,7
2014,Dolce,F,100,7,0,7
2014,Domnick,M,100,0,7,7
2014,Donaldo,M,100,0,7,7
2014,Donnel,M,100,0,7,7
2014,Dontavion,M,100,0,7,7
2014,Donzell,M,100,0,7,7
2014,Dorismar,F,100,7,0,7
2014,Doroteo,M,100,0,7,7
2014,Dorsa,F,100,7,0,7
2014,Douglass,M,100,0,7,7
2014,Draylon,M,100,0,7,7
2014,Draysen,M,100,0,7,7
2014,Drevion,M,100,0,7,7
2014,Drexler,M,100,0,7,7
2014,Drey,M,100,0,7,7
2014,Dreydan,M,100,0,7,7
2014,Dreydon,M,100,0,7,7
2014,Drystan,M,100,0,7,7
2014,Duan,M,100,0,7,7
2014,Dujuan,M,100,0,7,7
2014,Dulcinea,F,100,7,0,7
2014,Durante,M,100,0,7,7
2014,Dylanie,F,100,7,0,7
2014,Dysen,M,100,0,7,7
2014,Eavan,F,100,7,0,7
2014,Ebin,M,100,0,7,7
2014,Ebon,M,100,0,7,7
2014,Ebubechukwu,M,100,0,7,7
2014,Edelin,F,100,7,0,7
2014,Edilson,M,100,0,7,7
2014,Edona,F,100,7,0,7
2014,Edyson,M,100,0,7,7
2014,Egon,M,100,0,7,7
2014,Eilene,F,100,7,0,7
2014,Eirik,M,100,0,7,7
2014,Ekamjot,M,100,0,7,7
2014,Ekamveer,M,100,0,7,7
2014,Ekin,M,100,0,7,7
2014,Elaf,F,100,7,0,7
2014,Elaijah,F,100,7,0,7
2014,Elaisha,F,100,7,0,7
2014,Elajah,F,100,7,0,7
2014,Elanah,F,100,7,0,7
2014,Elania,F,100,7,0,7
2014,Elaynah,F,100,7,0,7
2014,Elchonon,M,100,0,7,7
2014,Eldrick,M,100,0,7,7
2014,Eleazer,M,100,0,7,7
2014,Elenor,F,100,7,0,7
2014,Eliakim,M,100,0,7,7
2014,Elianie,F,100,7,0,7
2014,Elianys,F,100,7,0,7
2014,Elice,F,100,7,0,7
2014,Eligah,M,100,0,7,7
2014,Eliona,F,100,7,0,7
2014,Eliotte,F,100,7,0,7
2014,Elisabella,F,100,7,0,7
2014,Elisandra,F,100,7,0,7
2014,Elishah,M,100,0,7,7
2014,Elisheba,F,100,7,0,7
2014,Elishua,M,100,0,7,7
2014,Eliyanna,F,100,7,0,7
2014,Elizjah,M,100,0,7,7
2014,Elizzabeth,F,100,7,0,7
2014,Ellawyn,F,100,7,0,7
2014,Elliemay,F,100,7,0,7
2014,Elliston,M,100,0,7,7
2014,Elonzo,M,100,0,7,7
2014,Elovie,F,100,7,0,7
2014,Elrey,M,100,0,7,7
2014,Elsah,F,100,7,0,7
2014,Elyes,M,100,0,7,7
2014,Emah,F,100,7,0,7
2014,Emariah,F,100,7,0,7
2014,Embrey,F,100,7,0,7
2014,Emerik,M,100,0,7,7
2014,Emileo,M,100,0,7,7
2014,Emiliya,F,100,7,0,7
2014,Emillee,F,100,7,0,7
2014,Emmabelle,F,100,7,0,7
2014,Emmelynn,F,100,7,0,7
2014,Emmilynn,F,100,7,0,7
2014,Emmory,F,100,7,0,7
2014,Emron,M,100,0,7,7
2014,Enderson,M,100,0,7,7
2014,Ennio,M,100,0,7,7
2014,Enora,F,100,7,0,7
2014,Ensar,M,100,0,7,7
2014,Enso,M,100,0,7,7
2014,Eralynn,F,100,7,0,7
2014,Erdi,M,100,0,7,7
2014,Eri,F,100,7,0,7
2014,Erie,F,100,7,0,7
2014,Erlin,M,100,0,7,7
2014,Erlinda,F,100,7,0,7
2014,Eryx,M,100,0,7,7
2014,Escarlet,F,100,7,0,7
2014,Eshana,F,100,7,0,7
2014,Espyn,F,100,7,0,7
2014,Esrom,M,100,0,7,7
2014,Essynce,F,100,7,0,7
2014,Estefan,M,100,0,7,7
2014,Esthela,F,100,7,0,7
2014,Eustace,M,100,0,7,7
2014,Evalene,F,100,7,0,7
2014,Evalet,F,100,7,0,7
2014,Evaly,F,100,7,0,7
2014,Evangelin,F,100,7,0,7
2014,Evarose,F,100,7,0,7
2014,Evely,F,100,7,0,7
2014,Eveny,F,100,7,0,7
2014,Evynne,F,100,7,0,7
2014,Exton,M,100,0,7,7
2014,Eyuel,M,100,0,7,7
2014,Ezeriah,M,100,0,7,7
2014,Eziel,M,100,0,7,7
2014,Ezmerelda,F,100,7,0,7
2014,Ezrie,F,100,7,0,7
2014,Faaiz,M,100,0,7,7
2014,Faaris,M,100,0,7,7
2014,Fabrizzio,M,100,0,7,7
2014,Faelan,M,100,0,7,7
2014,Faithe,F,100,7,0,7
2014,Faizaan,M,100,0,7,7
2014,Falco,M,100,0,7,7
2014,Faraday,F,100,7,0,7
2014,Fardeen,M,100,0,7,7
2014,Fardowsa,F,100,7,0,7
2014,Fareedah,F,100,7,0,7
2014,Fariza,F,100,7,0,7
2014,Faruk,M,100,0,7,7
2014,Faylin,F,100,7,0,7
2014,Fenna,F,100,7,0,7
2014,Ferryn,F,100,7,0,7
2014,Finbar,M,100,0,7,7
2014,Finch,M,100,0,7,7
2014,Fionnuala,F,100,7,0,7
2014,Flash,M,100,0,7,7
2014,Gabbanelli,F,100,7,0,7
2014,Gabriana,F,100,7,0,7
2014,Gaddiel,M,100,0,7,7
2014,Galylea,F,100,7,0,7
2014,Gannyn,M,100,0,7,7
2014,Ganyn,M,100,0,7,7
2014,Garet,M,100,0,7,7
2014,Garik,M,100,0,7,7
2014,Garion,M,100,0,7,7
2014,Gattlin,M,100,0,7,7
2014,Gavinn,M,100,0,7,7
2014,Gayle,F,100,7,0,7
2014,Gedalia,M,100,0,7,7
2014,Geissie,F,100,7,0,7
2014,Genesee,F,100,7,0,7
2014,Genesi,F,100,7,0,7
2014,Geniyah,F,100,7,0,7
2014,Gennavieve,F,100,7,0,7
2014,Gent,M,100,0,7,7
2014,Geonna,F,100,7,0,7
2014,Geordan,M,100,0,7,7
2014,Georg,M,100,0,7,7
2014,Georganna,F,100,7,0,7
2014,Geovannie,M,100,0,7,7
2014,Ghazal,F,100,7,0,7
2014,Ghina,F,100,7,0,7
2014,Ghita,F,100,7,0,7
2014,Gianah,F,100,7,0,7
2014,Gianluigi,M,100,0,7,7
2014,Giannamarie,F,100,7,0,7
2014,Giannie,F,100,7,0,7
2014,Gibbs,M,100,0,7,7
2014,Gila,F,100,7,0,7
2014,Gilad,M,100,0,7,7
2014,Gilliana,F,100,7,0,7
2014,Giomar,M,100,0,7,7
2014,Gionny,M,100,0,7,7
2014,Glorious,F,100,7,0,7
2014,Godwin,M,100,0,7,7
2014,Graceanne,F,100,7,0,7
2014,Gracieann,F,100,7,0,7
2014,Gracilyn,F,100,7,0,7
2014,Gradon,M,100,0,7,7
2014,Grantham,M,100,0,7,7
2014,Graysin,M,100,0,7,7
2014,Greysyn,M,100,0,7,7
2014,Griff,M,100,0,7,7
2014,Grigor,M,100,0,7,7
2014,Guillermina,F,100,7,0,7
2014,Gunnarr,M,100,0,7,7
2014,Gwenna,F,100,7,0,7
2014,Gyzelle,F,100,7,0,7
2014,Haani,F,100,7,0,7
2014,Haaris,M,100,0,7,7
2014,Habibah,F,100,7,0,7
2014,Hadarah,F,100,7,0,7
2014,Hadlyn,F,100,7,0,7
2014,Hailei,F,100,7,0,7
2014,Hajira,F,100,7,0,7
2014,Hajun,M,100,0,7,7
2014,Halaina,F,100,7,0,7
2014,Halaya,F,100,7,0,7
2014,Haleem,M,100,0,7,7
2014,Halena,F,100,7,0,7
2014,Halim,M,100,0,7,7
2014,Haliyah,F,100,7,0,7
2014,Hallelujah,F,100,7,0,7
2014,Halsten,M,100,0,7,7
2014,Hamsa,M,100,0,7,7
2014,Hanalei,F,100,7,0,7
2014,Hansini,F,100,7,0,7
2014,Hanzo,M,100,0,7,7
2014,Hao,M,100,0,7,7
2014,Happiness,F,100,7,0,7
2014,Harika,F,100,7,0,7
2014,Harim,M,100,0,7,7
2014,Harjot,M,100,0,7,7
2014,Harlea,F,100,7,0,7
2014,Harout,M,100,0,7,7
2014,Harshita,F,100,7,0,7
2014,Hartleigh,F,100,7,0,7
2014,Harumi,F,100,7,0,7
2014,Hayslee,F,100,7,0,7
2014,Hazal,F,100,7,0,7
2014,Hazell,F,100,7,0,7
2014,Heavin,F,100,7,0,7
2014,Hebert,M,100,0,7,7
2014,Hedaya,F,100,7,0,7
2014,Heide,F,100,7,0,7
2014,Heli,F,100,7,0,7
2014,Helix,M,100,0,7,7
2014,Henesis,F,100,7,0,7
2014,Henly,F,100,7,0,7
2014,Henos,M,100,0,7,7
2014,Heru,M,100,0,7,7
2014,Hikari,F,100,7,0,7
2014,Hodaya,F,100,7,0,7
2014,Honestee,F,100,7,0,7
2014,Honestii,F,100,7,0,7
2014,Hoor,F,100,7,0,7
2014,Hooriya,F,100,7,0,7
2014,Hser,F,100,7,0,7
2014,Hughston,M,100,0,7,7
2014,Hutchison,M,100,0,7,7
2014,Hyacinth,F,100,7,0,7
2014,Hyder,M,100,0,7,7
2014,Hyland,M,100,0,7,7
2014,Hyman,M,100,0,7,7
2014,Ibrahem,M,100,0,7,7
2014,Icelyn,F,100,7,0,7
2014,Idali,F,100,7,0,7
2014,Idamae,F,100,7,0,7
2014,Idella,F,100,7,0,7
2014,Ife,F,100,7,0,7
2014,Ihsaan,M,100,0,7,7
2014,Ilario,M,100,0,7,7
2014,Ilay,M,100,0,7,7
2014,Ilayah,F,100,7,0,7
2014,Ilayda,F,100,7,0,7
2014,Ileah,F,100,7,0,7
2014,Ilija,M,100,0,7,7
2014,Ilithya,F,100,7,0,7
2014,Ilyaas,M,100,0,7,7
2014,Ilyan,M,100,0,7,7
2014,Imanuel,M,100,0,7,7
2014,Imir,M,100,0,7,7
2014,Imonie,F,100,7,0,7
2014,Indiya,F,100,7,0,7
2014,Indyah,F,100,7,0,7
2014,Ingram,M,100,0,7,7
2014,Inshirah,F,100,7,0,7
2014,Intisar,F,100,7,0,7
2014,Iola,F,100,7,0,7
2014,Iori,M,100,0,7,7
2014,Irany,F,100,7,0,7
2014,Iremide,M,100,0,7,7
2014,Irissa,F,100,7,0,7
2014,Iryna,F,100,7,0,7
2014,Isaah,M,100,0,7,7
2014,Isam,M,100,0,7,7
2014,Italo,M,100,0,7,7
2014,Ithan,M,100,0,7,7
2014,Itsuki,M,100,0,7,7
2014,Itzuri,F,100,7,0,7
2014,Ivah,F,100,7,0,7
2014,Ivionna,F,100,7,0,7
2014,Ivor,M,100,0,7,7
2014,Iyani,F,100,7,0,7
2014,Iysis,F,100,7,0,7
2014,Izaiha,M,100,0,7,7
2014,Izyck,M,100,0,7,7
2014,Jaan,M,100,0,7,7
2014,Jaaron,M,100,0,7,7
2014,Jac,M,100,0,7,7
2014,Jacarion,M,100,0,7,7
2014,Jacian,M,100,0,7,7
2014,Jacier,M,100,0,7,7
2014,Jackalyn,F,100,7,0,7
2014,Jackston,M,100,0,7,7
2014,Jacson,M,100,0,7,7
2014,Jadea,F,100,7,0,7
2014,Jadrien,M,100,0,7,7
2014,Jady,F,100,7,0,7
2014,Jaeanna,F,100,7,0,7
2014,Jaethan,M,100,0,7,7
2014,Jaffer,M,100,0,7,7
2014,Jaffet,M,100,0,7,7
2014,Jahira,F,100,7,0,7
2014,Jahlaya,F,100,7,0,7
2014,Jahleya,F,100,7,0,7
2014,Jahmi,M,100,0,7,7
2014,Jahmia,F,100,7,0,7
2014,Jahmiyah,F,100,7,0,7
2014,Jahmya,F,100,7,0,7
2014,Jahzeel,M,100,0,7,7
2014,Jaidalyn,F,100,7,0,7
2014,Jaidev,M,100,0,7,7
2014,Jaileah,F,100,7,0,7
2014,Jaimarie,F,100,7,0,7
2014,Jais,M,100,0,7,7
2014,Jaisa,F,100,7,0,7
2014,Jaislyn,F,100,7,0,7
2014,Jaiyden,M,100,0,7,7
2014,Jakaiyah,F,100,7,0,7
2014,Jakaylah,F,100,7,0,7
2014,Jakyah,F,100,7,0,7
2014,Jakyree,M,100,0,7,7
2014,Jalasia,F,100,7,0,7
2014,Jalayiah,F,100,7,0,7
2014,Jalee,F,100,7,0,7
2014,Jaleiah,F,100,7,0,7
2014,Jaliana,F,100,7,0,7
2014,Jalysia,F,100,7,0,7
2014,Jama,M,100,0,7,7
2014,Jamael,M,100,0,7,7
2014,Jamariyah,F,100,7,0,7
2014,Jamarley,M,100,0,7,7
2014,Jamason,M,100,0,7,7
2014,Jamaul,M,100,0,7,7
2014,Jamecia,F,100,7,0,7
2014,Jamesmichael,M,100,0,7,7
2014,Jamille,M,100,0,7,7
2014,Jamilyn,F,100,7,0,7
2014,Jamion,M,100,0,7,7
2014,Jamiyla,F,100,7,0,7
2014,Jamonte,M,100,0,7,7
2014,Janala,F,100,7,0,7
2014,Janavi,F,100,7,0,7
2014,Janaye,F,100,7,0,7
2014,Janayia,F,100,7,0,7
2014,Janelyn,F,100,7,0,7
2014,Janielle,F,100,7,0,7
2014,Janielys,F,100,7,0,7
2014,Janiyha,F,100,7,0,7
2014,Jannessa,F,100,7,0,7
2014,Janneth,F,100,7,0,7
2014,Jansel,M,100,0,7,7
2014,Jaques,M,100,0,7,7
2014,Jara,F,100,7,0,7
2014,Jarelle,M,100,0,7,7
2014,Jarelly,F,100,7,0,7
2014,Jaryiah,F,100,7,0,7
2014,Jasa,F,100,7,0,7
2014,Jasek,M,100,0,7,7
2014,Jashun,M,100,0,7,7
2014,Jasraj,M,100,0,7,7
2014,Jasreet,F,100,7,0,7
2014,Jasten,M,100,0,7,7
2014,Jatavious,M,100,0,7,7
2014,Jathniel,M,100,0,7,7
2014,Jatoria,F,100,7,0,7
2014,Javanni,M,100,0,7,7
2014,Javarion,M,100,0,7,7
2014,Javius,M,100,0,7,7
2014,Javonn,M,100,0,7,7
2014,Javonna,F,100,7,0,7
2014,Javontay,M,100,0,7,7
2014,Javyn,M,100,0,7,7
2014,Jawon,M,100,0,7,7
2014,Jaxxton,M,100,0,7,7
2014,Jayceyon,M,100,0,7,7
2014,Jaydalis,F,100,7,0,7
2014,Jaydden,M,100,0,7,7
2014,Jaydeliz,F,100,7,0,7
2014,Jaydelyn,F,100,7,0,7
2014,Jaydis,M,100,0,7,7
2014,Jayen,M,100,0,7,7
2014,Jaylannie,F,100,7,0,7
2014,Jaylany,F,100,7,0,7
2014,Jaylarose,F,100,7,0,7
2014,Jayleanna,F,100,7,0,7
2014,Jaylianie,F,100,7,0,7
2014,Jaylinne,F,100,7,0,7
2014,Jaylnn,F,100,7,0,7
2014,Jayma,F,100,7,0,7
2014,Jaysten,M,100,0,7,7
2014,Jayzeon,M,100,0,7,7
2014,Jayzin,M,100,0,7,7
2014,Jazilynn,F,100,7,0,7
2014,Jazzilyn,F,100,7,0,7
2014,Jazzlynne,F,100,7,0,7
2014,Jebron,M,100,0,7,7
2014,Jedrick,M,100,0,7,7
2014,Jeeya,F,100,7,0,7
2014,Jefry,M,100,0,7,7
2014,Jeidy,F,100,7,0,7
2014,Jeimmy,F,100,7,0,7
2014,Jenaro,M,100,0,7,7
2014,Jenavi,F,100,7,0,7
2014,Jenella,F,100,7,0,7
2014,Jenevy,F,100,7,0,7
2014,Jenissa,F,100,7,0,7
2014,Jenivieve,F,100,7,0,7
2014,Jeorge,M,100,0,7,7
2014,Jerardo,M,100,0,7,7
2014,Jeremya,M,100,0,7,7
2014,Jeren,M,100,0,7,7
2014,Jericko,M,100,0,7,7
2014,Jermari,M,100,0,7,7
2014,Jermarion,M,100,0,7,7
2014,Jermey,M,100,0,7,7
2014,Jermiya,F,100,7,0,7
2014,Jermon,M,100,0,7,7
2014,Jerniyah,F,100,7,0,7
2014,Jerred,M,100,0,7,7
2014,Jerryn,M,100,0,7,7
2014,Jersee,F,100,7,0,7
2014,Jersi,F,100,7,0,7
2014,Jerusalen,F,100,7,0,7
2014,Jeryl,M,100,0,7,7
2014,Jeselle,F,100,7,0,7
2014,Jessabella,F,100,7,0,7
2014,Jessalee,F,100,7,0,7
2014,Jessamae,F,100,7,0,7
2014,Jessimae,F,100,7,0,7
2014,Jesslin,F,100,7,0,7
2014,Jessly,F,100,7,0,7
2014,Jessup,M,100,0,7,7
2014,Jessyka,F,100,7,0,7
2014,Jesten,M,100,0,7,7
2014,Jevan,M,100,0,7,7
2014,Jeydan,M,100,0,7,7
2014,Jeymi,F,100,7,0,7
2014,Jeysen,M,100,0,7,7
2014,Jhade,F,100,7,0,7
2014,Jhaiden,M,100,0,7,7
2014,Jhair,M,100,0,7,7
2014,Jhoanna,F,100,7,0,7
2014,Jhony,M,100,0,7,7
2014,Jhoselyn,F,100,7,0,7
2014,Jhournee,F,100,7,0,7
2014,Jiancarlo,M,100,0,7,7
2014,Jiarui,M,100,0,7,7
2014,Jisela,F,100,7,0,7
2014,Jizzelle,F,100,7,0,7
2014,Jniah,F,100,7,0,7
2014,Joannie,F,100,7,0,7
2014,Joanny,F,100,7,0,7
2014,Joash,M,100,0,7,7
2014,Jodeci,M,100,0,7,7
2014,Jodee,F,100,7,0,7
2014,Joeanthony,M,100,0,7,7
2014,Joelene,F,100,7,0,7
2014,Jofiel,M,100,0,7,7
2014,Johnryan,M,100,0,7,7
2014,Johntae,M,100,0,7,7
2014,Joleena,F,100,7,0,7
2014,Joliene,F,100,7,0,7
2014,Jonalyn,F,100,7,0,7
2014,Jonel,M,100,0,7,7
2014,Jonibek,M,100,0,7,7
2014,Jonmichael,M,100,0,7,7
2014,Jorah,M,100,0,7,7
2014,Jorey,M,100,0,7,7
2014,Jorin,M,100,0,7,7
2014,Joscelin,F,100,7,0,7
2014,Josejulian,M,100,0,7,7
2014,Joseth,M,100,0,7,7
2014,Joshuajames,M,100,0,7,7
2014,Josiane,F,100,7,0,7
2014,Josselyne,F,100,7,0,7
2014,Josslin,F,100,7,0,7
2014,Josy,F,100,7,0,7
2014,Josyiah,M,100,0,7,7
2014,Jozelynn,F,100,7,0,7
2014,Jrew,M,100,0,7,7
2014,Jt,M,100,0,7,7
2014,Juanluis,M,100,0,7,7
2014,Julene,F,100,7,0,7
2014,Julieonna,F,100,7,0,7
2014,Julious,M,100,0,7,7
2014,Juliyan,M,100,0,7,7
2014,Julyanna,F,100,7,0,7
2014,Jumanah,F,100,7,0,7
2014,Juneau,F,100,7,0,7
2014,Justinian,M,100,0,7,7
2014,Jw,M,100,0,7,7
2014,Jyler,M,100,0,7,7
2014,Kacelynn,F,100,7,0,7
2014,Kaceton,M,100,0,7,7
2014,Kaelon,M,100,0,7,7
2014,Kaeto,M,100,0,7,7
2014,Kahlani,F,100,7,0,7
2014,Kahle,M,100,0,7,7
2014,Kahleah,F,100,7,0,7
2014,Kahlee,F,100,7,0,7
2014,Kahliya,F,100,7,0,7
2014,Kailas,M,100,0,7,7
2014,Kaileena,F,100,7,0,7
2014,Kailene,F,100,7,0,7
2014,Kailiana,F,100,7,0,7
2014,Kailiyah,F,100,7,0,7
2014,Kailoni,F,100,7,0,7
2014,Kaipo,M,100,0,7,7
2014,Kairan,M,100,0,7,7
2014,Kalasia,F,100,7,0,7
2014,Kaleila,F,100,7,0,7
2014,Kaleth,M,100,0,7,7
2014,Kalid,M,100,0,7,7
2014,Kaliegh,F,100,7,0,7
2014,Kalisha,F,100,7,0,7
2014,Kaliyanei,F,100,7,0,7
2014,Kalla,F,100,7,0,7
2014,Kalven,M,100,0,7,7
2014,Kaly,F,100,7,0,7
2014,Kalyana,F,100,7,0,7
2014,Kalyiah,F,100,7,0,7
2014,Kamaiya,F,100,7,0,7
2014,Kamarrion,M,100,0,7,7
2014,Kamdan,M,100,0,7,7
2014,Kamdynn,F,100,7,0,7
2014,Kamelia,F,100,7,0,7
2014,Kamina,F,100,7,0,7
2014,Kaniel,M,100,0,7,7
2014,Kanika,F,100,7,0,7
2014,Kanisha,F,100,7,0,7
2014,Kannen,M,100,0,7,7
2014,Kaos,M,100,0,7,7
2014,Kapiolani,F,100,7,0,7
2014,Kapono,M,100,0,7,7
2014,Kapree,F,100,7,0,7
2014,Kaprice,F,100,7,0,7
2014,Kaptain,M,100,0,7,7
2014,Karcyn,F,100,7,0,7
2014,Karcynn,F,100,7,0,7
2014,Karine,F,100,7,0,7
2014,Karington,F,100,7,0,7
2014,Karlito,M,100,0,7,7
2014,Karlton,M,100,0,7,7
2014,Kartel,M,100,0,7,7
2014,Kary,F,100,7,0,7
2014,Kaseem,M,100,0,7,7
2014,Kaselynn,F,100,7,0,7
2014,Kashay,F,100,7,0,7
2014,Kashia,F,100,7,0,7
2014,Kashif,M,100,0,7,7
2014,Kashis,M,100,0,7,7
2014,Kashon,M,100,0,7,7
2014,Kassady,F,100,7,0,7
2014,Kasson,M,100,0,7,7
2014,Katalynna,F,100,7,0,7
2014,Katanna,F,100,7,0,7
2014,Kataryna,F,100,7,0,7
2014,Katelee,F,100,7,0,7
2014,Kately,F,100,7,0,7
2014,Kateryna,F,100,7,0,7
2014,Katiya,F,100,7,0,7
2014,Katja,F,100,7,0,7
2014,Kaushik,M,100,0,7,7
2014,Kawon,M,100,0,7,7
2014,Kaybri,F,100,7,0,7
2014,Kaylean,F,100,7,0,7
2014,Kaylem,M,100,0,7,7
2014,Kayliegh,F,100,7,0,7
2014,Kaylis,F,100,7,0,7
2014,Kaylnn,F,100,7,0,7
2014,Kayloni,F,100,7,0,7
2014,Kaylonnie,F,100,7,0,7
2014,Kayman,M,100,0,7,7
2014,Kaynin,M,100,0,7,7
2014,Kayvan,M,100,0,7,7
2014,Kayveon,M,100,0,7,7
2014,Kazim,M,100,0,7,7
2014,Kaziyah,F,100,7,0,7
2014,Keano,M,100,0,7,7
2014,Keeden,M,100,0,7,7
2014,Keegen,M,100,0,7,7
2014,Keelen,M,100,0,7,7
2014,Keelynn,F,100,7,0,7
2014,Keenon,M,100,0,7,7
2014,Kehila,F,100,7,0,7
2014,Keiara,F,100,7,0,7
2014,Keiasia,F,100,7,0,7
2014,Keighley,F,100,7,0,7
2014,Keileigh,F,100,7,0,7
2014,Keiton,M,100,0,7,7
2014,Kelbi,F,100,7,0,7
2014,Kelen,M,100,0,7,7
2014,Kelena,F,100,7,0,7
2014,Keliah,F,100,7,0,7
2014,Kelijah,M,100,0,7,7
2014,Kelina,F,100,7,0,7
2014,Kellam,M,100,0,7,7
2014,Kelon,M,100,0,7,7
2014,Kelvyn,M,100,0,7,7
2014,Kemberly,F,100,7,0,7
2014,Kemiah,F,100,7,0,7
2014,Kempton,M,100,0,7,7
2014,Kendrea,F,100,7,0,7
2014,Kendrew,M,100,0,7,7
2014,Kengston,M,100,0,7,7
2014,Kenlea,F,100,7,0,7
2014,Kennidee,F,100,7,0,7
2014,Kennidy,F,100,7,0,7
2014,Kenniya,F,100,7,0,7
2014,Kenric,M,100,0,7,7
2014,Kensen,M,100,0,7,7
2014,Kenston,M,100,0,7,7
2014,Keny,M,100,0,7,7
2014,Kerington,F,100,7,0,7
2014,Keriyah,F,100,7,0,7
2014,Kerwin,M,100,0,7,7
2014,Keslee,F,100,7,0,7
2014,Ketcher,M,100,0,7,7
2014,Kevionna,F,100,7,0,7
2014,Kevontae,M,100,0,7,7
2014,Keyandre,M,100,0,7,7
2014,Keyera,F,100,7,0,7
2014,Keylani,F,100,7,0,7
2014,Keynan,M,100,0,7,7
2014,Keyonni,F,100,7,0,7
2014,Keziyah,F,100,7,0,7
2014,Khaila,F,100,7,0,7
2014,Khailee,F,100,7,0,7
2014,Khaliel,M,100,0,7,7
2014,Khalisi,F,100,7,0,7
2014,Khalyn,F,100,7,0,7
2014,Kham,M,100,0,7,7
2014,Kharlee,F,100,7,0,7
2014,Khason,M,100,0,7,7
2014,Khianna,F,100,7,0,7
2014,Khiley,F,100,7,0,7
2014,Khriz,M,100,0,7,7
2014,Khya,F,100,7,0,7
2014,Khyre,M,100,0,7,7
2014,Kianah,F,100,7,0,7
2014,Kiarrah,F,100,7,0,7
2014,Kielyn,F,100,7,0,7
2014,Kielynn,F,100,7,0,7
2014,Kier,M,100,0,7,7
2014,Kiing,M,100,0,7,7
2014,Kimar,M,100,0,7,7
2014,Kimimela,F,100,7,0,7
2014,Kimimila,F,100,7,0,7
2014,Kimiya,F,100,7,0,7
2014,Kimmora,F,100,7,0,7
2014,Kinberly,F,100,7,0,7
2014,Kindra,F,100,7,0,7
2014,Kindrick,M,100,0,7,7
2014,Kingmichael,M,100,0,7,7
2014,Kingsolomon,M,100,0,7,7
2014,Kinjal,F,100,7,0,7
2014,Kinlei,F,100,7,0,7
2014,Kinlie,F,100,7,0,7
2014,Kinsly,F,100,7,0,7
2014,Kiralyn,F,100,7,0,7
2014,Kirpa,F,100,7,0,7
2014,Kiyla,F,100,7,0,7
2014,Kiyra,F,100,7,0,7
2014,Klani,F,100,7,0,7
2014,Kleo,F,100,7,0,7
2014,Klhoe,F,100,7,0,7
2014,Kmora,F,100,7,0,7
2014,Knighton,M,100,0,7,7
2014,Knyla,F,100,7,0,7
2014,Koko,F,100,7,0,7
2014,Kolbee,F,100,7,0,7
2014,Kolie,F,100,7,0,7
2014,Kollyn,M,100,0,7,7
2014,Koran,M,100,0,7,7
2014,Kordai,M,100,0,7,7
2014,Korinna,F,100,7,0,7
2014,Kosta,M,100,0,7,7
2014,Kourosh,M,100,0,7,7
2014,Kraven,M,100,0,7,7
2014,Krisette,F,100,7,0,7
2014,Krishaan,M,100,0,7,7
2014,Krishawn,M,100,0,7,7
2014,Krissia,F,100,7,0,7
2014,Kroix,M,100,0,7,7
2014,Kron,M,100,0,7,7
2014,Krzysztof,M,100,0,7,7
2014,Kshawn,M,100,0,7,7
2014,Kuper,M,100,0,7,7
2014,Kvion,M,100,0,7,7
2014,Kwan,M,100,0,7,7
2014,Kwasi,M,100,0,7,7
2014,Kween,F,100,7,0,7
2014,Kyarah,F,100,7,0,7
2014,Kyian,M,100,0,7,7
2014,Kyleeann,F,100,7,0,7
2014,Kyleena,F,100,7,0,7
2014,Kyleigha,F,100,7,0,7
2014,Kylina,F,100,7,0,7
2014,Kymiah,F,100,7,0,7
2014,Kymier,M,100,0,7,7
2014,Kynlea,F,100,7,0,7
2014,Kynzley,F,100,7,0,7
2014,Kyreece,M,100,0,7,7
2014,Kyreese,M,100,0,7,7
2014,Kyriana,F,100,7,0,7
2014,Kyrstin,F,100,7,0,7
2014,Kytzia,F,100,7,0,7
2014,Lachlyn,F,100,7,0,7
2014,Ladarrion,M,100,0,7,7
2014,Lahela,F,100,7,0,7
2014,Laiana,F,100,7,0,7
2014,Laiklynn,F,100,7,0,7
2014,Lailanee,F,100,7,0,7
2014,Lailynn,F,100,7,0,7
2014,Laionna,F,100,7,0,7
2014,Lakeyn,F,100,7,0,7
2014,Lakira,F,100,7,0,7
2014,Lakoda,M,100,0,7,7
2014,Lalita,F,100,7,0,7
2014,Lamoni,F,100,7,0,7
2014,Lamonica,F,100,7,0,7
2014,Lanaiya,F,100,7,0,7
2014,Lanique,F,100,7,0,7
2014,Lantz,M,100,0,7,7
2014,Lanyla,F,100,7,0,7
2014,Laraina,F,100,7,0,7
2014,Laren,F,100,7,0,7
2014,Laryiah,F,100,7,0,7
2014,Lashawna,F,100,7,0,7
2014,Latoria,F,100,7,0,7
2014,Latrinity,F,100,7,0,7
2014,Laureli,F,100,7,0,7
2014,Laurelin,F,100,7,0,7
2014,Laurin,F,100,7,0,7
2014,Laveyah,F,100,7,0,7
2014,Laylan,F,100,7,0,7
2014,Laylynn,F,100,7,0,7
2014,Layson,M,100,0,7,7
2014,Lazariah,F,100,7,0,7
2014,Lazaya,F,100,7,0,7
2014,Le,M,100,0,7,7
2014,Leaf,M,100,0,7,7
2014,Leahnna,F,100,7,0,7
2014,Learah,F,100,7,0,7
2014,Leeasia,F,100,7,0,7
2014,Leelu,F,100,7,0,7
2014,Leeon,M,100,0,7,7
2014,Lehi,M,100,0,7,7
2014,Leiby,M,100,0,7,7
2014,Leilahni,F,100,7,0,7
2014,Leili,F,100,7,0,7
2014,Leilynn,F,100,7,0,7
2014,Lejend,M,100,0,7,7
2014,Lella,F,100,7,0,7
2014,Lelyn,M,100,0,7,7
2014,Lelynd,M,100,0,7,7
2014,Leto,M,100,0,7,7
2014,Letrell,M,100,0,7,7
2014,Levell,M,100,0,7,7
2014,Levent,M,100,0,7,7
2014,Lexandra,F,100,7,0,7
2014,Lexianna,F,100,7,0,7
2014,Lexine,F,100,7,0,7
2014,Leysha,F,100,7,0,7
2014,Li,M,100,0,7,7
2014,Liamgabriel,M,100,0,7,7
2014,Liamjames,M,100,0,7,7
2014,Liammatthew,M,100,0,7,7
2014,Liammichael,M,100,0,7,7
2014,Lianette,F,100,7,0,7
2014,Liany,F,100,7,0,7
2014,Librado,M,100,0,7,7
2014,Lilienne,F,100,7,0,7
2014,Lilinoe,F,100,7,0,7
2014,Lille,F,100,7,0,7
2014,Lilliam,F,100,7,0,7
2014,Lilliane,F,100,7,0,7
2014,Lillieana,F,100,7,0,7
2014,Lilliemae,F,100,7,0,7
2014,Lillienne,F,100,7,0,7
2014,Lillyanah,F,100,7,0,7
2014,Lillyauna,F,100,7,0,7
2014,Lillybelle,F,100,7,0,7
2014,Lindell,M,100,0,7,7
2014,Linleigh,F,100,7,0,7
2014,Linsy,F,100,7,0,7
2014,Linzie,F,100,7,0,7
2014,Liona,F,100,7,0,7
2014,Lissett,F,100,7,0,7
2014,Livingston,M,100,0,7,7
2014,Liyat,F,100,7,0,7
2014,Lizmary,F,100,7,0,7
2014,Llewellyn,M,100,0,7,7
2014,Loraina,F,100,7,0,7
2014,Lorely,F,100,7,0,7
2014,Lorence,M,100,0,7,7
2014,Lotte,F,100,7,0,7
2014,Louay,M,100,0,7,7
2014,Lovelee,F,100,7,0,7
2014,Lovelle,F,100,7,0,7
2014,Lovelyn,F,100,7,0,7
2014,Loza,F,100,7,0,7
2014,Luanne,F,100,7,0,7
2014,Lucianne,F,100,7,0,7
2014,Lucyanna,F,100,7,0,7
2014,Ludwig,M,100,0,7,7
2014,Luisfernando,M,100,0,7,7
2014,Lukka,M,100,0,7,7
2014,Lulani,F,100,7,0,7
2014,Luma,F,100,7,0,7
2014,Luzia,F,100,7,0,7
2014,Lydie,F,100,7,0,7
2014,Lylianna,F,100,7,0,7
2014,Lylie,F,100,7,0,7
2014,Lylliana,F,100,7,0,7
2014,Lyllie,F,100,7,0,7
2014,Lyndan,F,100,7,0,7
2014,Lyneah,F,100,7,0,7
2014,Lynell,M,100,0,7,7
2014,Lyniyah,F,100,7,0,7
2014,Lynne,F,100,7,0,7
2014,Lynniah,F,100,7,0,7
2014,Lynnley,F,100,7,0,7
2014,Lynora,F,100,7,0,7
2014,Lyrika,F,100,7,0,7
2014,Mabree,F,100,7,0,7
2014,Mackay,M,100,0,7,7
2014,Mackenzye,F,100,7,0,7
2014,Mackinnon,M,100,0,7,7
2014,Macks,M,100,0,7,7
2014,Maclean,M,100,0,7,7
2014,Macrina,F,100,7,0,7
2014,Madaleine,F,100,7,0,7
2014,Madalina,F,100,7,0,7
2014,Maddielynn,F,100,7,0,7
2014,Madsen,M,100,0,7,7
2014,Madylynn,F,100,7,0,7
2014,Maebh,F,100,7,0,7
2014,Maedot,F,100,7,0,7
2014,Maekayla,F,100,7,0,7
2014,Magalie,F,100,7,0,7
2014,Maggi,F,100,7,0,7
2014,Mahamadou,M,100,0,7,7
2014,Mahniya,F,100,7,0,7
2014,Mahsa,F,100,7,0,7
2014,Maicee,F,100,7,0,7
2014,Maili,F,100,7,0,7
2014,Mairyn,F,100,7,0,7
2014,Maitte,F,100,7,0,7
2014,Majer,M,100,0,7,7
2014,Majesti,F,100,7,0,7
2014,Maka,F,100,7,0,7
2014,Makail,M,100,0,7,7
2014,Makalynn,F,100,7,0,7
2014,Makeila,F,100,7,0,7
2014,Makensey,F,100,7,0,7
2014,Makensley,F,100,7,0,7
2014,Mala,F,100,7,0,7
2014,Malacai,M,100,0,7,7
2014,Malacki,M,100,0,7,7
2014,Malaijah,F,100,7,0,7
2014,Malaisha,F,100,7,0,7
2014,Malarie,F,100,7,0,7
2014,Malayjah,F,100,7,0,7
2014,Maley,F,100,7,0,7
2014,Malijah,F,100,7,0,7
2014,Malikiah,M,100,0,7,7
2014,Mallarie,F,100,7,0,7
2014,Malloree,F,100,7,0,7
2014,Malyiah,F,100,7,0,7
2014,Malyk,M,100,0,7,7
2014,Malyn,F,100,7,0,7
2014,Manaf,M,100,0,7,7
2014,Mane,F,100,7,0,7
2014,Manhattan,F,100,7,0,7
2014,Manveer,M,100,0,7,7
2014,Marai,F,100,7,0,7
2014,Marcellous,M,100,0,7,7
2014,Marcuz,M,100,0,7,7
2014,Marelin,F,100,7,0,7
2014,Marella,F,100,7,0,7
2014,Margarete,F,100,7,0,7
2014,Margery,F,100,7,0,7
2014,Mariangela,F,100,7,0,7
2014,Maribeth,F,100,7,0,7
2014,Marija,F,100,7,0,7
2014,Markee,M,100,0,7,7
2014,Markevious,M,100,0,7,7
2014,Markise,M,100,0,7,7
2014,Marlana,F,100,7,0,7
2014,Marline,F,100,7,0,7
2014,Marra,F,100,7,0,7
2014,Marriah,F,100,7,0,7
2014,Marston,M,100,0,7,7
2014,Martrell,M,100,0,7,7
2014,Martyn,M,100,0,7,7
2014,Maryangel,F,100,7,0,7
2014,Marycarmen,F,100,7,0,7
2014,Maryclare,F,100,7,0,7
2014,Marycruz,F,100,7,0,7
2014,Maryjo,F,100,7,0,7
2014,Maryori,F,100,7,0,7
2014,Marz,M,100,0,7,7
2014,Marzell,M,100,0,7,7
2014,Masha,F,100,7,0,7
2014,Massai,M,100,0,7,7
2014,Maston,M,100,0,7,7
2014,Mathan,M,100,0,7,7
2014,Mathea,F,100,7,0,7
2014,Matrix,M,100,0,7,7
2014,Mattan,M,100,0,7,7
2014,Matteus,M,100,0,7,7
2014,Maurissa,F,100,7,0,7
2014,Mauriyah,F,100,7,0,7
2014,Mavi,F,100,7,0,7
2014,Maxence,M,100,0,7,7
2014,Maxsen,M,100,0,7,7
2014,Maxten,M,100,0,7,7
2014,Mayan,F,100,7,0,7
2014,Mayari,F,100,7,0,7
2014,Mayreli,F,100,7,0,7
2014,Mays,M,100,0,7,7
2014,Mayssa,F,100,7,0,7
2014,Maytal,F,100,7,0,7
2014,Mayuri,F,100,7,0,7
2014,Mckenize,F,100,7,0,7
2014,Mckenly,F,100,7,0,7
2014,Mckinzy,F,100,7,0,7
2014,Mckynley,F,100,7,0,7
2014,Mckynna,F,100,7,0,7
2014,Mckynzee,F,100,7,0,7
2014,Meeah,F,100,7,0,7
2014,Meeko,M,100,0,7,7
2014,Meghna,F,100,7,0,7
2014,Mehmed,M,100,0,7,7
2014,Meladie,F,100,7,0,7
2014,Melana,F,100,7,0,7
2014,Meleny,F,100,7,0,7
2014,Mellina,F,100,7,0,7
2014,Melondy,F,100,7,0,7
2014,Melynda,F,100,7,0,7
2014,Mercie,F,100,7,0,7
2014,Merelyn,F,100,7,0,7
2014,Meridian,F,100,7,0,7
2014,Meriem,F,100,7,0,7
2014,Meritxell,F,100,7,0,7
2014,Merrin,F,100,7,0,7
2014,Meryam,F,100,7,0,7
2014,Messai,M,100,0,7,7
2014,Metztli,F,100,7,0,7
2014,Miabelle,F,100,7,0,7
2014,Micai,M,100,0,7,7
2014,Michah,M,100,0,7,7
2014,Michala,F,100,7,0,7
2014,Mickaela,F,100,7,0,7
2014,Mielle,F,100,7,0,7
2014,Mikaelah,F,100,7,0,7
2014,Mikaiah,F,100,7,0,7
2014,Mikailah,F,100,7,0,7
2014,Mikeila,F,100,7,0,7
2014,Mikinley,F,100,7,0,7
2014,Mikyle,M,100,0,7,7
2014,Milaan,F,100,7,0,7
2014,Milaysia,F,100,7,0,7
2014,Milcah,F,100,7,0,7
2014,Milea,F,100,7,0,7
2014,Mileidy,F,100,7,0,7
2014,Mileydi,F,100,7,0,7
2014,Milez,M,100,0,7,7
2014,Milon,M,100,0,7,7
2014,Min,M,100,0,7,7
2014,Minato,M,100,0,7,7
2014,Minela,F,100,7,0,7
2014,Minsa,F,100,7,0,7
2014,Mirac,M,100,0,7,7
2014,Miriya,F,100,7,0,7
2014,Mirren,F,100,7,0,7
2014,Misaki,F,100,7,0,7
2014,Mishel,F,100,7,0,7
2014,Miyoko,F,100,7,0,7
2014,Miyu,F,100,7,0,7
2014,Moataz,M,100,0,7,7
2014,Moayed,M,100,0,7,7
2014,Moe,M,100,0,7,7
2014,Momin,M,100,0,7,7
2014,Momoka,F,100,7,0,7
2014,Monta,M,100,0,7,7
2014,Montay,M,100,0,7,7
2014,Montrez,M,100,0,7,7
2014,Morayo,F,100,7,0,7
2014,Morgana,F,100,7,0,7
2014,Morgann,F,100,7,0,7
2014,Morrell,M,100,0,7,7
2014,Mouhamad,M,100,0,7,7
2014,Mounir,M,100,0,7,7
2014,Moyosoreoluwa,F,100,7,0,7
2014,Muhannad,M,100,0,7,7
2014,Mumin,M,100,0,7,7
2014,Munisa,F,100,7,0,7
2014,Muscab,M,100,0,7,7
2014,Muskan,F,100,7,0,7
2014,Muslima,F,100,7,0,7
2014,Mutasim,M,100,0,7,7
2014,Myiesha,F,100,7,0,7
2014,Mykala,F,100,7,0,7
2014,Mykeria,F,100,7,0,7
2014,Mykia,F,100,7,0,7
2014,Myleigha,F,100,7,0,7
2014,Mylove,F,100,7,0,7
2014,Mystery,F,100,7,0,7
2014,Mystique,F,100,7,0,7
2014,Naaman,M,100,0,7,7
2014,Naara,F,100,7,0,7
2014,Naeomi,F,100,7,0,7
2014,Naheim,M,100,0,7,7
2014,Naida,F,100,7,0,7
2014,Nairi,F,100,7,0,7
2014,Naitik,M,100,0,7,7
2014,Najat,F,100,7,0,7
2014,Najia,F,100,7,0,7
2014,Nakhi,M,100,0,7,7
2014,Nalanie,F,100,7,0,7
2014,Nalayna,F,100,7,0,7
2014,Nalyah,F,100,7,0,7
2014,Namari,M,100,0,7,7
2014,Nameera,F,100,7,0,7
2014,Namia,F,100,7,0,7
2014,Nan,F,100,7,0,7
2014,Nanayaa,F,100,7,0,7
2014,Naod,M,100,0,7,7
2014,Narain,M,100,0,7,7
2014,Narely,F,100,7,0,7
2014,Naren,M,100,0,7,7
2014,Nasri,M,100,0,7,7
2014,Naszir,M,100,0,7,7
2014,Nataliyah,F,100,7,0,7
2014,Natasia,F,100,7,0,7
2014,Nathanyel,M,100,0,7,7
2014,Natia,F,100,7,0,7
2014,Natilyn,F,100,7,0,7
2014,Navneet,F,100,7,0,7
2014,Nayab,F,100,7,0,7
2014,Nayalee,F,100,7,0,7
2014,Nayela,F,100,7,0,7
2014,Nayeliz,F,100,7,0,7
2014,Naysha,F,100,7,0,7
2014,Nayvadius,M,100,0,7,7
2014,Nazeer,M,100,0,7,7
2014,Nea,F,100,7,0,7
2014,Necalli,M,100,0,7,7
2014,Neco,M,100,0,7,7
2014,Nefeli,F,100,7,0,7
2014,Nehir,F,100,7,0,7
2014,Neisha,F,100,7,0,7
2014,Nekko,M,100,0,7,7
2014,Nelsy,F,100,7,0,7
2014,Nema,F,100,7,0,7
2014,Neomiah,M,100,0,7,7
2014,Nephtalie,F,100,7,0,7
2014,Nermin,F,100,7,0,7
2014,Nesochi,F,100,7,0,7
2014,Netanya,F,100,7,0,7
2014,Nethaniel,M,100,0,7,7
2014,Neveyah,F,100,7,0,7
2014,Nevyn,M,100,0,7,7
2014,Neyah,F,100,7,0,7
2014,Ngoc,F,100,7,0,7
2014,Nhyira,F,100,7,0,7
2014,Nialah,F,100,7,0,7
2014,Nikai,M,100,0,7,7
2014,Nikitha,F,100,7,0,7
2014,Nikka,F,100,7,0,7
2014,Nikkie,F,100,7,0,7
2014,Nikkos,M,100,0,7,7
2014,Nikodem,M,100,0,7,7
2014,Nikoloz,M,100,0,7,7
2014,Nineveh,F,100,7,0,7
2014,Ninfa,F,100,7,0,7
2014,Nishika,F,100,7,0,7
2014,Nishita,F,100,7,0,7
2014,Nithin,M,100,0,7,7
2014,Nitin,M,100,0,7,7
2014,Nivedh,M,100,0,7,7
2014,Nivriti,F,100,7,0,7
2014,Nixson,M,100,0,7,7
2014,Niyelle,F,100,7,0,7
2014,Nnenna,F,100,7,0,7
2014,Noaah,M,100,0,7,7
2014,Noelan,M,100,0,7,7
2014,Nofer,M,100,0,7,7
2014,Nohealani,F,100,7,0,7
2014,Nole,M,100,0,7,7
2014,Nolon,M,100,0,7,7
2014,Norielle,F,100,7,0,7
2014,Nouf,F,100,7,0,7
2014,Nozomi,F,100,7,0,7
2014,Nusrat,F,100,7,0,7
2014,Nyala,F,100,7,0,7
2014,Nyeem,M,100,0,7,7
2014,Nyeli,F,100,7,0,7
2014,Nykeem,M,100,0,7,7
2014,Nykia,F,100,7,0,7
2014,Nylaa,F,100,7,0,7
2014,Nyleigh,F,100,7,0,7
2014,Nyomie,F,100,7,0,7
2014,Nyrah,F,100,7,0,7
2014,Oceane,F,100,7,0,7
2014,Odai,M,100,0,7,7
2014,Oday,M,100,0,7,7
2014,Olanna,F,100,7,0,7
2014,Oli,M,100,0,7,7
2014,Oliviamarie,F,100,7,0,7
2014,Olman,M,100,0,7,7
2014,Oluwatimileyin,M,100,0,7,7
2014,Omair,M,100,0,7,7
2014,Omara,F,100,7,0,7
2014,Omarie,M,100,0,7,7
2014,Ondrea,F,100,7,0,7
2014,Orestes,M,100,0,7,7
2014,Orielle,F,100,7,0,7
2014,Ornella,F,100,7,0,7
2014,Orry,M,100,0,7,7
2014,Oshyn,F,100,7,0,7
2014,Osiah,M,100,0,7,7
2014,Ossiel,M,100,0,7,7
2014,Ottilie,F,100,7,0,7
2014,Oviya,F,100,7,0,7
2014,Paco,M,100,0,7,7
2014,Pahal,F,100,7,0,7
2014,Paisely,F,100,7,0,7
2014,Paiyton,F,100,7,0,7
2014,Palin,F,100,7,0,7
2014,Papa,M,100,0,7,7
2014,Parthenia,F,100,7,0,7
2014,Pasha,M,100,0,7,7
2014,Patty,F,100,7,0,7
2014,Pavani,F,100,7,0,7
2014,Pebbles,F,100,7,0,7
2014,Pelin,F,100,7,0,7
2014,Pendleton,M,100,0,7,7
2014,Perrion,M,100,0,7,7
2014,Persephony,F,100,7,0,7
2014,Piercen,M,100,0,7,7
2014,Pius,M,100,0,7,7
2014,Poetry,F,100,7,0,7
2014,Pookela,M,100,0,7,7
2014,Prabhleen,F,100,7,0,7
2014,Pragna,F,100,7,0,7
2014,Prajwal,M,100,0,7,7
2014,Pranish,M,100,0,7,7
2014,Pranit,M,100,0,7,7
2014,Pratyush,M,100,0,7,7
2014,Presly,F,100,7,0,7
2014,Prezlee,F,100,7,0,7
2014,Prezley,F,100,7,0,7
2014,Princetyn,M,100,0,7,7
2014,Prish,M,100,0,7,7
2014,Promisse,F,100,7,0,7
2014,Prophet,M,100,0,7,7
2014,Qassam,M,100,0,7,7
2014,Quantavious,M,100,0,7,7
2014,Quavon,M,100,0,7,7
2014,Quetzal,F,100,7,0,7
2014,Quinne,F,100,7,0,7
2014,Quinnleigh,F,100,7,0,7
2014,Raavi,F,100,7,0,7
2014,Rabab,F,100,7,0,7
2014,Racer,M,100,0,7,7
2014,Rad,M,100,0,7,7
2014,Raechel,F,100,7,0,7
2014,Raekwon,M,100,0,7,7
2014,Raela,F,100,7,0,7
2014,Raelea,F,100,7,0,7
2014,Raeshawn,M,100,0,7,7
2014,Raheel,M,100,0,7,7
2014,Raife,M,100,0,7,7
2014,Rainna,F,100,7,0,7
2014,Rajiv,M,100,0,7,7
2014,Rajvi,F,100,7,0,7
2014,Ralynn,F,100,7,0,7
2014,Ramell,M,100,0,7,7
2014,Ramey,F,100,7,0,7
2014,Ramond,M,100,0,7,7
2014,Randa,F,100,7,0,7
2014,Ranen,M,100,0,7,7
2014,Ranezmae,F,100,7,0,7
2014,Ranezmay,F,100,7,0,7
2014,Ranim,F,100,7,0,7
2014,Ranyla,F,100,7,0,7
2014,Rashan,M,100,0,7,7
2014,Rashi,F,100,7,0,7
2014,Rawlins,M,100,0,7,7
2014,Rayane,M,100,0,7,7
2014,Raycen,M,100,0,7,7
2014,Raydyn,M,100,0,7,7
2014,Rayen,F,100,7,0,7
2014,Rayford,M,100,0,7,7
2014,Rayhaan,M,100,0,7,7
2014,Rayhanna,F,100,7,0,7
2014,Raylei,F,100,7,0,7
2014,Rediet,F,100,7,0,7
2014,Rehema,F,100,7,0,7
2014,Reighn,F,100,7,0,7
2014,Rejoice,F,100,7,0,7
2014,Rejoyce,F,100,7,0,7
2014,Relena,F,100,7,0,7
2014,Remini,F,100,7,0,7
2014,Renea,F,100,7,0,7
2014,Renesmay,F,100,7,0,7
2014,Renton,M,100,0,7,7
2014,Reshawn,M,100,0,7,7
2014,Reven,M,100,0,7,7
2014,Revin,M,100,0,7,7
2014,Revyn,M,100,0,7,7
2014,Reynaliz,F,100,7,0,7
2014,Rhealyn,F,100,7,0,7
2014,Rhonan,M,100,0,7,7
2014,Riddhima,F,100,7,0,7
2014,Rigley,M,100,0,7,7
2014,Rimas,F,100,7,0,7
2014,Rishit,M,100,0,7,7
2014,Rithvika,F,100,7,0,7
2014,Rithwik,M,100,0,7,7
2014,Rivaldo,M,100,0,7,7
2014,Riverlynn,F,100,7,0,7
2014,Rizwan,M,100,0,7,7
2014,Robertson,M,100,0,7,7
2014,Rocklynn,F,100,7,0,7
2014,Rogers,M,100,0,7,7
2014,Rollie,M,100,0,7,7
2014,Romana,F,100,7,0,7
2014,Romin,M,100,0,7,7
2014,Ronal,M,100,0,7,7
2014,Rooke,M,100,0,7,7
2014,Rosaisela,F,100,7,0,7
2014,Rosalva,F,100,7,0,7
2014,Rosealynn,F,100,7,0,7
2014,Rosebella,F,100,7,0,7
2014,Roselle,F,100,7,0,7
2014,Roxane,F,100,7,0,7
2014,Royden,M,100,0,7,7
2014,Royston,M,100,0,7,7
2014,Rozelyn,F,100,7,0,7
2014,Rubylynn,F,100,7,0,7
2014,Ruchoma,F,100,7,0,7
2014,Rufino,M,100,0,7,7
2014,Ruoxi,F,100,7,0,7
2014,Rustam,M,100,0,7,7
2014,Ry,M,100,0,7,7
2014,Ryenne,F,100,7,0,7
2014,Ryer,M,100,0,7,7
2014,Ryhanna,F,100,7,0,7
2014,Ryilee,F,100,7,0,7
2014,Ryleeann,F,100,7,0,7
2014,Rylend,M,100,0,7,7
2014,Sa,M,100,0,7,7
2014,Saabir,M,100,0,7,7
2014,Saahas,M,100,0,7,7
2014,Sabah,F,100,7,0,7
2014,Saban,M,100,0,7,7
2014,Sabreena,F,100,7,0,7
2014,Saharra,F,100,7,0,7
2014,Saheim,M,100,0,7,7
2014,Sahel,M,100,0,7,7
2014,Sahmir,M,100,0,7,7
2014,Saidi,F,100,7,0,7
2014,Saifullah,M,100,0,7,7
2014,Saije,F,100,7,0,7
2014,Saikrishna,M,100,0,7,7
2014,Saila,F,100,7,0,7
2014,Sailer,F,100,7,0,7
2014,Saily,F,100,7,0,7
2014,Saindhavi,F,100,7,0,7
2014,Sair,M,100,0,7,7
2014,Sajed,M,100,0,7,7
2014,Saksham,M,100,0,7,7
2014,Salaya,F,100,7,0,7
2014,Salayah,F,100,7,0,7
2014,Salimah,F,100,7,0,7
2014,Saloni,F,100,7,0,7
2014,Salote,F,100,7,0,7
2014,Saman,M,100,0,7,7
2014,Samarie,F,100,7,0,7
2014,Samary,F,100,7,0,7
2014,Samreet,F,100,7,0,7
2014,Samyrah,F,100,7,0,7
2014,Samyukta,F,100,7,0,7
2014,Sanam,F,100,7,0,7
2014,Sanat,M,100,0,7,7
2014,Sanjeev,M,100,0,7,7
2014,Sankalp,M,100,0,7,7
2014,Santhosh,M,100,0,7,7
2014,Santy,M,100,0,7,7
2014,Sarahjane,F,100,7,0,7
2014,Sareen,F,100,7,0,7
2014,Sarvin,M,100,0,7,7
2014,Sarye,F,100,7,0,7
2014,Savage,M,100,0,7,7
2014,Savian,M,100,0,7,7
2014,Say,F,100,7,0,7
2014,Sayvion,M,100,0,7,7
2014,Schneider,M,100,0,7,7
2014,Schneur,M,100,0,7,7
2014,Sebasthian,M,100,0,7,7
2014,Sedric,M,100,0,7,7
2014,Seher,F,100,7,0,7
2014,Semir,M,100,0,7,7
2014,Semiyah,F,100,7,0,7
2014,Seniah,F,100,7,0,7
2014,Seona,F,100,7,0,7
2014,Sephiroth,M,100,0,7,7
2014,Serenah,F,100,7,0,7
2014,Seryna,F,100,7,0,7
2014,Setayesh,F,100,7,0,7
2014,Seton,M,100,0,7,7
2014,Seydi,F,100,7,0,7
2014,Shadi,M,100,0,7,7
2014,Shadia,F,100,7,0,7
2014,Shaheed,M,100,0,7,7
2014,Shahmeer,M,100,0,7,7
2014,Shaka,M,100,0,7,7
2014,Shakai,M,100,0,7,7
2014,Shamia,F,100,7,0,7
2014,Shanlee,F,100,7,0,7
2014,Shannah,F,100,7,0,7
2014,Shantell,F,100,7,0,7
2014,Shanyiah,F,100,7,0,7
2014,Sharvil,M,100,0,7,7
2014,Shasta,F,100,7,0,7
2014,Shayana,F,100,7,0,7
2014,Shayde,F,100,7,0,7
2014,Shayma,F,100,7,0,7
2014,Shazil,M,100,0,7,7
2014,Sheindy,F,100,7,0,7
2014,Shelbey,F,100,7,0,7
2014,Shelsey,F,100,7,0,7
2014,Sherwood,M,100,0,7,7
2014,Shona,F,100,7,0,7
2014,Shoni,F,100,7,0,7
2014,Shterna,F,100,7,0,7
2014,Shuban,M,100,0,7,7
2014,Shulamis,F,100,7,0,7
2014,Shya,F,100,7,0,7
2014,Sidnee,F,100,7,0,7
2014,Silka,F,100,7,0,7
2014,Simaya,F,100,7,0,7
2014,Simrin,F,100,7,0,7
2014,Simya,F,100,7,0,7
2014,Sinclaire,F,100,7,0,7
2014,Sirat,F,100,7,0,7
2014,Siren,F,100,7,0,7
2014,Skii,F,100,7,0,7
2014,Skilah,F,100,7,0,7
2014,Skilyn,F,100,7,0,7
2014,Skyann,F,100,7,0,7
2014,Skyi,F,100,7,0,7
2014,Skylette,F,100,7,0,7
2014,Skyllar,F,100,7,0,7
2014,Skylur,F,100,7,0,7
2014,Sofiagrace,F,100,7,0,7
2014,Sokhna,F,100,7,0,7
2014,Sola,F,100,7,0,7
2014,Soleia,F,100,7,0,7
2014,Solomiya,F,100,7,0,7
2014,Solymar,F,100,7,0,7
2014,Somer,F,100,7,0,7
2014,Sonika,F,100,7,0,7
2014,Sonnie,F,100,7,0,7
2014,Sophialynn,F,100,7,0,7
2014,Sophiee,F,100,7,0,7
2014,Sophronia,F,100,7,0,7
2014,Sorrel,F,100,7,0,7
2014,Soumaya,F,100,7,0,7
2014,Srihari,M,100,0,7,7
2014,Sritha,F,100,7,0,7
2014,Stalin,M,100,0,7,7
2014,Starlett,F,100,7,0,7
2014,Steffon,M,100,0,7,7
2014,Stela,F,100,7,0,7
2014,Stelios,M,100,0,7,7
2014,Stephone,M,100,0,7,7
2014,Storey,F,100,7,0,7
2014,Stran,M,100,0,7,7
2014,Strummer,M,100,0,7,7
2014,Su,F,100,7,0,7
2014,Suad,F,100,7,0,7
2014,Sufian,M,100,0,7,7
2014,Sufyaan,M,100,0,7,7
2014,Sujan,M,100,0,7,7
2014,Sukaina,F,100,7,0,7
2014,Sukhraj,M,100,0,7,7
2014,Summerlynn,F,100,7,0,7
2014,Sun,F,100,7,0,7
2014,Sundai,F,100,7,0,7
2014,Sunee,F,100,7,0,7
2014,Sunset,F,100,7,0,7
2014,Surah,F,100,7,0,7
2014,Suren,M,100,0,7,7
2014,Sureya,F,100,7,0,7
2014,Svara,F,100,7,0,7
2014,Swastik,M,100,0,7,7
2014,Sydelle,F,100,7,0,7
2014,Syla,F,100,7,0,7
2014,Sylver,F,100,7,0,7
2014,Symia,F,100,7,0,7
2014,Symphani,F,100,7,0,7
2014,Synai,F,100,7,0,7
2014,Syndi,F,100,7,0,7
2014,Synia,F,100,7,0,7
2014,Syrianna,F,100,7,0,7
2014,Taaj,M,100,0,7,7
2014,Taara,F,100,7,0,7
2014,Tabius,M,100,0,7,7
2014,Tabytha,F,100,7,0,7
2014,Tacey,F,100,7,0,7
2014,Tae,M,100,0,7,7
2014,Taegen,F,100,7,0,7
2014,Taelon,M,100,0,7,7
2014,Taevin,M,100,0,7,7
2014,Tag,M,100,0,7,7
2014,Taggert,M,100,0,7,7
2014,Taia,F,100,7,0,7
2014,Taima,F,100,7,0,7
2014,Taimane,F,100,7,0,7
2014,Taisei,M,100,0,7,7
2014,Taisha,F,100,7,0,7
2014,Taleb,M,100,0,7,7
2014,Talisha,F,100,7,0,7
2014,Tallia,F,100,7,0,7
2014,Tamani,F,100,7,0,7
2014,Tamarian,M,100,0,7,7
2014,Tamarius,M,100,0,7,7
2014,Tamea,F,100,7,0,7
2014,Tameria,F,100,7,0,7
2014,Tami,F,100,7,0,7
2014,Tannor,M,100,0,7,7
2014,Tanyah,F,100,7,0,7
2014,Tarin,M,100,0,7,7
2014,Tason,M,100,0,7,7
2014,Tateum,M,100,0,7,7
2014,Tava,F,100,7,0,7
2014,Tayem,M,100,0,7,7
2014,Taymar,F,100,7,0,7
2014,Tayquan,M,100,0,7,7
2014,Tayzlee,F,100,7,0,7
2014,Taz,M,100,0,7,7
2014,Taziah,F,100,7,0,7
2014,Teagon,M,100,0,7,7
2014,Tedrick,M,100,0,7,7
2014,Tehillah,F,100,7,0,7
2014,Teighlor,F,100,7,0,7
2014,Telly,M,100,0,7,7
2014,Telvin,M,100,0,7,7
2014,Temur,M,100,0,7,7
2014,Tenia,F,100,7,0,7
2014,Teressa,F,100,7,0,7
2014,Terrelle,M,100,0,7,7
2014,Terris,M,100,0,7,7
2014,Teuila,F,100,7,0,7
2014,Teven,M,100,0,7,7
2014,Tevon,M,100,0,7,7
2014,Teyton,M,100,0,7,7
2014,Tha,M,100,0,7,7
2014,Thamara,F,100,7,0,7
2014,Thaniel,M,100,0,7,7
2014,Thao,F,100,7,0,7
2014,Thijs,M,100,0,7,7
2014,Thurman,M,100,0,7,7
2014,Thyme,F,100,7,0,7
2014,Tiahna,F,100,7,0,7
2014,Tianni,F,100,7,0,7
2014,Tiarah,F,100,7,0,7
2014,Tiasia,F,100,7,0,7
2014,Tiera,F,100,7,0,7
2014,Timiyah,F,100,7,0,7
2014,Timon,M,100,0,7,7
2014,Timya,F,100,7,0,7
2014,Tisa,F,100,7,0,7
2014,Tison,M,100,0,7,7
2014,Tiyonna,F,100,7,0,7
2014,Tlaloc,M,100,0,7,7
2014,Tomer,M,100,0,7,7
2014,Tomi,F,100,7,0,7
2014,Toriah,F,100,7,0,7
2014,Trason,M,100,0,7,7
2014,Travonte,M,100,0,7,7
2014,Traycen,M,100,0,7,7
2014,Treazure,F,100,7,0,7
2014,Trell,M,100,0,7,7
2014,Trelyn,M,100,0,7,7
2014,Tremain,M,100,0,7,7
2014,Tremel,M,100,0,7,7
2014,Trendyn,M,100,0,7,7
2014,Trenise,F,100,7,0,7
2014,Treon,M,100,0,7,7
2014,Trequan,M,100,0,7,7
2014,Treshun,M,100,0,7,7
2014,Treva,F,100,7,0,7
2014,Trevonte,M,100,0,7,7
2014,Treyon,M,100,0,7,7
2014,Triana,F,100,7,0,7
2014,Trillium,F,100,7,0,7
2014,Trinten,M,100,0,7,7
2014,Triumph,M,100,0,7,7
2014,Tryce,M,100,0,7,7
2014,Trynitee,F,100,7,0,7
2014,Trystian,M,100,0,7,7
2014,Tudor,M,100,0,7,7
2014,Tyesha,F,100,7,0,7
2014,Tyjae,F,100,7,0,7
2014,Tymeer,M,100,0,7,7
2014,Tynley,F,100,7,0,7
2014,Tyrann,M,100,0,7,7
2014,Tyrease,M,100,0,7,7
2014,Tyris,M,100,0,7,7
2014,Tyyanna,F,100,7,0,7
2014,Ubaid,M,100,0,7,7
2014,Uchenna,M,100,0,7,7
2014,Ugochi,F,100,7,0,7
2014,Ugochukwu,M,100,0,7,7
2014,Ulyssa,F,100,7,0,7
2014,Umika,F,100,7,0,7
2014,Urias,M,100,0,7,7
2014,Urie,M,100,0,7,7
2014,Vahe,M,100,0,7,7
2014,Vaishnav,M,100,0,7,7
2014,Valerio,M,100,0,7,7
2014,Valeriya,F,100,7,0,7
2014,Vallie,F,100,7,0,7
2014,Valon,M,100,0,7,7
2014,Vaniyah,F,100,7,0,7
2014,Vardaan,M,100,0,7,7
2014,Varian,M,100,0,7,7
2014,Vasiliy,M,100,0,7,7
2014,Vedansh,M,100,0,7,7
2014,Veida,F,100,7,0,7
2014,Verah,F,100,7,0,7
2014,Vergil,M,100,0,7,7
2014,Vianny,F,100,7,0,7
2014,Vienne,F,100,7,0,7
2014,Viet,M,100,0,7,7
2014,Vinaya,F,100,7,0,7
2014,Vinton,M,100,0,7,7
2014,Vivie,F,100,7,0,7
2014,Vonnie,F,100,7,0,7
2014,Vrishank,M,100,0,7,7
2014,Vyla,F,100,7,0,7
2014,Vyncent,M,100,0,7,7
2014,Wakely,F,100,7,0,7
2014,Waylynn,F,100,7,0,7
2014,Weber,M,100,0,7,7
2014,Wendolyn,F,100,7,0,7
2014,Weylyn,M,100,0,7,7
2014,Wilkin,M,100,0,7,7
2014,Wilmary,F,100,7,0,7
2014,Wrenna,F,100,7,0,7
2014,Xara,F,100,7,0,7
2014,Xareni,F,100,7,0,7
2014,Xariyah,F,100,7,0,7
2014,Xaylen,M,100,0,7,7
2014,Xiadani,F,100,7,0,7
2014,Xinyue,F,100,7,0,7
2014,Xiomar,M,100,0,7,7
2014,Xochil,F,100,7,0,7
2014,Xxavier,M,100,0,7,7
2014,Xya,F,100,7,0,7
2014,Xyaire,M,100,0,7,7
2014,Xylan,M,100,0,7,7
2014,Xylon,M,100,0,7,7
2014,Xyon,M,100,0,7,7
2014,Yaa,F,100,7,0,7
2014,Yadrian,M,100,0,7,7
2014,Yailynn,F,100,7,0,7
2014,Yaksh,M,100,0,7,7
2014,Yakub,M,100,0,7,7
2014,Yalena,F,100,7,0,7
2014,Yalini,F,100,7,0,7
2014,Yamato,M,100,0,7,7
2014,Yanetzi,F,100,7,0,7
2014,Yanilen,F,100,7,0,7
2014,Yareny,F,100,7,0,7
2014,Yarethzi,F,100,7,0,7
2014,Yaretsi,F,100,7,0,7
2014,Yarexi,F,100,7,0,7
2014,Yashua,M,100,0,7,7
2014,Yasna,F,100,7,0,7
2014,Yazhini,F,100,7,0,7
2014,Yedidya,M,100,0,7,7
2014,Yegor,M,100,0,7,7
2014,Yehonatan,M,100,0,7,7
2014,Yehudit,F,100,7,0,7
2014,Yeico,M,100,0,7,7
2014,Yelina,F,100,7,0,7
2014,Yeniel,M,100,0,7,7
2014,Yenty,F,100,7,0,7
2014,Yeudiel,M,100,0,7,7
2014,Yicheng,M,100,0,7,7
2014,Yohaan,M,100,0,7,7
2014,Yohanan,M,100,0,7,7
2014,Yomna,F,100,7,0,7
2014,Yoniel,M,100,0,7,7
2014,York,M,100,0,7,7
2014,Yoshi,M,100,0,7,7
2014,Yosmar,M,100,0,7,7
2014,Yovanny,M,100,0,7,7
2014,Yuleisy,F,100,7,0,7
2014,Zadaya,F,100,7,0,7
2014,Zadin,M,100,0,7,7
2014,Zady,F,100,7,0,7
2014,Zaela,F,100,7,0,7
2014,Zahi,M,100,0,7,7
2014,Zahyra,F,100,7,0,7
2014,Zaiven,M,100,0,7,7
2014,Zaiyon,M,100,0,7,7
2014,Zakee,M,100,0,7,7
2014,Zalyn,M,100,0,7,7
2014,Zamantha,F,100,7,0,7
2014,Zamarah,F,100,7,0,7
2014,Zamire,M,100,0,7,7
2014,Zamoria,F,100,7,0,7
2014,Zamuel,M,100,0,7,7
2014,Zanae,F,100,7,0,7
2014,Zanaiya,F,100,7,0,7
2014,Zanaria,F,100,7,0,7
2014,Zaniylah,F,100,7,0,7
2014,Zariaha,F,100,7,0,7
2014,Zarius,M,100,0,7,7
2014,Zarrah,F,100,7,0,7
2014,Zathan,M,100,0,7,7
2014,Zaveon,M,100,0,7,7
2014,Zavia,F,100,7,0,7
2014,Zavon,M,100,0,7,7
2014,Zaydenn,M,100,0,7,7
2014,Zayliah,F,100,7,0,7
2014,Zea,F,100,7,0,7
2014,Zehava,F,100,7,0,7
2014,Zelaya,F,100,7,0,7
2014,Zenab,F,100,7,0,7
2014,Zenya,F,100,7,0,7
2014,Zeplin,M,100,0,7,7
2014,Zeric,M,100,0,7,7
2014,Zethan,M,100,0,7,7
2014,Zevi,M,100,0,7,7
2014,Zevulun,M,100,0,7,7
2014,Zhaniya,F,100,7,0,7
2014,Zhyaire,M,100,0,7,7
2014,Zhyon,M,100,0,7,7
2014,Zi,M,100,0,7,7
2014,Zihan,F,100,7,0,7
2014,Zinab,F,100,7,0,7
2014,Zinedine,M,100,0,7,7
2014,Ziv,M,100,0,7,7
2014,Zlaty,F,100,7,0,7
2014,Zohan,M,100,0,7,7
2014,Zohara,F,100,7,0,7
2014,Zorie,F,100,7,0,7
2014,Zuha,F,100,7,0,7
2014,Zula,F,100,7,0,7
2014,Zyden,M,100,0,7,7
2014,Zyen,M,100,0,7,7
2014,Zyiah,F,100,7,0,7
2014,Zyian,F,100,7,0,7
2014,Zylar,M,100,0,7,7
2014,Zyleigh,F,100,7,0,7
2014,Zylon,M,100,0,7,7
2014,Zymier,M,100,0,7,7
2014,Zynia,F,100,7,0,7
2014,Zyonnah,F,100,7,0,7
2014,Zyrell,M,100,0,7,7
2014,Zytaveon,M,100,0,7,7
2014,Aakarsh,M,100,0,6,6
2014,Aalaiyah,F,100,6,0,6
2014,Aalana,F,100,6,0,6
2014,Aalanah,F,100,6,0,6
2014,Aaleiyah,F,100,6,0,6
2014,Aaleya,F,100,6,0,6
2014,Aaliayah,F,100,6,0,6
2014,Aalina,F,100,6,0,6
2014,Aaliyahmarie,F,100,6,0,6
2014,Aamil,M,100,0,6,6
2014,Aamori,F,100,6,0,6
2014,Aaradhana,F,100,6,0,6
2014,Aaraiz,M,100,0,6,6
2014,Aarionna,F,100,6,0,6
2014,Aaro,M,100,0,6,6
2014,Aaryana,F,100,6,0,6
2014,Aashay,M,100,0,6,6
2014,Aavyn,M,100,0,6,6
2014,Abaigeal,F,100,6,0,6
2014,Aban,M,100,0,6,6
2014,Abbe,F,100,6,0,6
2014,Abbylynn,F,100,6,0,6
2014,Abdelaziz,M,100,0,6,6
2014,Abdikarim,M,100,0,6,6
2014,Abdou,M,100,0,6,6
2014,Abduallah,M,100,0,6,6
2014,Abdulloh,M,100,0,6,6
2014,Abdulrhman,M,100,0,6,6
2014,Abdulwahab,M,100,0,6,6
2014,Abia,F,100,6,0,6
2014,Abie,M,100,0,6,6
2014,Abigailgrace,F,100,6,0,6
2014,Abigaille,F,100,6,0,6
2014,Abigailmarie,F,100,6,0,6
2014,Abigailrose,F,100,6,0,6
2014,Abigayl,F,100,6,0,6
2014,Abigel,F,100,6,0,6
2014,Abigial,F,100,6,0,6
2014,Abilynn,F,100,6,0,6
2014,Abisola,F,100,6,0,6
2014,Abrahem,M,100,0,6,6
2014,Abryana,F,100,6,0,6
2014,Abryella,F,100,6,0,6
2014,Absalom,M,100,0,6,6
2014,Abshir,M,100,0,6,6
2014,Abuk,F,100,6,0,6
2014,Abukar,M,100,0,6,6
2014,Acamas,M,100,0,6,6
2014,Acesyn,M,100,0,6,6
2014,Achyuth,M,100,0,6,6
2014,Acxel,M,100,0,6,6
2014,Adaia,F,100,6,0,6
2014,Adaire,F,100,6,0,6
2014,Adaleya,F,100,6,0,6
2014,Adamariz,F,100,6,0,6
2014,Adaugo,F,100,6,0,6
2014,Addaley,F,100,6,0,6
2014,Addelina,F,100,6,0,6
2014,Addiley,F,100,6,0,6
2014,Addysyn,F,100,6,0,6
2014,Adeel,M,100,0,6,6
2014,Adelinah,F,100,6,0,6
2014,Ademar,M,100,0,6,6
2014,Ademola,M,100,0,6,6
2014,Adeoluwa,M,100,0,6,6
2014,Adhiraj,M,100,0,6,6
2014,Adiah,F,100,6,0,6
2014,Adileigh,F,100,6,0,6
2014,Adileni,F,100,6,0,6
2014,Adileny,F,100,6,0,6
2014,Adiyan,M,100,0,6,6
2014,Adjoa,F,100,6,0,6
2014,Adly,F,100,6,0,6
2014,Adolphus,M,100,0,6,6
2014,Adraya,F,100,6,0,6
2014,Adream,F,100,6,0,6
2014,Adreena,F,100,6,0,6
2014,Adrieanna,F,100,6,0,6
2014,Adrienna,F,100,6,0,6
2014,Adrija,F,100,6,0,6
2014,Adrith,M,100,0,6,6
2014,Adriyan,M,100,0,6,6
2014,Adriyel,M,100,0,6,6
2014,Advita,F,100,6,0,6
2014,Adyleigh,F,100,6,0,6
2014,Adysson,F,100,6,0,6
2014,Aemilia,F,100,6,0,6
2014,Aemon,M,100,0,6,6
2014,Aeriel,F,100,6,0,6
2014,Aeriella,F,100,6,0,6
2014,Aeyla,F,100,6,0,6
2014,Afaf,F,100,6,0,6
2014,Afra,F,100,6,0,6
2014,Afsa,F,100,6,0,6
2014,Afsana,F,100,6,0,6
2014,Afua,F,100,6,0,6
2014,Agasthya,M,100,0,6,6
2014,Agnieszka,F,100,6,0,6
2014,Agustine,M,100,0,6,6
2014,Ahleah,F,100,6,0,6
2014,Ahleena,F,100,6,0,6
2014,Ahlena,F,100,6,0,6
2014,Ahlia,F,100,6,0,6
2014,Ahlivia,F,100,6,0,6
2014,Ahmarion,M,100,0,6,6
2014,Ahmiah,F,100,6,0,6
2014,Ahmier,M,100,0,6,6
2014,Ahmiracle,F,100,6,0,6
2014,Ahnalee,F,100,6,0,6
2014,Ahnalise,F,100,6,0,6
2014,Ahnesty,F,100,6,0,6
2014,Ahnya,F,100,6,0,6
2014,Ahnyah,F,100,6,0,6
2014,Ahnylah,F,100,6,0,6
2014,Ahriah,F,100,6,0,6
2014,Aidrick,M,100,0,6,6
2014,Aiiden,M,100,0,6,6
2014,Aijah,F,100,6,0,6
2014,Aileah,F,100,6,0,6
2014,Aimie,F,100,6,0,6
2014,Airabelle,F,100,6,0,6
2014,Airyonna,F,100,6,0,6
2014,Aisa,F,100,6,0,6
2014,Aiyan,M,100,0,6,6
2014,Ajavion,M,100,0,6,6
2014,Ajmal,M,100,0,6,6
2014,Akanksha,F,100,6,0,6
2014,Akansha,F,100,6,0,6
2014,Akenzie,F,100,6,0,6
2014,Akili,F,100,6,0,6
2014,Akiya,F,100,6,0,6
2014,Akshitha,F,100,6,0,6
2014,Akyla,F,100,6,0,6
2014,Alai,M,100,0,6,6
2014,Alaiza,F,100,6,0,6
2014,Alam,M,100,0,6,6
2014,Alamea,F,100,6,0,6
2014,Alanee,F,100,6,0,6
2014,Alannie,F,100,6,0,6
2014,Alannys,F,100,6,0,6
2014,Alaunna,F,100,6,0,6
2014,Alaycia,F,100,6,0,6
2014,Alayjha,F,100,6,0,6
2014,Alaynnah,F,100,6,0,6
2014,Alayssa,F,100,6,0,6
2014,Alayzha,F,100,6,0,6
2014,Alazay,F,100,6,0,6
2014,Alaziah,F,100,6,0,6
2014,Albeiro,M,100,0,6,6
2014,Alberth,M,100,0,6,6
2014,Aldina,F,100,6,0,6
2014,Aldrick,M,100,0,6,6
2014,Aleasha,F,100,6,0,6
2014,Aleayah,F,100,6,0,6
2014,Aleda,F,100,6,0,6
2014,Alejandrina,F,100,6,0,6
2014,Aleksy,M,100,0,6,6
2014,Alekxander,M,100,0,6,6
2014,Aleni,F,100,6,0,6
2014,Alexanderia,F,100,6,0,6
2014,Alexandrya,F,100,6,0,6
2014,Alexiss,F,100,6,0,6
2014,Alexyss,F,100,6,0,6
2014,Aleynna,F,100,6,0,6
2014,Aleza,F,100,6,0,6
2014,Alezandra,F,100,6,0,6
2014,Alezandro,M,100,0,6,6
2014,Alianis,F,100,6,0,6
2014,Aliera,F,100,6,0,6
2014,Alii,M,100,0,6,6
2014,Alija,M,100,0,6,6
2014,Alilah,F,100,6,0,6
2014,Alimah,F,100,6,0,6
2014,Alionna,F,100,6,0,6
2014,Alisabeth,F,100,6,0,6
2014,Alisynn,F,100,6,0,6
2014,Alivianna,F,100,6,0,6
2014,Aliyannah,F,100,6,0,6
2014,Aliyha,F,100,6,0,6
2014,Aljawhara,F,100,6,0,6
2014,Alleena,F,100,6,0,6
2014,Allene,F,100,6,0,6
2014,Alliemae,F,100,6,0,6
2014,Allistair,M,100,0,6,6
2014,Allyah,F,100,6,0,6
2014,Allye,F,100,6,0,6
2014,Alperen,M,100,0,6,6
2014,Alrick,M,100,0,6,6
2014,Alyasia,F,100,6,0,6
2014,Alynah,F,100,6,0,6
2014,Alyonna,F,100,6,0,6
2014,Alyshia,F,100,6,0,6
2014,Alysiana,F,100,6,0,6
2014,Alyssabeth,F,100,6,0,6
2014,Alyster,M,100,0,6,6
2014,Alythia,F,100,6,0,6
2014,Amaad,M,100,0,6,6
2014,Amala,F,100,6,0,6
2014,Amaliah,F,100,6,0,6
2014,Amanii,F,100,6,0,6
2014,Amariee,F,100,6,0,6
2014,Amarisa,F,100,6,0,6
2014,Amarrion,M,100,0,6,6
2014,Amartya,M,100,0,6,6
2014,Amarya,F,100,6,0,6
2014,Amayra,F,100,6,0,6
2014,Amazin,F,100,6,0,6
2014,Amear,M,100,0,6,6
2014,Amedeo,M,100,0,6,6
2014,Ameina,F,100,6,0,6
2014,Amida,F,100,6,0,6
2014,Amileah,F,100,6,0,6
2014,Amillio,M,100,0,6,6
2014,Amiyra,F,100,6,0,6
2014,Amoz,M,100,0,6,6
2014,Amparo,F,100,6,0,6
2014,Amryn,F,100,6,0,6
2014,Anahit,F,100,6,0,6
2014,Anaily,F,100,6,0,6
2014,Anaiza,F,100,6,0,6
2014,Analeiah,F,100,6,0,6
2014,Analeise,F,100,6,0,6
2014,Analilia,F,100,6,0,6
2014,Analisia,F,100,6,0,6
2014,Analyah,F,100,6,0,6
2014,Analys,F,100,6,0,6
2014,Ananshi,F,100,6,0,6
2014,Ananth,M,100,0,6,6
2014,Anapaola,F,100,6,0,6
2014,Anariah,F,100,6,0,6
2014,Anastassia,F,100,6,0,6
2014,Anatolia,F,100,6,0,6
2014,Anaysha,F,100,6,0,6
2014,Anaysia,F,100,6,0,6
2014,Ancel,M,100,0,6,6
2014,Andersson,M,100,0,6,6
2014,Andony,M,100,0,6,6
2014,Andray,M,100,0,6,6
2014,Andreanna,F,100,6,0,6
2014,Andreea,F,100,6,0,6
2014,Andreia,F,100,6,0,6
2014,Andreyah,F,100,6,0,6
2014,Andri,M,100,0,6,6
2014,Andrijana,F,100,6,0,6
2014,Aneeka,F,100,6,0,6
2014,Anees,M,100,0,6,6
2014,Aneisha,F,100,6,0,6
2014,Anelly,F,100,6,0,6
2014,Anelys,F,100,6,0,6
2014,Anfisa,F,100,6,0,6
2014,Angeldejesus,M,100,0,6,6
2014,Anguel,M,100,0,6,6
2014,Anhar,F,100,6,0,6
2014,Anija,F,100,6,0,6
2014,Aniko,F,100,6,0,6
2014,Aniruddh,M,100,0,6,6
2014,Anisia,F,100,6,0,6
2014,Anisjon,M,100,0,6,6
2014,Aniyha,F,100,6,0,6
2014,Anmarie,F,100,6,0,6
2014,Annabele,F,100,6,0,6
2014,Annaelle,F,100,6,0,6
2014,Annajo,F,100,6,0,6
2014,Annalyce,F,100,6,0,6
2014,Annam,F,100,6,0,6
2014,Annapaula,F,100,6,0,6
2014,Annastin,F,100,6,0,6
2014,Annelies,F,100,6,0,6
2014,Anneliesa,F,100,6,0,6
2014,Annely,F,100,6,0,6
2014,Annetta,F,100,6,0,6
2014,Annick,F,100,6,0,6
2014,Annison,F,100,6,0,6
2014,Annlee,F,100,6,0,6
2014,Annleigh,F,100,6,0,6
2014,Anokhi,F,100,6,0,6
2014,Anola,F,100,6,0,6
2014,Anoop,M,100,0,6,6
2014,Antario,M,100,0,6,6
2014,Anthonny,M,100,0,6,6
2014,Antonie,M,100,0,6,6
2014,Antonious,M,100,0,6,6
2014,Antwann,M,100,0,6,6
2014,Anup,M,100,0,6,6
2014,Anwen,F,100,6,0,6
2014,Anyieth,F,100,6,0,6
2014,Anysia,F,100,6,0,6
2014,Aparna,F,100,6,0,6
2014,Apolonia,F,100,6,0,6
2014,Aquil,M,100,0,6,6
2014,Arabellah,F,100,6,0,6
2014,Aracelys,F,100,6,0,6
2014,Arael,M,100,0,6,6
2014,Araiyah,F,100,6,0,6
2014,Arali,F,100,6,0,6
2014,Aranya,F,100,6,0,6
2014,Arayiah,F,100,6,0,6
2014,Arayla,F,100,6,0,6
2014,Arben,M,100,0,6,6
2014,Arbrielle,F,100,6,0,6
2014,Arch,M,100,0,6,6
2014,Archana,F,100,6,0,6
2014,Ardian,M,100,0,6,6
2014,Areah,F,100,6,0,6
2014,Aretzi,F,100,6,0,6
2014,Arhaam,M,100,0,6,6
2014,Ariadny,F,100,6,0,6
2014,Ariahana,F,100,6,0,6
2014,Ariahnna,F,100,6,0,6
2014,Ariarose,F,100,6,0,6
2014,Ariday,F,100,6,0,6
2014,Arienna,F,100,6,0,6
2014,Arihan,M,100,0,6,6
2014,Arinna,F,100,6,0,6
2014,Arisbel,F,100,6,0,6
2014,Aritzel,F,100,6,0,6
2014,Ariyeh,M,100,0,6,6
2014,Ariz,M,100,0,6,6
2014,Arla,F,100,6,0,6
2014,Arlandria,F,100,6,0,6
2014,Arleny,F,100,6,0,6
2014,Arlon,M,100,0,6,6
2014,Arlow,M,100,0,6,6
2014,Armiya,F,100,6,0,6
2014,Armony,F,100,6,0,6
2014,Arnab,M,100,0,6,6
2014,Aro,M,100,0,6,6
2014,Arona,M,100,0,6,6
2014,Arpi,F,100,6,0,6
2014,Arpita,F,100,6,0,6
2014,Arryana,F,100,6,0,6
2014,Arryn,F,100,6,0,6
2014,Arshaan,M,100,0,6,6
2014,Arshaun,M,100,0,6,6
2014,Artorius,M,100,0,6,6
2014,Arvid,M,100,0,6,6
2014,Aryani,F,100,6,0,6
2014,Aryaveer,M,100,0,6,6
2014,Arye,M,100,0,6,6
2014,Asadbek,M,100,0,6,6
2014,Asanti,F,100,6,0,6
2014,Asenat,F,100,6,0,6
2014,Ashaan,M,100,0,6,6
2014,Ashai,M,100,0,6,6
2014,Ashay,M,100,0,6,6
2014,Ashika,F,100,6,0,6
2014,Ashlei,F,100,6,0,6
2014,Ashot,M,100,0,6,6
2014,Ashrita,F,100,6,0,6
2014,Ashtian,M,100,0,6,6
2014,Ashvika,F,100,6,0,6
2014,Ashvin,M,100,0,6,6
2014,Ashyla,F,100,6,0,6
2014,Asier,M,100,0,6,6
2014,Aspin,F,100,6,0,6
2014,Assad,M,100,0,6,6
2014,Asteria,F,100,6,0,6
2014,Atalya,F,100,6,0,6
2014,Atia,F,100,6,0,6
2014,Atiana,F,100,6,0,6
2014,Atiksh,M,100,0,6,6
2014,Atina,F,100,6,0,6
2014,Atlai,M,100,0,6,6
2014,Attalie,F,100,6,0,6
2014,Aubriauna,F,100,6,0,6
2014,Aubriela,F,100,6,0,6
2014,Audrei,F,100,6,0,6
2014,Audriel,F,100,6,0,6
2014,Audrionna,F,100,6,0,6
2014,Aunisty,F,100,6,0,6
2014,Aurion,M,100,0,6,6
2014,Auviana,F,100,6,0,6
2014,Avaia,F,100,6,0,6
2014,Avajane,F,100,6,0,6
2014,Avaleena,F,100,6,0,6
2014,Avalise,F,100,6,0,6
2014,Avalyse,F,100,6,0,6
2014,Avanicole,F,100,6,0,6
2014,Avanish,M,100,0,6,6
2014,Avash,M,100,0,6,6
2014,Avayla,F,100,6,0,6
2014,Aveen,F,100,6,0,6
2014,Avelia,F,100,6,0,6
2014,Avenleigh,F,100,6,0,6
2014,Avera,F,100,6,0,6
2014,Averett,M,100,0,6,6
2014,Averil,F,100,6,0,6
2014,Averylynn,F,100,6,0,6
2014,Aviance,F,100,6,0,6
2014,Avid,M,100,0,6,6
2014,Avilynn,F,100,6,0,6
2014,Avira,F,100,6,0,6
2014,Avlyn,F,100,6,0,6
2014,Avonte,M,100,0,6,6
2014,Avrielle,F,100,6,0,6
2014,Avrumy,M,100,0,6,6
2014,Axal,M,100,0,6,6
2014,Aydren,M,100,0,6,6
2014,Ayia,F,100,6,0,6
2014,Ayliana,F,100,6,0,6
2014,Aymar,F,100,6,0,6
2014,Ayodele,M,100,0,6,6
2014,Ayona,F,100,6,0,6
2014,Ayotunde,M,100,0,6,6
2014,Ayris,F,100,6,0,6
2014,Aysiah,F,100,6,0,6
2014,Ayvan,M,100,0,6,6
2014,Ayveon,M,100,0,6,6
2014,Azaila,F,100,6,0,6
2014,Azaleia,F,100,6,0,6
2014,Azaleya,F,100,6,0,6
2014,Azalie,F,100,6,0,6
2014,Azam,M,100,0,6,6
2014,Azar,M,100,0,6,6
2014,Azden,M,100,0,6,6
2014,Azelie,F,100,6,0,6
2014,Azera,F,100,6,0,6
2014,Azharia,F,100,6,0,6
2014,Azi,M,100,0,6,6
2014,Azilee,F,100,6,0,6
2014,Azimjon,M,100,0,6,6
2014,Azusena,F,100,6,0,6
2014,Azyra,F,100,6,0,6
2014,Azyriah,F,100,6,0,6
2014,Baelee,F,100,6,0,6
2014,Bailasan,F,100,6,0,6
2014,Bailea,F,100,6,0,6
2014,Baili,F,100,6,0,6
2014,Bakary,M,100,0,6,6
2014,Baler,M,100,0,6,6
2014,Baleria,F,100,6,0,6
2014,Banesa,F,100,6,0,6
2014,Bardia,M,100,0,6,6
2014,Barkot,F,100,6,0,6
2014,Basem,M,100,0,6,6
2014,Becka,F,100,6,0,6
2014,Behnam,M,100,0,6,6
2014,Behruz,M,100,0,6,6
2014,Belkis,F,100,6,0,6
2014,Belma,F,100,6,0,6
2014,Benedicta,F,100,6,0,6
2014,Benedikt,M,100,0,6,6
2014,Benjermin,M,100,0,6,6
2014,Bentyn,M,100,0,6,6
2014,Benz,M,100,0,6,6
2014,Berkli,F,100,6,0,6
2014,Bernie,M,100,0,6,6
2014,Berta,F,100,6,0,6
2014,Bertrand,M,100,0,6,6
2014,Bethani,F,100,6,0,6
2014,Bethann,F,100,6,0,6
2014,Bevis,M,100,0,6,6
2014,Bexton,M,100,0,6,6
2014,Bezalel,M,100,0,6,6
2014,Bhargav,M,100,0,6,6
2014,Bianna,F,100,6,0,6
2014,Bianney,F,100,6,0,6
2014,Bilaal,M,100,0,6,6
2014,Billi,F,100,6,0,6
2014,Binti,F,100,6,0,6
2014,Birkley,F,100,6,0,6
2014,Bitania,F,100,6,0,6
2014,Bitanya,F,100,6,0,6
2014,Bj,M,100,0,6,6
2014,Bladyn,M,100,0,6,6
2014,Blaiz,M,100,0,6,6
2014,Blanche,F,100,6,0,6
2014,Blaydin,M,100,0,6,6
2014,Blithe,F,100,6,0,6
2014,Bob,M,100,0,6,6
2014,Bocephus,M,100,0,6,6
2014,Boedy,M,100,0,6,6
2014,Boen,M,100,0,6,6
2014,Bonny,F,100,6,0,6
2014,Bowdy,M,100,0,6,6
2014,Bradie,F,100,6,0,6
2014,Braedin,M,100,0,6,6
2014,Braela,F,100,6,0,6
2014,Braelie,F,100,6,0,6
2014,Braian,M,100,0,6,6
2014,Brandom,M,100,0,6,6
2014,Brannen,M,100,0,6,6
2014,Brantlie,F,100,6,0,6
2014,Braun,M,100,0,6,6
2014,Bravo,M,100,0,6,6
2014,Braxtan,M,100,0,6,6
2014,Breaja,F,100,6,0,6
2014,Breaker,M,100,0,6,6
2014,Breannah,F,100,6,0,6
2014,Breeah,F,100,6,0,6
2014,Breina,F,100,6,0,6
2014,Breklyn,F,100,6,0,6
2014,Brelee,F,100,6,0,6
2014,Bren,M,100,0,6,6
2014,Brendy,F,100,6,0,6
2014,Brenin,M,100,0,6,6
2014,Breniya,F,100,6,0,6
2014,Brenlie,F,100,6,0,6
2014,Brenly,F,100,6,0,6
2014,Breno,M,100,0,6,6
2014,Brentin,M,100,0,6,6
2014,Brentson,M,100,0,6,6
2014,Brette,F,100,6,0,6
2014,Brevan,M,100,0,6,6
2014,Breyelle,F,100,6,0,6
2014,Briamarie,F,100,6,0,6
2014,Briceson,M,100,0,6,6
2014,Bricyn,M,100,0,6,6
2014,Briden,M,100,0,6,6
2014,Briea,F,100,6,0,6
2014,Brien,M,100,0,6,6
2014,Brilliant,M,100,0,6,6
2014,Brinli,F,100,6,0,6
2014,Brit,F,100,6,0,6
2014,Britnee,F,100,6,0,6
2014,Brixtyn,F,100,6,0,6
2014,Brizeyda,F,100,6,0,6
2014,Brodix,M,100,0,6,6
2014,Bron,M,100,0,6,6
2014,Bronc,M,100,0,6,6
2014,Bronte,F,100,6,0,6
2014,Bronwen,F,100,6,0,6
2014,Brooklinn,F,100,6,0,6
2014,Brookston,M,100,0,6,6
2014,Brox,M,100,0,6,6
2014,Brycelyn,F,100,6,0,6
2014,Brylinn,F,100,6,0,6
2014,Bryndal,F,100,6,0,6
2014,Brysyn,M,100,0,6,6
2014,Bryxton,M,100,0,6,6
2014,Bulut,M,100,0,6,6
2014,Burley,M,100,0,6,6
2014,Cace,M,100,0,6,6
2014,Cacey,F,100,6,0,6
2014,Cadell,M,100,0,6,6
2014,Caedence,F,100,6,0,6
2014,Caeleigh,F,100,6,0,6
2014,Caelix,M,100,0,6,6
2014,Cahlia,F,100,6,0,6
2014,Caiah,F,100,6,0,6
2014,Cailean,M,100,0,6,6
2014,Caitrin,F,100,6,0,6
2014,Caiyden,M,100,0,6,6
2014,Calais,F,100,6,0,6
2014,Calayah,F,100,6,0,6
2014,Calea,F,100,6,0,6
2014,Calel,M,100,0,6,6
2014,Calib,M,100,0,6,6
2014,Calixta,F,100,6,0,6
2014,Callieann,F,100,6,0,6
2014,Calliegh,F,100,6,0,6
2014,Calob,M,100,0,6,6
2014,Cambell,F,100,6,0,6
2014,Camella,F,100,6,0,6
2014,Camran,M,100,0,6,6
2014,Camyah,F,100,6,0,6
2014,Camylle,F,100,6,0,6
2014,Candence,F,100,6,0,6
2014,Caoilinn,F,100,6,0,6
2014,Caragan,F,100,6,0,6
2014,Caralena,F,100,6,0,6
2014,Carena,F,100,6,0,6
2014,Cariah,F,100,6,0,6
2014,Carinna,F,100,6,0,6
2014,Carisa,F,100,6,0,6
2014,Carisma,F,100,6,0,6
2014,Carlea,F,100,6,0,6
2014,Carliana,F,100,6,0,6
2014,Carliee,F,100,6,0,6
2014,Carlosdaniel,M,100,0,6,6
2014,Carmichael,M,100,0,6,6
2014,Carmin,F,100,6,0,6
2014,Carmon,F,100,6,0,6
2014,Carolyna,F,100,6,0,6
2014,Carolynne,F,100,6,0,6
2014,Carra,F,100,6,0,6
2014,Carrieanne,F,100,6,0,6
2014,Carrisa,F,100,6,0,6
2014,Carroll,M,100,0,6,6
2014,Carrson,M,100,0,6,6
2014,Caryn,F,100,6,0,6
2014,Cas,M,100,0,6,6
2014,Caseton,M,100,0,6,6
2014,Cashawn,M,100,0,6,6
2014,Cashe,M,100,0,6,6
2014,Cashious,M,100,0,6,6
2014,Cashous,M,100,0,6,6
2014,Casi,F,100,6,0,6
2014,Cassadie,F,100,6,0,6
2014,Cassey,F,100,6,0,6
2014,Cassin,M,100,0,6,6
2014,Catalya,F,100,6,0,6
2014,Caydyn,M,100,0,6,6
2014,Cayn,M,100,0,6,6
2014,Cayse,M,100,0,6,6
2014,Caysin,M,100,0,6,6
2014,Ceazar,M,100,0,6,6
2014,Cecilie,F,100,6,0,6
2014,Cecilya,F,100,6,0,6
2014,Cerise,F,100,6,0,6
2014,Cesario,M,100,0,6,6
2014,Cesiah,F,100,6,0,6
2014,Chadd,M,100,0,6,6
2014,Chaelynn,F,100,6,0,6
2014,Chaison,M,100,0,6,6
2014,Chaitanya,M,100,0,6,6
2014,Chananya,M,100,0,6,6
2014,Chandra,F,100,6,0,6
2014,Charan,M,100,0,6,6
2014,Charleeann,F,100,6,0,6
2014,Charleson,M,100,0,6,6
2014,Charlet,F,100,6,0,6
2014,Charlianne,F,100,6,0,6
2014,Charline,F,100,6,0,6
2014,Charlyse,F,100,6,0,6
2014,Charna,F,100,6,0,6
2014,Chas,M,100,0,6,6
2014,Chasten,M,100,0,6,6
2014,Chavelle,F,100,6,0,6
2014,Chavi,F,100,6,0,6
2014,Chaviva,F,100,6,0,6
2014,Chayne,M,100,0,6,6
2014,Chayten,M,100,0,6,6
2014,Chazlyn,F,100,6,0,6
2014,Cheney,M,100,0,6,6
2014,Cheng,M,100,0,6,6
2014,Cherlyn,F,100,6,0,6
2014,Cheyenna,F,100,6,0,6
2014,Chigozirim,M,100,0,6,6
2014,Chinedu,M,100,0,6,6
2014,Chinedum,M,100,0,6,6
2014,Chinmay,M,100,0,6,6
2014,Chinonso,M,100,0,6,6
2014,Chizitelu,F,100,6,0,6
2014,Chloemarie,F,100,6,0,6
2014,Chord,M,100,0,6,6
2014,Chrisangel,M,100,0,6,6
2014,Chrissi,F,100,6,0,6
2014,Chrissie,F,100,6,0,6
2014,Christena,F,100,6,0,6
2014,Christia,F,100,6,0,6
2014,Christoff,M,100,0,6,6
2014,Chyan,F,100,6,0,6
2014,Cicero,M,100,0,6,6
2014,Cieran,M,100,0,6,6
2014,Cintia,F,100,6,0,6
2014,Cirilo,M,100,0,6,6
2014,Claribelle,F,100,6,0,6
2014,Clemence,F,100,6,0,6
2014,Clete,M,100,0,6,6
2014,Clutch,M,100,0,6,6
2014,Coalton,M,100,0,6,6
2014,Cobey,M,100,0,6,6
2014,Cobin,M,100,0,6,6
2014,Coe,M,100,0,6,6
2014,Colbey,M,100,0,6,6
2014,Colbin,M,100,0,6,6
2014,Collen,M,100,0,6,6
2014,Comfort,F,100,6,0,6
2014,Connall,M,100,0,6,6
2014,Conroy,M,100,0,6,6
2014,Constantinos,M,100,0,6,6
2014,Copelyn,F,100,6,0,6
2014,Coralin,F,100,6,0,6
2014,Coralline,F,100,6,0,6
2014,Cordai,M,100,0,6,6
2014,Cordaro,M,100,0,6,6
2014,Corday,M,100,0,6,6
2014,Coree,F,100,6,0,6
2014,Corran,M,100,0,6,6
2014,Correy,M,100,0,6,6
2014,Corrinne,F,100,6,0,6
2014,Corson,M,100,0,6,6
2014,Corvyn,M,100,0,6,6
2014,Costa,M,100,0,6,6
2014,Cottrell,M,100,0,6,6
2014,Crimsyn,F,100,6,0,6
2014,Crislynn,F,100,6,0,6
2014,Cristabel,F,100,6,0,6
2014,Cristabella,F,100,6,0,6
2014,Cristin,F,100,6,0,6
2014,Cristyn,F,100,6,0,6
2014,Croy,M,100,0,6,6
2014,Cruize,M,100,0,6,6
2014,Crystalynn,F,100,6,0,6
2014,Crystian,M,100,0,6,6
2014,Cyana,F,100,6,0,6
2014,Cyann,F,100,6,0,6
2014,Cymone,F,100,6,0,6
2014,Cynia,F,100,6,0,6
2014,Cyniyah,F,100,6,0,6
2014,Cyprus,M,100,0,6,6
2014,Cyree,M,100,0,6,6
2014,Daaron,M,100,0,6,6
2014,Dabria,F,100,6,0,6
2014,Daejah,F,100,6,0,6
2014,Daelen,M,100,0,6,6
2014,Daelon,M,100,0,6,6
2014,Daemion,M,100,0,6,6
2014,Daena,F,100,6,0,6
2014,Daeshon,M,100,0,6,6
2014,Daeveon,M,100,0,6,6
2014,Dagim,M,100,0,6,6
2014,Daichi,M,100,0,6,6
2014,Daily,F,100,6,0,6
2014,Daimian,M,100,0,6,6
2014,Daine,M,100,0,6,6
2014,Daion,M,100,0,6,6
2014,Daire,M,100,0,6,6
2014,Daisia,F,100,6,0,6
2014,Daiva,F,100,6,0,6
2014,Daiyan,M,100,0,6,6
2014,Dajour,M,100,0,6,6
2014,Dakhi,M,100,0,6,6
2014,Dakiya,F,100,6,0,6
2014,Dalasia,F,100,6,0,6
2014,Daler,M,100,0,6,6
2014,Dalery,F,100,6,0,6
2014,Dalian,M,100,0,6,6
2014,Dalida,F,100,6,0,6
2014,Dalisa,F,100,6,0,6
2014,Dalten,M,100,0,6,6
2014,Damareon,M,100,0,6,6
2014,Damariz,F,100,6,0,6
2014,Damiana,F,100,6,0,6
2014,Damiano,M,100,0,6,6
2014,Damira,F,100,6,0,6
2014,Damoney,M,100,0,6,6
2014,Damorion,M,100,0,6,6
2014,Danahi,F,100,6,0,6
2014,Danalynn,F,100,6,0,6
2014,Dandy,M,100,0,6,6
2014,Danelys,F,100,6,0,6
2014,Daney,F,100,6,0,6
2014,Danilee,F,100,6,0,6
2014,Danity,F,100,6,0,6
2014,Dannon,M,100,0,6,6
2014,Dantez,M,100,0,6,6
2014,Danyale,F,100,6,0,6
2014,Danyela,F,100,6,0,6
2014,Darah,F,100,6,0,6
2014,Darcee,F,100,6,0,6
2014,Darelyn,F,100,6,0,6
2014,Darick,M,100,0,6,6
2014,Darko,M,100,0,6,6
2014,Darleny,F,100,6,0,6
2014,Darrielle,F,100,6,0,6
2014,Darwyn,M,100,0,6,6
2014,Daryel,M,100,0,6,6
2014,Daryen,M,100,0,6,6
2014,Dasael,M,100,0,6,6
2014,Daschel,M,100,0,6,6
2014,Dashia,F,100,6,0,6
2014,Dat,M,100,0,6,6
2014,Dava,F,100,6,0,6
2014,Davayah,F,100,6,0,6
2014,Daveyon,M,100,0,6,6
2014,Davyd,M,100,0,6,6
2014,Dawaun,M,100,0,6,6
2014,Dayren,M,100,0,6,6
2014,Daysie,F,100,6,0,6
2014,Daytin,M,100,0,6,6
2014,Dayyan,M,100,0,6,6
2014,Dazia,F,100,6,0,6
2014,Dazion,M,100,0,6,6
2014,Daziya,F,100,6,0,6
2014,Deaaron,M,100,0,6,6
2014,Deaja,F,100,6,0,6
2014,Deann,F,100,6,0,6
2014,Deari,F,100,6,0,6
2014,Dearius,M,100,0,6,6
2014,Debbra,F,100,6,0,6
2014,Decarter,M,100,0,6,6
2014,Declen,M,100,0,6,6
2014,Deepa,F,100,6,0,6
2014,Deia,F,100,6,0,6
2014,Deidre,F,100,6,0,6
2014,Deivin,M,100,0,6,6
2014,Dekiya,F,100,6,0,6
2014,Dela,F,100,6,0,6
2014,Delaiah,F,100,6,0,6
2014,Delailah,F,100,6,0,6
2014,Delayni,F,100,6,0,6
2014,Delaysia,F,100,6,0,6
2014,Deliza,F,100,6,0,6
2014,Delson,M,100,0,6,6
2014,Delyza,F,100,6,0,6
2014,Demacio,M,100,0,6,6
2014,Demara,F,100,6,0,6
2014,Demauria,F,100,6,0,6
2014,Demeria,F,100,6,0,6
2014,Demetrick,M,100,0,6,6
2014,Demetrion,M,100,0,6,6
2014,Demetrus,M,100,0,6,6
2014,Demontre,M,100,0,6,6
2014,Demyiah,F,100,6,0,6
2014,Denarius,M,100,0,6,6
2014,Denaya,F,100,6,0,6
2014,Denia,F,100,6,0,6
2014,Deniel,M,100,0,6,6
2014,Denilah,F,100,6,0,6
2014,Dennys,M,100,0,6,6
2014,Deondra,F,100,6,0,6
2014,Deoni,F,100,6,0,6
2014,Dequincy,M,100,0,6,6
2014,Deriana,F,100,6,0,6
2014,Derica,F,100,6,0,6
2014,Derico,M,100,0,6,6
2014,Derrica,F,100,6,0,6
2014,Derris,M,100,0,6,6
2014,Derry,M,100,0,6,6
2014,Desiderio,M,100,0,6,6
2014,Desirey,F,100,6,0,6
2014,Desten,M,100,0,6,6
2014,Destery,M,100,0,6,6
2014,Destinii,F,100,6,0,6
2014,Destynee,F,100,6,0,6
2014,Detzani,F,100,6,0,6
2014,Deva,F,100,6,0,6
2014,Devam,M,100,0,6,6
2014,Devian,M,100,0,6,6
2014,Devonn,M,100,0,6,6
2014,Deylani,F,100,6,0,6
2014,Dezariah,F,100,6,0,6
2014,Dezman,M,100,0,6,6
2014,Dhyaan,M,100,0,6,6
2014,Diamonte,M,100,0,6,6
2014,Diba,F,100,6,0,6
2014,Dileydi,F,100,6,0,6
2014,Dimitris,M,100,0,6,6
2014,Din,M,100,0,6,6
2014,Dinara,F,100,6,0,6
2014,Dinh,M,100,0,6,6
2014,Dinora,F,100,6,0,6
2014,Dionysus,M,100,0,6,6
2014,Diora,F,100,6,0,6
2014,Disney,F,100,6,0,6
2014,Diyala,F,100,6,0,6
2014,Diyan,M,100,0,6,6
2014,Djay,M,100,0,6,6
2014,Dmario,M,100,0,6,6
2014,Dmiya,F,100,6,0,6
2014,Domino,F,100,6,0,6
2014,Domonik,M,100,0,6,6
2014,Donel,M,100,0,6,6
2014,Donevan,M,100,0,6,6
2014,Dontrey,M,100,0,6,6
2014,Dorsey,M,100,0,6,6
2014,Doruk,M,100,0,6,6
2014,Draelyn,M,100,0,6,6
2014,Draeson,M,100,0,6,6
2014,Drago,M,100,0,6,6
2014,Draken,M,100,0,6,6
2014,Draper,M,100,0,6,6
2014,Drashti,F,100,6,0,6
2014,Dravon,M,100,0,6,6
2014,Draylan,M,100,0,6,6
2014,Drelynn,F,100,6,0,6
2014,Drevyn,M,100,0,6,6
2014,Dreyah,F,100,6,0,6
2014,Driana,F,100,6,0,6
2014,Driggs,M,100,0,6,6
2014,Drita,F,100,6,0,6
2014,Dsean,M,100,0,6,6
2014,Dugan,M,100,0,6,6
2014,Dustan,M,100,0,6,6
2014,Dusten,M,100,0,6,6
2014,Duwayne,M,100,0,6,6
2014,Dyan,M,100,0,6,6
2014,Dyanne,F,100,6,0,6
2014,Dylilah,F,100,6,0,6
2014,Dyna,F,100,6,0,6
2014,Dynastee,F,100,6,0,6
2014,Dyshawn,M,100,0,6,6
2014,Dzaria,F,100,6,0,6
2014,Ealyn,F,100,6,0,6
2014,Eanna,F,100,6,0,6
2014,Earle,M,100,0,6,6
2014,Ebby,F,100,6,0,6
2014,Ebunoluwa,F,100,6,0,6
2014,Ece,F,100,6,0,6
2014,Ed,M,100,0,6,6
2014,Edessa,F,100,6,0,6
2014,Edge,M,100,0,6,6
2014,Edoardo,M,100,0,6,6
2014,Edon,M,100,0,6,6
2014,Edriel,M,100,0,6,6
2014,Edrik,M,100,0,6,6
2014,Eduin,M,100,0,6,6
2014,Edwar,M,100,0,6,6
2014,Eevie,F,100,6,0,6
2014,Ehaan,M,100,0,6,6
2014,Ein,M,100,0,6,6
2014,Einin,F,100,6,0,6
2014,Eizabella,F,100,6,0,6
2014,Elainna,F,100,6,0,6
2014,Eland,M,100,0,6,6
2014,Elannah,F,100,6,0,6
2014,Elanore,F,100,6,0,6
2014,Elea,F,100,6,0,6
2014,Eleftheria,F,100,6,0,6
2014,Eleri,F,100,6,0,6
2014,Elfego,M,100,0,6,6
2014,Eliazer,M,100,0,6,6
2014,Elidia,F,100,6,0,6
2014,Elijahjames,M,100,0,6,6
2014,Elinora,F,100,6,0,6
2014,Elionna,F,100,6,0,6
2014,Elisah,F,100,6,0,6
2014,Elisiana,F,100,6,0,6
2014,Elizabethann,F,100,6,0,6
2014,Elizer,M,100,0,6,6
2014,Elkan,M,100,0,6,6
2014,Elky,F,100,6,0,6
2014,Ellajane,F,100,6,0,6
2014,Ellenora,F,100,6,0,6
2014,Elliahna,F,100,6,0,6
2014,Ellierose,F,100,6,0,6
2014,Ellin,F,100,6,0,6
2014,Ellizabeth,F,100,6,0,6
2014,Elloree,F,100,6,0,6
2014,Ellsworth,M,100,0,6,6
2014,Ellyott,F,100,6,0,6
2014,Ellysia,F,100,6,0,6
2014,Elmir,M,100,0,6,6
2014,Elna,F,100,6,0,6
2014,Elodia,F,100,6,0,6
2014,Elshaddai,M,100,0,6,6
2014,Elvie,F,100,6,0,6
2014,Elvina,F,100,6,0,6
2014,Elway,M,100,0,6,6
2014,Elyanah,F,100,6,0,6
2014,Emannuel,M,100,0,6,6
2014,Emanuelle,F,100,6,0,6
2014,Emel,F,100,6,0,6
2014,Emerii,F,100,6,0,6
2014,Emerlee,F,100,6,0,6
2014,Emila,F,100,6,0,6
2014,Emiliah,F,100,6,0,6
2014,Emilya,F,100,6,0,6
2014,Emirah,F,100,6,0,6
2014,Emireth,F,100,6,0,6
2014,Emlynn,F,100,6,0,6
2014,Emmalena,F,100,6,0,6
2014,Emmaley,F,100,6,0,6
2014,Emmamae,F,100,6,0,6
2014,Emmani,F,100,6,0,6
2014,Emmaus,M,100,0,6,6
2014,Emmelyne,F,100,6,0,6
2014,Emmielou,F,100,6,0,6
2014,Emmilee,F,100,6,0,6
2014,Emmytt,M,100,0,6,6
2014,Emonee,F,100,6,0,6
2014,Empris,F,100,6,0,6
2014,Enara,F,100,6,0,6
2014,Endre,M,100,0,6,6
2014,Endrit,M,100,0,6,6
2014,Enrrique,M,100,0,6,6
2014,Enslie,F,100,6,0,6
2014,Envee,F,100,6,0,6
2014,Enzlee,F,100,6,0,6
2014,Enzlie,F,100,6,0,6
2014,Ephrata,F,100,6,0,6
2014,Eragon,M,100,0,6,6
2014,Eralyn,F,100,6,0,6
2014,Eran,M,100,0,6,6
2014,Erendira,F,100,6,0,6
2014,Erikah,F,100,6,0,6
2014,Eriksen,M,100,0,6,6
2014,Erilynn,F,100,6,0,6
2014,Erisa,F,100,6,0,6
2014,Erva,F,100,6,0,6
2014,Eryka,F,100,6,0,6
2014,Esben,M,100,0,6,6
2014,Eshika,F,100,6,0,6
2014,Esmie,F,100,6,0,6
2014,Esmond,M,100,0,6,6
2014,Essance,F,100,6,0,6
2014,Estefano,M,100,0,6,6
2014,Estin,M,100,0,6,6
2014,Estreya,F,100,6,0,6
2014,Eton,M,100,0,6,6
2014,Eulalio,M,100,0,6,6
2014,Eulises,M,100,0,6,6
2014,Euphemia,F,100,6,0,6
2014,Evaan,M,100,0,6,6
2014,Evaleen,F,100,6,0,6
2014,Evalyna,F,100,6,0,6
2014,Evamae,F,100,6,0,6
2014,Evangel,M,100,0,6,6
2014,Evannie,F,100,6,0,6
2014,Evaya,F,100,6,0,6
2014,Evellyn,F,100,6,0,6
2014,Evienne,F,100,6,0,6
2014,Evina,F,100,6,0,6
2014,Evonny,F,100,6,0,6
2014,Evyanna,F,100,6,0,6
2014,Eyasu,M,100,0,6,6
2014,Eylan,M,100,0,6,6
2014,Eymen,M,100,0,6,6
2014,Eyosias,M,100,0,6,6
2014,Eze,M,100,0,6,6
2014,Ezechiel,M,100,0,6,6
2014,Ezekiah,M,100,0,6,6
2014,Ezell,M,100,0,6,6
2014,Ezinne,F,100,6,0,6
2014,Ezmie,F,100,6,0,6
2014,Eztli,F,100,6,0,6
2014,Fabiano,M,100,0,6,6
2014,Fadila,F,100,6,0,6
2014,Faiha,F,100,6,0,6
2014,Faizon,M,100,0,6,6
2014,Fajr,F,100,6,0,6
2014,Fareeha,F,100,6,0,6
2014,Farhad,M,100,0,6,6
2014,Farhana,F,100,6,0,6
2014,Faria,F,100,6,0,6
2014,Farooq,M,100,0,6,6
2014,Farouq,M,100,0,6,6
2014,Farzona,F,100,6,0,6
2014,Fatim,F,100,6,0,6
2014,Fatouma,F,100,6,0,6
2014,Fatumata,F,100,6,0,6
2014,Favio,M,100,0,6,6
2014,Fayez,M,100,0,6,6
2014,Faylee,F,100,6,0,6
2014,Faysal,M,100,0,6,6
2014,Fenet,F,100,6,0,6
2014,Fenway,M,100,0,6,6
2014,Ferrah,F,100,6,0,6
2014,Ferrell,M,100,0,6,6
2014,Filippa,F,100,6,0,6
2014,Fina,F,100,6,0,6
2014,Finola,F,100,6,0,6
2014,Finton,M,100,0,6,6
2014,Fitzwilliam,M,100,0,6,6
2014,Fotima,F,100,6,0,6
2014,Francella,F,100,6,0,6
2014,Francie,F,100,6,0,6
2014,Franciszek,M,100,0,6,6
2014,Frederico,M,100,0,6,6
2014,Free,F,100,6,0,6
2014,Freyah,F,100,6,0,6
2014,Frimy,F,100,6,0,6
2014,Fryda,F,100,6,0,6
2014,Fynnlee,F,100,6,0,6
2014,Fynnley,F,100,6,0,6
2014,Fyodor,M,100,0,6,6
2014,Gabbrielle,F,100,6,0,6
2014,Gabreil,M,100,0,6,6
2014,Gabriellah,F,100,6,0,6
2014,Gabrielly,F,100,6,0,6
2014,Gabrien,M,100,0,6,6
2014,Galena,F,100,6,0,6
2014,Gardenia,F,100,6,0,6
2014,Gardner,M,100,0,6,6
2014,Garrin,M,100,0,6,6
2014,Garvens,M,100,0,6,6
2014,Garyn,M,100,0,6,6
2014,Gavrielle,F,100,6,0,6
2014,Gaya,F,100,6,0,6
2014,Gayla,F,100,6,0,6
2014,Gem,F,100,6,0,6
2014,Genecis,F,100,6,0,6
2014,Genuine,M,100,0,6,6
2014,Genysis,F,100,6,0,6
2014,Geordyn,F,100,6,0,6
2014,Georgeanna,F,100,6,0,6
2014,Geovana,F,100,6,0,6
2014,Geraldin,F,100,6,0,6
2014,Geraldo,M,100,0,6,6
2014,Geralyn,F,100,6,0,6
2014,Gershom,M,100,0,6,6
2014,Getzemani,F,100,6,0,6
2014,Ghala,F,100,6,0,6
2014,Ghaleb,M,100,0,6,6
2014,Gianelle,F,100,6,0,6
2014,Giann,M,100,0,6,6
2014,Giavonni,F,100,6,0,6
2014,Giliana,F,100,6,0,6
2014,Giuliette,F,100,6,0,6
2014,Glorianne,F,100,6,0,6
2014,Gorge,M,100,0,6,6
2014,Graceanna,F,100,6,0,6
2014,Graceland,F,100,6,0,6
2014,Gracelee,F,100,6,0,6
2014,Gracianna,F,100,6,0,6
2014,Graciee,F,100,6,0,6
2014,Graisyn,F,100,6,0,6
2014,Granville,M,100,0,6,6
2014,Graycelyn,F,100,6,0,6
2014,Graydin,M,100,0,6,6
2014,Graylan,M,100,0,6,6
2014,Graylee,F,100,6,0,6
2014,Greidy,F,100,6,0,6
2014,Gretchyn,F,100,6,0,6
2014,Greydis,F,100,6,0,6
2014,Grisham,M,100,0,6,6
2014,Guhan,M,100,0,6,6
2014,Gwendelyn,F,100,6,0,6
2014,Gwendoline,F,100,6,0,6
2014,Gwendolynne,F,100,6,0,6
2014,Gwenn,F,100,6,0,6
2014,Gwyndolyn,F,100,6,0,6
2014,Haaheo,M,100,0,6,6
2014,Haddley,F,100,6,0,6
2014,Hades,M,100,0,6,6
2014,Hadja,F,100,6,0,6
2014,Hadly,F,100,6,0,6
2014,Hadlynn,F,100,6,0,6
2014,Hady,M,100,0,6,6
2014,Haeven,F,100,6,0,6
2014,Haidon,M,100,0,6,6
2014,Haidynn,F,100,6,0,6
2014,Haizen,M,100,0,6,6
2014,Hajj,M,100,0,6,6
2014,Haleigha,F,100,6,0,6
2014,Hameed,M,100,0,6,6
2014,Hamim,M,100,0,6,6
2014,Hamsini,F,100,6,0,6
2014,Hamzeh,M,100,0,6,6
2014,Hananiah,F,100,6,0,6
2014,Handsome,M,100,0,6,6
2014,Haniah,F,100,6,0,6
2014,Hannie,F,100,6,0,6
2014,Haoran,M,100,0,6,6
2014,Haowen,M,100,0,6,6
2014,Hara,F,100,6,0,6
2014,Harbin,M,100,0,6,6
2014,Harfateh,M,100,0,6,6
2014,Harison,M,100,0,6,6
2014,Harlequin,F,100,6,0,6
2014,Harleyann,F,100,6,0,6
2014,Harloe,F,100,6,0,6
2014,Harmanie,F,100,6,0,6
2014,Harmone,F,100,6,0,6
2014,Harsha,M,100,0,6,6
2014,Harshiv,M,100,0,6,6
2014,Harvard,M,100,0,6,6
2014,Hason,M,100,0,6,6
2014,Hassaan,M,100,0,6,6
2014,Hasten,M,100,0,6,6
2014,Hasti,F,100,6,0,6
2014,Hatice,F,100,6,0,6
2014,Hatim,M,100,0,6,6
2014,Havick,M,100,0,6,6
2014,Haviland,F,100,6,0,6
2014,Hawkin,M,100,0,6,6
2014,Hawo,F,100,6,0,6
2014,Hawthorn,M,100,0,6,6
2014,Hawwaa,F,100,6,0,6
2014,Hayleen,F,100,6,0,6
2014,Haynes,M,100,0,6,6
2014,Hein,M,100,0,6,6
2014,Heloise,F,100,6,0,6
2014,Hemma,F,100,6,0,6
2014,Henessy,F,100,6,0,6
2014,Hennesy,F,100,6,0,6
2014,Hennley,F,100,6,0,6
2014,Henok,M,100,0,6,6
2014,Henriette,F,100,6,0,6
2014,Herberth,M,100,0,6,6
2014,Hetvi,F,100,6,0,6
2014,Hever,M,100,0,6,6
2014,Heyam,F,100,6,0,6
2014,Heydy,F,100,6,0,6
2014,Hezekiel,M,100,0,6,6
2014,Hildegard,F,100,6,0,6
2014,Hinaea,F,100,6,0,6
2014,Hines,M,100,0,6,6
2014,Hixon,M,100,0,6,6
2014,Hoang,M,100,0,6,6
2014,Hobie,M,100,0,6,6
2014,Hobson,M,100,0,6,6
2014,Hollin,F,100,6,0,6
2014,Hollynd,F,100,6,0,6
2014,Honorio,M,100,0,6,6
2014,Hopelyn,F,100,6,0,6
2014,Hopper,M,100,0,6,6
2014,Hossain,M,100,0,6,6
2014,Hossam,M,100,0,6,6
2014,Hrehaan,M,100,0,6,6
2014,Hypatia,F,100,6,0,6
2014,Iago,M,100,0,6,6
2014,Ianto,M,100,0,6,6
2014,Iban,M,100,0,6,6
2014,Icey,F,100,6,0,6
2014,Idalee,F,100,6,0,6
2014,Idalis,F,100,6,0,6
2014,Idania,F,100,6,0,6
2014,Idiris,M,100,0,6,6
2014,Ieva,F,100,6,0,6
2014,Ifeoma,F,100,6,0,6
2014,Ilaina,F,100,6,0,6
2014,Ilaisaane,F,100,6,0,6
2014,Ilda,F,100,6,0,6
2014,Ilian,M,100,0,6,6
2014,Illeana,F,100,6,0,6
2014,Illias,M,100,0,6,6
2014,Ilma,F,100,6,0,6
2014,Ilo,F,100,6,0,6
2014,Imagine,F,100,6,0,6
2014,Imanie,F,100,6,0,6
2014,Imany,F,100,6,0,6
2014,Imoni,F,100,6,0,6
2014,Imrane,M,100,0,6,6
2014,Imre,M,100,0,6,6
2014,Inanna,F,100,6,0,6
2014,Indiah,F,100,6,0,6
2014,Inge,F,100,6,0,6
2014,Insley,F,100,6,0,6
2014,Ipek,F,100,6,0,6
2014,Iralyn,F,100,6,0,6
2014,Irha,F,100,6,0,6
2014,Iridessa,F,100,6,0,6
2014,Isaack,M,100,0,6,6
2014,Isahi,M,100,0,6,6
2014,Isahia,M,100,0,6,6
2014,Isaia,M,100,0,6,6
2014,Isais,M,100,0,6,6
2014,Isaly,F,100,6,0,6
2014,Ishara,F,100,6,0,6
2014,Isia,F,100,6,0,6
2014,Itati,F,100,6,0,6
2014,Itta,F,100,6,0,6
2014,Itzael,M,100,0,6,6
2014,Itzamara,F,100,6,0,6
2014,Itzayani,F,100,6,0,6
2014,Itzelle,F,100,6,0,6
2014,Ivann,M,100,0,6,6
2014,Ivannah,F,100,6,0,6
2014,Ivi,F,100,6,0,6
2014,Ivianna,F,100,6,0,6
2014,Ivion,M,100,0,6,6
2014,Ivis,M,100,0,6,6
2014,Iyaad,M,100,0,6,6
2014,Iyauna,F,100,6,0,6
2014,Iyleen,F,100,6,0,6
2014,Izadora,F,100,6,0,6
2014,Izea,M,100,0,6,6
2014,Izelle,F,100,6,0,6
2014,Izhar,M,100,0,6,6
2014,Izzabel,F,100,6,0,6
2014,Izzabellah,F,100,6,0,6
2014,Izzibella,F,100,6,0,6
2014,Jaana,F,100,6,0,6
2014,Jaasritha,F,100,6,0,6
2014,Jabdiel,M,100,0,6,6
2014,Jabes,M,100,0,6,6
2014,Jabori,M,100,0,6,6
2014,Jabraylen,M,100,0,6,6
2014,Jabri,M,100,0,6,6
2014,Jacaree,M,100,0,6,6
2014,Jacieon,M,100,0,6,6
2014,Jacody,M,100,0,6,6
2014,Jacolbi,M,100,0,6,6
2014,Jacquan,M,100,0,6,6
2014,Jacyion,M,100,0,6,6
2014,Jadalee,F,100,6,0,6
2014,Jadalise,F,100,6,0,6
2014,Jadaya,F,100,6,0,6
2014,Jaelan,M,100,0,6,6
2014,Jaemarie,F,100,6,0,6
2014,Jaeonna,F,100,6,0,6
2014,Jaeshawn,M,100,0,6,6
2014,Jaesun,M,100,0,6,6
2014,Jaeveon,M,100,0,6,6
2014,Jaevian,M,100,0,6,6
2014,Jaggar,M,100,0,6,6
2014,Jahdai,F,100,6,0,6
2014,Jahid,M,100,0,6,6
2014,Jahiyah,F,100,6,0,6
2014,Jahkeem,M,100,0,6,6
2014,Jahmai,M,100,0,6,6
2014,Jahnia,F,100,6,0,6
2014,Jahquan,M,100,0,6,6
2014,Jahzel,F,100,6,0,6
2014,Jaiceyon,M,100,0,6,6
2014,Jaideep,M,100,0,6,6
2014,Jaidelyn,F,100,6,0,6
2014,Jaik,M,100,0,6,6
2014,Jaikob,M,100,0,6,6
2014,Jailin,M,100,0,6,6
2014,Jailiyah,F,100,6,0,6
2014,Jaimere,M,100,0,6,6
2014,Jaiyon,M,100,0,6,6
2014,Jakailyn,F,100,6,0,6
2014,Jakar,M,100,0,6,6
2014,Jakavion,M,100,0,6,6
2014,Jakevia,F,100,6,0,6
2014,Jakirah,F,100,6,0,6
2014,Jakobee,M,100,0,6,6
2014,Jakoda,M,100,0,6,6
2014,Jakolby,M,100,0,6,6
2014,Jakyrah,F,100,6,0,6
2014,Jalaia,F,100,6,0,6
2014,Jalie,F,100,6,0,6
2014,Jalik,M,100,0,6,6
2014,Jalise,F,100,6,0,6
2014,Jaliyiah,F,100,6,0,6
2014,Jaliza,F,100,6,0,6
2014,Jamaurion,M,100,0,6,6
2014,Jameia,F,100,6,0,6
2014,Jameison,M,100,0,6,6
2014,Jamerion,M,100,0,6,6
2014,Jamesryan,M,100,0,6,6
2014,Jamicah,M,100,0,6,6
2014,Jamieon,M,100,0,6,6
2014,Jamina,F,100,6,0,6
2014,Jamori,M,100,0,6,6
2014,Jamyriah,F,100,6,0,6
2014,Janaiyah,F,100,6,0,6
2014,Janier,M,100,0,6,6
2014,Janila,F,100,6,0,6
2014,Janny,F,100,6,0,6
2014,Jansiel,M,100,0,6,6
2014,Jaquann,M,100,0,6,6
2014,Jaquelyne,F,100,6,0,6
2014,Jaramiah,M,100,0,6,6
2014,Jaraya,F,100,6,0,6
2014,Jarelis,F,100,6,0,6
2014,Jarik,M,100,0,6,6
2014,Jarin,M,100,0,6,6
2014,Jarissa,F,100,6,0,6
2014,Jarome,M,100,0,6,6
2014,Jarrin,M,100,0,6,6
2014,Jas,M,100,0,6,6
2014,Jashley,F,100,6,0,6
2014,Jasian,M,100,0,6,6
2014,Jasias,M,100,0,6,6
2014,Jasielle,F,100,6,0,6
2014,Jaslen,F,100,6,0,6
2014,Jatavia,F,100,6,0,6
2014,Javiana,F,100,6,0,6
2014,Javir,M,100,0,6,6
2014,Javis,M,100,0,6,6
2014,Javoni,M,100,0,6,6
2014,Jaxzon,M,100,0,6,6
2014,Jayace,M,100,0,6,6
2014,Jayanth,M,100,0,6,6
2014,Jayauna,F,100,6,0,6
2014,Jaycean,M,100,0,6,6
2014,Jayceeon,M,100,0,6,6
2014,Jaycey,F,100,6,0,6
2014,Jaydalee,F,100,6,0,6
2014,Jaydalyn,F,100,6,0,6
2014,Jaydelin,F,100,6,0,6
2014,Jaydelynn,F,100,6,0,6
2014,Jaydi,F,100,6,0,6
2014,Jaydian,M,100,0,6,6
2014,Jayel,F,100,6,0,6
2014,Jayk,M,100,0,6,6
2014,Jaylaah,F,100,6,0,6
2014,Jaylanis,F,100,6,0,6
2014,Jayleena,F,100,6,0,6
2014,Jaylianis,F,100,6,0,6
2014,Jaylise,F,100,6,0,6
2014,Jaymarion,M,100,0,6,6
2014,Jaymen,M,100,0,6,6
2014,Jaymian,M,100,0,6,6
2014,Jaymon,M,100,0,6,6
2014,Jaysin,M,100,0,6,6
2014,Jaysun,M,100,0,6,6
2014,Jayveion,M,100,0,6,6
2014,Jayvonni,M,100,0,6,6
2014,Jaz,M,100,0,6,6
2014,Jaza,F,100,6,0,6
2014,Jazael,M,100,0,6,6
2014,Jazavion,M,100,0,6,6
2014,Jazen,M,100,0,6,6
2014,Jazhiel,M,100,0,6,6
2014,Jazilyn,F,100,6,0,6
2014,Jazlen,F,100,6,0,6
2014,Jazmina,F,100,6,0,6
2014,Jazyah,F,100,6,0,6
2014,Jazzabella,F,100,6,0,6
2014,Jazzabelle,F,100,6,0,6
2014,Jazzel,F,100,6,0,6
2014,Jazziel,M,100,0,6,6
2014,Jazzlin,F,100,6,0,6
2014,Jazzlyne,F,100,6,0,6
2014,Jcyon,M,100,0,6,6
2014,Jdyn,M,100,0,6,6
2014,Jeanmarie,F,100,6,0,6
2014,Jebadiah,M,100,0,6,6
2014,Jedrik,M,100,0,6,6
2014,Jeffren,M,100,0,6,6
2014,Jefte,M,100,0,6,6
2014,Jehan,M,100,0,6,6
2014,Jehilyn,F,100,6,0,6
2014,Jeilin,F,100,6,0,6
2014,Jeiren,M,100,0,6,6
2014,Jekhi,M,100,0,6,6
2014,Jelina,F,100,6,0,6
2014,Jem,F,100,6,0,6
2014,Jemina,F,100,6,0,6
2014,Jemuel,M,100,0,6,6
2014,Jenaliz,F,100,6,0,6
2014,Jenan,F,100,6,0,6
2014,Jenelly,F,100,6,0,6
2014,Jenely,F,100,6,0,6
2014,Jenessy,F,100,6,0,6
2014,Jenesys,F,100,6,0,6
2014,Jeniel,M,100,0,6,6
2014,Jenine,F,100,6,0,6
2014,Jennalise,F,100,6,0,6
2014,Jennalynn,F,100,6,0,6
2014,Jennasis,F,100,6,0,6
2014,Jennelle,F,100,6,0,6
2014,Jennette,F,100,6,0,6
2014,Jenniah,F,100,6,0,6
2014,Jenrry,M,100,0,6,6
2014,Jentrie,F,100,6,0,6
2014,Jeptha,M,100,0,6,6
2014,Jera,F,100,6,0,6
2014,Jeremai,M,100,0,6,6
2014,Jericha,F,100,6,0,6
2014,Jericka,F,100,6,0,6
2014,Jermarcus,M,100,0,6,6
2014,Jernie,F,100,6,0,6
2014,Jeromy,M,100,0,6,6
2014,Jerrel,M,100,0,6,6
2014,Jerrika,F,100,6,0,6
2014,Jerrold,M,100,0,6,6
2014,Jervon,M,100,0,6,6
2014,Jerzei,F,100,6,0,6
2014,Jesi,F,100,6,0,6
2014,Jeslie,F,100,6,0,6
2014,Jeslin,F,100,6,0,6
2014,Jesmarie,F,100,6,0,6
2014,Jesper,M,100,0,6,6
2014,Jessey,F,100,6,0,6
2014,Jesson,M,100,0,6,6
2014,Jeston,M,100,0,6,6
2014,Jetton,M,100,0,6,6
2014,Jex,M,100,0,6,6
2014,Jeydon,M,100,0,6,6
2014,Jeyko,M,100,0,6,6
2014,Jeylen,F,100,6,0,6
2014,Jezebelle,F,100,6,0,6
2014,Jezel,F,100,6,0,6
2014,Jhayden,M,100,0,6,6
2014,Jhenae,F,100,6,0,6
2014,Jhia,F,100,6,0,6
2014,Jhoel,M,100,0,6,6
2014,Jhourni,F,100,6,0,6
2014,Jianah,F,100,6,0,6
2014,Jiannah,F,100,6,0,6
2014,Jibriel,M,100,0,6,6
2014,Jillianna,F,100,6,0,6
2014,Jillyan,F,100,6,0,6
2014,Jimenna,F,100,6,0,6
2014,Jion,M,100,0,6,6
2014,Jiro,M,100,0,6,6
2014,Jisele,F,100,6,0,6
2014,Jisell,F,100,6,0,6
2014,Jiyaan,M,100,0,6,6
2014,Jla,F,100,6,0,6
2014,Jnyah,F,100,6,0,6
2014,Joangel,M,100,0,6,6
2014,Jocey,F,100,6,0,6
2014,Jociah,M,100,0,6,6
2014,Joclyn,F,100,6,0,6
2014,Joclynn,F,100,6,0,6
2014,Jodan,M,100,0,6,6
2014,Joeliz,F,100,6,0,6
2014,Joellen,F,100,6,0,6
2014,Joelyn,F,100,6,0,6
2014,Joesiyah,M,100,0,6,6
2014,Johanan,M,100,0,6,6
2014,Johnasia,F,100,6,0,6
2014,Johniel,M,100,0,6,6
2014,Johniya,F,100,6,0,6
2014,Johnjoseph,M,100,0,6,6
2014,Johnni,F,100,6,0,6
2014,Johon,M,100,0,6,6
2014,Joliette,F,100,6,0,6
2014,Jolyssa,F,100,6,0,6
2014,Joniah,F,100,6,0,6
2014,Jophiel,M,100,0,6,6
2014,Joran,M,100,0,6,6
2014,Jorgeluis,M,100,0,6,6
2014,Josedejesus,M,100,0,6,6
2014,Josefa,F,100,6,0,6
2014,Joselina,F,100,6,0,6
2014,Joshia,M,100,0,6,6
2014,Joshuel,M,100,0,6,6
2014,Josiana,F,100,6,0,6
2014,Josimar,M,100,0,6,6
2014,Josmarie,F,100,6,0,6
2014,Jossie,F,100,6,0,6
2014,Jouri,F,100,6,0,6
2014,Journe,F,100,6,0,6
2014,Journeii,F,100,6,0,6
2014,Journye,F,100,6,0,6
2014,Jovante,M,100,0,6,6
2014,Jowel,M,100,0,6,6
2014,Joydan,F,100,6,0,6
2014,Joyelle,F,100,6,0,6
2014,Joyful,F,100,6,0,6
2014,Joyous,F,100,6,0,6
2014,Jozette,F,100,6,0,6
2014,Jozi,F,100,6,0,6
2014,Jozlynne,F,100,6,0,6
2014,Juanandres,M,100,0,6,6
2014,Juelle,F,100,6,0,6
2014,Juiliana,F,100,6,0,6
2014,Juleah,F,100,6,0,6
2014,Julez,M,100,0,6,6
2014,Juliannah,F,100,6,0,6
2014,Julianni,F,100,6,0,6
2014,Julienna,F,100,6,0,6
2014,Juliessa,F,100,6,0,6
2014,Juliona,F,100,6,0,6
2014,Juliya,F,100,6,0,6
2014,Juliyana,F,100,6,0,6
2014,Junyi,M,100,0,6,6
2014,Juri,F,100,6,0,6
2014,Jury,M,100,0,6,6
2014,Juvia,F,100,6,0,6
2014,Jvian,M,100,0,6,6
2014,Jvion,M,100,0,6,6
2014,Jyair,M,100,0,6,6
2014,Jyden,M,100,0,6,6
2014,Kaalyn,F,100,6,0,6
2014,Kabe,M,100,0,6,6
2014,Kabel,M,100,0,6,6
2014,Kabrina,F,100,6,0,6
2014,Kacei,F,100,6,0,6
2014,Kacin,M,100,0,6,6
2014,Kadelyn,F,100,6,0,6
2014,Kadidiatou,F,100,6,0,6
2014,Kadidja,F,100,6,0,6
2014,Kadince,F,100,6,0,6
2014,Kadynn,F,100,6,0,6
2014,Kaedynce,F,100,6,0,6
2014,Kaelem,M,100,0,6,6
2014,Kaelob,M,100,0,6,6
2014,Kaelub,M,100,0,6,6
2014,Kahaan,M,100,0,6,6
2014,Kahealani,F,100,6,0,6
2014,Kaiann,F,100,6,0,6
2014,Kaiel,M,100,0,6,6
2014,Kaiicen,M,100,0,6,6
2014,Kailany,F,100,6,0,6
2014,Kailayah,F,100,6,0,6
2014,Kailena,F,100,6,0,6
2014,Kailon,M,100,0,6,6
2014,Kaion,M,100,0,6,6
2014,Kaisy,F,100,6,0,6
2014,Kaivon,M,100,0,6,6
2014,Kalet,M,100,0,6,6
2014,Kaliber,M,100,0,6,6
2014,Kalieah,F,100,6,0,6
2014,Kaliyana,F,100,6,0,6
2014,Kalleb,M,100,0,6,6
2014,Kallin,M,100,0,6,6
2014,Kalub,M,100,0,6,6
2014,Kamalani,F,100,6,0,6
2014,Kamalei,F,100,6,0,6
2014,Kamarah,F,100,6,0,6
2014,Kamarria,F,100,6,0,6
2014,Kamberlyn,F,100,6,0,6
2014,Kambre,F,100,6,0,6
2014,Kambreigh,F,100,6,0,6
2014,Kameelah,F,100,6,0,6
2014,Kamella,F,100,6,0,6
2014,Kamellia,F,100,6,0,6
2014,Kammy,F,100,6,0,6
2014,Kamonie,F,100,6,0,6
2014,Kamsi,F,100,6,0,6
2014,Kamyron,M,100,0,6,6
2014,Kanae,F,100,6,0,6
2014,Kandi,F,100,6,0,6
2014,Kandis,F,100,6,0,6
2014,Kandon,M,100,0,6,6
2014,Kandy,F,100,6,0,6
2014,Kanish,M,100,0,6,6
2014,Kano,M,100,0,6,6
2014,Karai,F,100,6,0,6
2014,Karanvir,M,100,0,6,6
2014,Kardae,M,100,0,6,6
2014,Kareema,F,100,6,0,6
2014,Kareli,F,100,6,0,6
2014,Karelys,F,100,6,0,6
2014,Karessa,F,100,6,0,6
2014,Karia,F,100,6,0,6
2014,Karie,F,100,6,0,6
2014,Kariel,F,100,6,0,6
2014,Kariem,M,100,0,6,6
2014,Karinna,F,100,6,0,6
2014,Kariss,F,100,6,0,6
2014,Karleen,F,100,6,0,6
2014,Karlene,F,100,6,0,6
2014,Karlia,F,100,6,0,6
2014,Karliee,F,100,6,0,6
2014,Karlin,M,100,0,6,6
2014,Karmon,F,100,6,0,6
2014,Karnell,M,100,0,6,6
2014,Karrine,F,100,6,0,6
2014,Karrson,M,100,0,6,6
2014,Karsan,M,100,0,6,6
2014,Kartar,M,100,0,6,6
2014,Karyss,F,100,6,0,6
2014,Kasadee,F,100,6,0,6
2014,Kashden,M,100,0,6,6
2014,Kashdyn,M,100,0,6,6
2014,Kasir,M,100,0,6,6
2014,Kasiyah,F,100,6,0,6
2014,Kaslyn,F,100,6,0,6
2014,Kassiana,F,100,6,0,6
2014,Kasumi,F,100,6,0,6
2014,Katalayah,F,100,6,0,6
2014,Katalin,F,100,6,0,6
2014,Kataliyah,F,100,6,0,6
2014,Katalya,F,100,6,0,6
2014,Katera,F,100,6,0,6
2014,Katherinne,F,100,6,0,6
2014,Katilynn,F,100,6,0,6
2014,Katrena,F,100,6,0,6
2014,Kaulana,M,100,0,6,6
2014,Kayani,F,100,6,0,6
2014,Kaycin,M,100,0,6,6
2014,Kaydian,M,100,0,6,6
2014,Kaydrian,M,100,0,6,6
2014,Kaydrie,F,100,6,0,6
2014,Kayen,M,100,0,6,6
2014,Kayge,M,100,0,6,6
2014,Kayleana,F,100,6,0,6
2014,Kaylla,F,100,6,0,6
2014,Kaynan,M,100,0,6,6
2014,Kayse,F,100,6,0,6
2014,Kaytee,F,100,6,0,6
2014,Kaytelynn,F,100,6,0,6
2014,Kayvin,M,100,0,6,6
2014,Kaz,M,100,0,6,6
2014,Kazlynn,F,100,6,0,6
2014,Keaka,M,100,0,6,6
2014,Kealy,F,100,6,0,6
2014,Keauna,F,100,6,0,6
2014,Kebron,M,100,0,6,6
2014,Keeyan,M,100,0,6,6
2014,Keiarah,F,100,6,0,6
2014,Keiland,M,100,0,6,6
2014,Keiliany,F,100,6,0,6
2014,Kein,M,100,0,6,6
2014,Keishaun,M,100,0,6,6
2014,Kekai,M,100,0,6,6
2014,Kellar,M,100,0,6,6
2014,Kelleigh,F,100,6,0,6
2014,Kellsey,F,100,6,0,6
2014,Kellsie,F,100,6,0,6
2014,Kellum,M,100,0,6,6
2014,Keltin,M,100,0,6,6
2014,Kelvon,M,100,0,6,6
2014,Kely,F,100,6,0,6
2014,Kenaniah,M,100,0,6,6
2014,Kenari,F,100,6,0,6
2014,Kendo,M,100,0,6,6
2014,Kendryk,M,100,0,6,6
2014,Kendy,F,100,6,0,6
2014,Keneth,M,100,0,6,6
2014,Keni,F,100,6,0,6
2014,Kenise,F,100,6,0,6
2014,Kenith,M,100,0,6,6
2014,Kennet,M,100,0,6,6
2014,Kennyel,M,100,0,6,6
2014,Kensy,F,100,6,0,6
2014,Kentleigh,F,100,6,0,6
2014,Kentrail,M,100,0,6,6
2014,Kepa,M,100,0,6,6
2014,Kerah,F,100,6,0,6
2014,Kesha,F,100,6,0,6
2014,Keslynn,F,100,6,0,6
2014,Kestyn,M,100,0,6,6
2014,Kevonte,M,100,0,6,6
2014,Kexin,F,100,6,0,6
2014,Keyron,M,100,0,6,6
2014,Khadin,M,100,0,6,6
2014,Khadyn,M,100,0,6,6
2014,Khalen,M,100,0,6,6
2014,Khalii,F,100,6,0,6
2014,Khalisah,F,100,6,0,6
2014,Khamar,M,100,0,6,6
2014,Khamden,M,100,0,6,6
2014,Khamil,F,100,6,0,6
2014,Khamron,M,100,0,6,6
2014,Khaniya,F,100,6,0,6
2014,Kharli,F,100,6,0,6
2014,Kharon,M,100,0,6,6
2014,Khasim,M,100,0,6,6
2014,Khassidy,F,100,6,0,6
2014,Khaza,M,100,0,6,6
2014,Khenadi,F,100,6,0,6
2014,Khiyan,M,100,0,6,6
2014,Kholee,F,100,6,0,6
2014,Khoury,M,100,0,6,6
2014,Khyon,M,100,0,6,6
2014,Kiam,M,100,0,6,6
2014,Kiaraliz,F,100,6,0,6
2014,Kieffer,M,100,0,6,6
2014,Kiela,F,100,6,0,6
2014,Kielan,M,100,0,6,6
2014,Kierce,M,100,0,6,6
2014,Kierrah,F,100,6,0,6
2014,Kiet,M,100,0,6,6
2014,Kileyann,F,100,6,0,6
2014,Kilo,M,100,0,6,6
2014,Kimiah,F,100,6,0,6
2014,Kimmie,F,100,6,0,6
2014,Kingcharles,M,100,0,6,6
2014,Kingelijah,M,100,0,6,6
2014,Kingman,M,100,0,6,6
2014,Kinnidy,F,100,6,0,6
2014,Kino,M,100,0,6,6
2014,Kinsie,F,100,6,0,6
2014,Kinsington,F,100,6,0,6
2014,Kipper,M,100,0,6,6
2014,Kirana,F,100,6,0,6
2014,Kire,M,100,0,6,6
2014,Kiriana,F,100,6,0,6
2014,Kiro,M,100,0,6,6
2014,Kiron,M,100,0,6,6
2014,Kiros,M,100,0,6,6
2014,Kirrah,F,100,6,0,6
2014,Kisha,F,100,6,0,6
2014,Kismet,F,100,6,0,6
2014,Kiyen,M,100,0,6,6
2014,Kiyonna,F,100,6,0,6
2014,Kj,M,100,0,6,6
2014,Kjell,M,100,0,6,6
2014,Kmarion,M,100,0,6,6
2014,Kmya,F,100,6,0,6
2014,Knoa,M,100,0,6,6
2014,Knoxley,M,100,0,6,6
2014,Knute,M,100,0,6,6
2014,Koben,M,100,0,6,6
2014,Kobin,M,100,0,6,6
2014,Koleman,M,100,0,6,6
2014,Kollen,M,100,0,6,6
2014,Konan,M,100,0,6,6
2014,Kopelynn,F,100,6,0,6
2014,Koralyne,F,100,6,0,6
2014,Korbynn,F,100,6,0,6
2014,Koriana,F,100,6,0,6
2014,Korrine,F,100,6,0,6
2014,Korryn,F,100,6,0,6
2014,Kortnie,F,100,6,0,6
2014,Kouper,M,100,0,6,6
2014,Kovu,M,100,0,6,6
2014,Kripa,F,100,6,0,6
2014,Krishang,M,100,0,6,6
2014,Krishay,M,100,0,6,6
2014,Kristhel,F,100,6,0,6
2014,Krystell,F,100,6,0,6
2014,Kushagra,M,100,0,6,6
2014,Kuyper,M,100,0,6,6
2014,Kweli,M,100,0,6,6
2014,Kyel,M,100,0,6,6
2014,Kyelle,F,100,6,0,6
2014,Kyier,M,100,0,6,6
2014,Kyleighann,F,100,6,0,6
2014,Kylena,F,100,6,0,6
2014,Kyllie,F,100,6,0,6
2014,Kymbree,F,100,6,0,6
2014,Kynden,M,100,0,6,6
2014,Kynslea,F,100,6,0,6
2014,Kynzli,F,100,6,0,6
2014,Kyo,M,100,0,6,6
2014,Kyrel,M,100,0,6,6
2014,Kyrianna,F,100,6,0,6
2014,Kyriee,M,100,0,6,6
2014,Kyrra,F,100,6,0,6
2014,Kyrus,M,100,0,6,6
2014,Kysin,M,100,0,6,6
2014,Kyvon,M,100,0,6,6
2014,Kyzier,M,100,0,6,6
2014,Laakea,M,100,0,6,6
2014,Laasia,F,100,6,0,6
2014,Labria,F,100,6,0,6
2014,Lachlann,M,100,0,6,6
2014,Ladamian,M,100,0,6,6
2014,Ladarien,M,100,0,6,6
2014,Ladarion,M,100,0,6,6
2014,Laden,M,100,0,6,6
2014,Laena,F,100,6,0,6
2014,Laeton,M,100,0,6,6
2014,Laik,M,100,0,6,6
2014,Lailaa,F,100,6,0,6
2014,Lailany,F,100,6,0,6
2014,Lailarose,F,100,6,0,6
2014,Lainy,F,100,6,0,6
2014,Lakeem,M,100,0,6,6
2014,Lakendra,F,100,6,0,6
2014,Lakiah,F,100,6,0,6
2014,Laking,M,100,0,6,6
2014,Laleh,F,100,6,0,6
2014,Lalitha,F,100,6,0,6
2014,Lamel,M,100,0,6,6
2014,Lamond,M,100,0,6,6
2014,Lamontae,M,100,0,6,6
2014,Lamontez,M,100,0,6,6
2014,Lamyra,F,100,6,0,6
2014,Lan,F,100,6,0,6
2014,Lang,M,100,0,6,6
2014,Lanita,F,100,6,0,6
2014,Lannie,F,100,6,0,6
2014,Lanston,M,100,0,6,6
2014,Larah,F,100,6,0,6
2014,Larayah,F,100,6,0,6
2014,Larence,M,100,0,6,6
2014,Laria,F,100,6,0,6
2014,Lashayla,F,100,6,0,6
2014,Lashon,M,100,0,6,6
2014,Lassana,M,100,0,6,6
2014,Latalia,F,100,6,0,6
2014,Lateen,F,100,6,0,6
2014,Lathyn,M,100,0,6,6
2014,Latrelle,M,100,0,6,6
2014,Latrez,M,100,0,6,6
2014,Latroy,M,100,0,6,6
2014,Laundyn,F,100,6,0,6
2014,Laurelyn,F,100,6,0,6
2014,Laurissa,F,100,6,0,6
2014,Laury,F,100,6,0,6
2014,Lavena,F,100,6,0,6
2014,Lavie,F,100,6,0,6
2014,Law,M,100,0,6,6
2014,Lawrance,M,100,0,6,6
2014,Layahna,F,100,6,0,6
2014,Layke,M,100,0,6,6
2014,Laykyn,F,100,6,0,6
2014,Laylagrace,F,100,6,0,6
2014,Laylie,F,100,6,0,6
2014,Laylonie,F,100,6,0,6
2014,Layn,M,100,0,6,6
2014,Laython,M,100,0,6,6
2014,Laziyah,F,100,6,0,6
2014,Leandria,F,100,6,0,6
2014,Leara,F,100,6,0,6
2014,Leauna,F,100,6,0,6
2014,Ledarius,M,100,0,6,6
2014,Leddi,F,100,6,0,6
2014,Leelend,M,100,0,6,6
2014,Leeonna,F,100,6,0,6
2014,Leeson,M,100,0,6,6
2014,Legna,F,100,6,0,6
2014,Lemmy,M,100,0,6,6
2014,Lendon,M,100,0,6,6
2014,Lenell,M,100,0,6,6
2014,Lennin,M,100,0,6,6
2014,Lenyn,F,100,6,0,6
2014,Leodan,M,100,0,6,6
2014,Leondro,M,100,0,6,6
2014,Leonella,F,100,6,0,6
2014,Leontae,M,100,0,6,6
2014,Leonte,M,100,0,6,6
2014,Lequan,M,100,0,6,6
2014,Leum,M,100,0,6,6
2014,Levaeh,F,100,6,0,6
2014,Levan,M,100,0,6,6
2014,Leveah,F,100,6,0,6
2014,Levina,F,100,6,0,6
2014,Levitt,M,100,0,6,6
2014,Lewyn,M,100,0,6,6
2014,Lexin,M,100,0,6,6
2014,Leyda,F,100,6,0,6
2014,Leylany,F,100,6,0,6
2014,Lezly,F,100,6,0,6
2014,Liahona,F,100,6,0,6
2014,Liandro,M,100,0,6,6
2014,Lianys,F,100,6,0,6
2014,Liav,M,100,0,6,6
2014,Liera,F,100,6,0,6
2014,Lija,F,100,6,0,6
2014,Lijana,F,100,6,0,6
2014,Lileana,F,100,6,0,6
2014,Liliannah,F,100,6,0,6
2014,Lillyahna,F,100,6,0,6
2014,Lilyah,F,100,6,0,6
2014,Lilyrae,F,100,6,0,6
2014,Linah,F,100,6,0,6
2014,Lindan,M,100,0,6,6
2014,Lindzey,F,100,6,0,6
2014,Lingyi,F,100,6,0,6
2014,Linlee,F,100,6,0,6
2014,Linna,F,100,6,0,6
2014,Linzee,F,100,6,0,6
2014,Linzi,F,100,6,0,6
2014,Lisabella,F,100,6,0,6
2014,Lisanna,F,100,6,0,6
2014,Lisbet,F,100,6,0,6
2014,Lisset,F,100,6,0,6
2014,Livan,M,100,0,6,6
2014,Liviya,F,100,6,0,6
2014,Lizy,F,100,6,0,6
2014,Loah,F,100,6,0,6
2014,Loch,M,100,0,6,6
2014,Locklin,M,100,0,6,6
2014,Locklynn,F,100,6,0,6
2014,Londell,M,100,0,6,6
2014,Loreina,F,100,6,0,6
2014,Loreta,F,100,6,0,6
2014,Loreyna,F,100,6,0,6
2014,Lorina,F,100,6,0,6
2014,Lorren,F,100,6,0,6
2014,Lorryn,F,100,6,0,6
2014,Louanna,F,100,6,0,6
2014,Luann,F,100,6,0,6
2014,Lubna,F,100,6,0,6
2014,Luisdaniel,M,100,0,6,6
2014,Luisenrique,M,100,0,6,6
2014,Luismario,M,100,0,6,6
2014,Lujayn,F,100,6,0,6
2014,Lumin,F,100,6,0,6
2014,Lumina,F,100,6,0,6
2014,Lusia,F,100,6,0,6
2014,Lylith,F,100,6,0,6
2014,Lylli,F,100,6,0,6
2014,Lyllia,F,100,6,0,6
2014,Lyndsi,F,100,6,0,6
2014,Lyndsie,F,100,6,0,6
2014,Lynken,M,100,0,6,6
2014,Lynnie,F,100,6,0,6
2014,Lynnsey,F,100,6,0,6
2014,Lynnzie,F,100,6,0,6
2014,Lynx,M,100,0,6,6
2014,Maali,F,100,6,0,6
2014,Maame,F,100,6,0,6
2014,Mabrie,F,100,6,0,6
2014,Macauley,M,100,0,6,6
2014,Maccoy,M,100,0,6,6
2014,Maciej,M,100,0,6,6
2014,Maciel,M,100,0,6,6
2014,Macintyre,M,100,0,6,6
2014,Mackai,M,100,0,6,6
2014,Mackenlee,F,100,6,0,6
2014,Macklan,M,100,0,6,6
2014,Macklyn,F,100,6,0,6
2014,Maclan,M,100,0,6,6
2014,Maclane,M,100,0,6,6
2014,Madailein,F,100,6,0,6
2014,Maddin,M,100,0,6,6
2014,Maddoc,M,100,0,6,6
2014,Madelein,F,100,6,0,6
2014,Madilee,F,100,6,0,6
2014,Madolynn,F,100,6,0,6
2014,Madonna,F,100,6,0,6
2014,Madrona,F,100,6,0,6
2014,Madysyn,F,100,6,0,6
2014,Maelah,F,100,6,0,6
2014,Maeryn,F,100,6,0,6
2014,Maesa,F,100,6,0,6
2014,Magdelene,F,100,6,0,6
2014,Mahaela,F,100,6,0,6
2014,Mahaila,F,100,6,0,6
2014,Mahamud,M,100,0,6,6
2014,Mahati,F,100,6,0,6
2014,Mahd,M,100,0,6,6
2014,Mahelet,F,100,6,0,6
2014,Mahia,F,100,6,0,6
2014,Mahiyah,F,100,6,0,6
2014,Mahjabeen,F,100,6,0,6
2014,Mahkayla,F,100,6,0,6
2014,Mahlani,F,100,6,0,6
2014,Maicie,F,100,6,0,6
2014,Maicy,F,100,6,0,6
2014,Maiden,F,100,6,0,6
2014,Mailei,F,100,6,0,6
2014,Maille,F,100,6,0,6
2014,Mairely,F,100,6,0,6
2014,Mairi,F,100,6,0,6
2014,Mairim,F,100,6,0,6
2014,Mais,F,100,6,0,6
2014,Maize,F,100,6,0,6
2014,Majorie,F,100,6,0,6
2014,Makalya,F,100,6,0,6
2014,Makay,F,100,6,0,6
2014,Makbel,M,100,0,6,6
2014,Makenize,F,100,6,0,6
2014,Makenli,F,100,6,0,6
2014,Makenzii,F,100,6,0,6
2014,Makhari,M,100,0,6,6
2014,Makhayla,F,100,6,0,6
2014,Makih,M,100,0,6,6
2014,Makinze,F,100,6,0,6
2014,Makynze,F,100,6,0,6
2014,Malaila,F,100,6,0,6
2014,Malaja,F,100,6,0,6
2014,Malakiah,M,100,0,6,6
2014,Malaun,F,100,6,0,6
2014,Maleiyah,F,100,6,0,6
2014,Malikhi,M,100,0,6,6
2014,Malkiel,M,100,0,6,6
2014,Mallak,F,100,6,0,6
2014,Malu,F,100,6,0,6
2014,Malvina,F,100,6,0,6
2014,Mamady,M,100,0,6,6
2014,Mamediarra,F,100,6,0,6
2014,Maneh,F,100,6,0,6
2014,Manish,M,100,0,6,6
2014,Manmeet,F,100,6,0,6
2014,Manon,F,100,6,0,6
2014,Manson,M,100,0,6,6
2014,Maor,M,100,0,6,6
2014,Maraki,F,100,6,0,6
2014,Marbin,M,100,0,6,6
2014,Marcin,M,100,0,6,6
2014,Marcon,M,100,0,6,6
2014,Maretta,F,100,6,0,6
2014,Margarette,F,100,6,0,6
2014,Mariabella,F,100,6,0,6
2014,Mariacamila,F,100,6,0,6
2014,Mariacecilia,F,100,6,0,6
2014,Mariaeduarda,F,100,6,0,6
2014,Marialuiza,F,100,6,0,6
2014,Marialy,F,100,6,0,6
2014,Mariani,F,100,6,0,6
2014,Mariavictoria,F,100,6,0,6
2014,Mariea,F,100,6,0,6
2014,Marillany,F,100,6,0,6
2014,Marinda,F,100,6,0,6
2014,Mariona,F,100,6,0,6
2014,Marisabel,F,100,6,0,6
2014,Marithza,F,100,6,0,6
2014,Markeisha,F,100,6,0,6
2014,Markeya,F,100,6,0,6
2014,Marlan,M,100,0,6,6
2014,Marle,F,100,6,0,6
2014,Marleena,F,100,6,0,6
2014,Marliah,F,100,6,0,6
2014,Marquies,M,100,0,6,6
2014,Marquita,F,100,6,0,6
2014,Marsel,M,100,0,6,6
2014,Marson,M,100,0,6,6
2014,Martavius,M,100,0,6,6
2014,Marvins,M,100,0,6,6
2014,Marvis,M,100,0,6,6
2014,Maryfer,F,100,6,0,6
2014,Maryjean,F,100,6,0,6
2014,Maryjose,F,100,6,0,6
2014,Maryona,F,100,6,0,6
2014,Maryorie,F,100,6,0,6
2014,Masaki,M,100,0,6,6
2014,Matalie,F,100,6,0,6
2014,Mateya,F,100,6,0,6
2014,Mati,M,100,0,6,6
2014,Mato,M,100,0,6,6
2014,Matrim,M,100,0,6,6
2014,Mats,M,100,0,6,6
2014,Mattson,M,100,0,6,6
2014,Maximilano,M,100,0,6,6
2014,Maximum,M,100,0,6,6
2014,Maxsim,M,100,0,6,6
2014,Maxus,M,100,0,6,6
2014,Maxxton,M,100,0,6,6
2014,Mayhem,M,100,0,6,6
2014,Mayim,F,100,6,0,6
2014,Maylan,F,100,6,0,6
2014,Maylasia,F,100,6,0,6
2014,Mayren,F,100,6,0,6
2014,Mayukha,F,100,6,0,6
2014,Mcclane,M,100,0,6,6
2014,Mckaela,F,100,6,0,6
2014,Mckinnon,M,100,0,6,6
2014,Mckinzi,F,100,6,0,6
2014,Mehran,M,100,0,6,6
2014,Meilany,F,100,6,0,6
2014,Meily,F,100,6,0,6
2014,Meital,F,100,6,0,6
2014,Meiyi,F,100,6,0,6
2014,Mekel,M,100,0,6,6
2014,Melchor,M,100,0,6,6
2014,Melech,M,100,0,6,6
2014,Meleena,F,100,6,0,6
2014,Melih,M,100,0,6,6
2014,Melik,M,100,0,6,6
2014,Meliza,F,100,6,0,6
2014,Melodyrose,F,100,6,0,6
2014,Melora,F,100,6,0,6
2014,Menachemmendel,M,100,0,6,6
2014,Mercury,M,100,0,6,6
2014,Meritt,F,100,6,0,6
2014,Merliah,F,100,6,0,6
2014,Merric,M,100,0,6,6
2014,Merrit,F,100,6,0,6
2014,Meshulem,M,100,0,6,6
2014,Messiyah,M,100,0,6,6
2014,Metzli,F,100,6,0,6
2014,Mialyn,F,100,6,0,6
2014,Miamore,F,100,6,0,6
2014,Miari,F,100,6,0,6
2014,Miaya,F,100,6,0,6
2014,Mical,F,100,6,0,6
2014,Michaelgabriel,M,100,0,6,6
2014,Micky,M,100,0,6,6
2014,Migel,M,100,0,6,6
2014,Mihajlo,M,100,0,6,6
2014,Mihit,M,100,0,6,6
2014,Mikayel,M,100,0,6,6
2014,Mikias,M,100,0,6,6
2014,Milenka,F,100,6,0,6
2014,Mileyah,F,100,6,0,6
2014,Minor,M,100,0,6,6
2014,Mionna,F,100,6,0,6
2014,Miori,F,100,6,0,6
2014,Mirae,F,100,6,0,6
2014,Mirayah,F,100,6,0,6
2014,Mirela,F,100,6,0,6
2014,Miriana,F,100,6,0,6
2014,Mirola,F,100,6,0,6
2014,Mishayla,F,100,6,0,6
2014,Mitchelle,F,100,6,0,6
2014,Miu,F,100,6,0,6
2014,Miyako,F,100,6,0,6
2014,Moaaz,M,100,0,6,6
2014,Mohmmed,M,100,0,6,6
2014,Mohnish,M,100,0,6,6
2014,Moise,M,100,0,6,6
2014,Mone,F,100,6,0,6
2014,Monserratt,F,100,6,0,6
2014,Morad,M,100,0,6,6
2014,Mordcha,M,100,0,6,6
2014,Morgane,F,100,6,0,6
2014,Morgynn,F,100,6,0,6
2014,Morocco,M,100,0,6,6
2014,Morrighan,F,100,6,0,6
2014,Mosa,M,100,0,6,6
2014,Mosie,M,100,0,6,6
2014,Mosley,M,100,0,6,6
2014,Moxxi,F,100,6,0,6
2014,Moya,F,100,6,0,6
2014,Mubeen,M,100,0,6,6
2014,Mubina,F,100,6,0,6
2014,Mulki,F,100,6,0,6
2014,Mumtas,F,100,6,0,6
2014,Munachi,M,100,0,6,6
2014,Musfirah,F,100,6,0,6
2014,Muskaan,F,100,6,0,6
2014,Myalee,F,100,6,0,6
2014,Myani,F,100,6,0,6
2014,Myca,F,100,6,0,6
2014,Myionna,F,100,6,0,6
2014,Mykaila,F,100,6,0,6
2014,Mykenzi,F,100,6,0,6
2014,Mykira,F,100,6,0,6
2014,Mylania,F,100,6,0,6
2014,Mylasia,F,100,6,0,6
2014,Mylen,M,100,0,6,6
2014,Myley,F,100,6,0,6
2014,Myna,F,100,6,0,6
2014,Nabria,F,100,6,0,6
2014,Nadalee,F,100,6,0,6
2014,Nadirah,F,100,6,0,6
2014,Nadja,F,100,6,0,6
2014,Naethan,M,100,0,6,6
2014,Nafi,M,100,0,6,6
2014,Nafis,M,100,0,6,6
2014,Nagisa,F,100,6,0,6
2014,Nahiara,F,100,6,0,6
2014,Nahim,M,100,0,6,6
2014,Nahiomy,F,100,6,0,6
2014,Nahmir,M,100,0,6,6
2014,Nahyeli,F,100,6,0,6
2014,Naihla,F,100,6,0,6
2014,Naileah,F,100,6,0,6
2014,Naithen,M,100,0,6,6
2014,Naiyeli,F,100,6,0,6
2014,Nakeya,F,100,6,0,6
2014,Nakye,M,100,0,6,6
2014,Nalan,M,100,0,6,6
2014,Nalana,F,100,6,0,6
2014,Naleigha,F,100,6,0,6
2014,Naliya,F,100,6,0,6
2014,Nalleli,F,100,6,0,6
2014,Namish,M,100,0,6,6
2014,Nandita,F,100,6,0,6
2014,Naphtali,M,100,0,6,6
2014,Narin,F,100,6,0,6
2014,Naryan,M,100,0,6,6
2014,Nashaly,F,100,6,0,6
2014,Nasia,F,100,6,0,6
2014,Nastasia,F,100,6,0,6
2014,Natahlia,F,100,6,0,6
2014,Natalierose,F,100,6,0,6
2014,Natas,M,100,0,6,6
2014,Natavia,F,100,6,0,6
2014,Nathalee,F,100,6,0,6
2014,Natiley,F,100,6,0,6
2014,Natilie,F,100,6,0,6
2014,Nattalie,F,100,6,0,6
2014,Naveena,F,100,6,0,6
2014,Navreet,F,100,6,0,6
2014,Nayelee,F,100,6,0,6
2014,Naymar,M,100,0,6,6
2014,Nazia,F,100,6,0,6
2014,Neamiah,M,100,0,6,6
2014,Nechuma,F,100,6,0,6
2014,Neeah,F,100,6,0,6
2014,Neer,M,100,0,6,6
2014,Neeya,F,100,6,0,6
2014,Neily,F,100,6,0,6
2014,Neimar,M,100,0,6,6
2014,Nelah,F,100,6,0,6
2014,Nely,F,100,6,0,6
2014,Nemo,M,100,0,6,6
2014,Neon,M,100,0,6,6
2014,Nerea,F,100,6,0,6
2014,Neria,F,100,6,0,6
2014,Nevelyn,F,100,6,0,6
2014,Nevo,M,100,0,6,6
2014,Neylan,M,100,0,6,6
2014,Neylin,F,100,6,0,6
2014,Nghi,F,100,6,0,6
2014,Nguyen,M,100,0,6,6
2014,Niala,F,100,6,0,6
2014,Nichol,F,100,6,0,6
2014,Nicholaus,M,100,0,6,6
2014,Nickan,M,100,0,6,6
2014,Nicson,M,100,0,6,6
2014,Niel,M,100,0,6,6
2014,Nieve,F,100,6,0,6
2014,Niha,F,100,6,0,6
2014,Nihar,M,100,0,6,6
2014,Nii,M,100,0,6,6
2014,Nija,F,100,6,0,6
2014,Nijae,F,100,6,0,6
2014,Nijay,M,100,0,6,6
2014,Nikan,M,100,0,6,6
2014,Nike,M,100,0,6,6
2014,Nikholas,M,100,0,6,6
2014,Nikolaj,M,100,0,6,6
2014,Nil,F,100,6,0,6
2014,Nilani,F,100,6,0,6
2014,Nimai,M,100,0,6,6
2014,Nimco,F,100,6,0,6
2014,Niobe,F,100,6,0,6
2014,Nirali,F,100,6,0,6
2014,Niranjan,M,100,0,6,6
2014,Nishal,M,100,0,6,6
2014,Nishma,F,100,6,0,6
2014,Nitika,F,100,6,0,6
2014,Niven,M,100,0,6,6
2014,Niyahlee,F,100,6,0,6
2014,Noga,F,100,6,0,6
2014,Norabelle,F,100,6,0,6
2014,Norelle,F,100,6,0,6
2014,Noriko,F,100,6,0,6
2014,Nouh,M,100,0,6,6
2014,Novali,F,100,6,0,6
2014,Noya,F,100,6,0,6
2014,Nubaid,M,100,0,6,6
2014,Nube,F,100,6,0,6
2014,Nuchem,M,100,0,6,6
2014,Nurto,F,100,6,0,6
2014,Nyasiah,F,100,6,0,6
2014,Nyeemah,F,100,6,0,6
2014,Nyel,M,100,0,6,6
2014,Nyela,F,100,6,0,6
2014,Nyheim,M,100,0,6,6
2014,Nyiah,F,100,6,0,6
2014,Nyimah,F,100,6,0,6
2014,Nyko,M,100,0,6,6
2014,Nylani,F,100,6,0,6
2014,Nylasia,F,100,6,0,6
2014,Nylea,F,100,6,0,6
2014,Nyron,M,100,0,6,6
2014,Obiora,M,100,0,6,6
2014,Okalani,F,100,6,0,6
2014,Olani,F,100,6,0,6
2014,Olawale,M,100,0,6,6
2014,Olimpia,F,100,6,0,6
2014,Oliverio,M,100,0,6,6
2014,Olivine,F,100,6,0,6
2014,Ollivander,M,100,0,6,6
2014,Oluchi,F,100,6,0,6
2014,Olumide,M,100,0,6,6
2014,Oluwadamilare,M,100,0,6,6
2014,Oluwafunmilayo,F,100,6,0,6
2014,Oluwaseyi,M,100,0,6,6
2014,Oluwaseyifunmi,F,100,6,0,6
2014,Oluwatosin,M,100,0,6,6
2014,Olyn,M,100,0,6,6
2014,Olyve,F,100,6,0,6
2014,Omarii,M,100,0,6,6
2014,Omni,F,100,6,0,6
2014,Onyinyechukwu,F,100,6,0,6
2014,Oria,F,100,6,0,6
2014,Oriya,F,100,6,0,6
2014,Oryon,M,100,0,6,6
2014,Osborne,M,100,0,6,6
2014,Osmara,F,100,6,0,6
2014,Osric,M,100,0,6,6
2014,Ossian,M,100,0,6,6
2014,Osten,M,100,0,6,6
2014,Ottavio,M,100,0,6,6
2014,Ottilia,F,100,6,0,6
2014,Oumy,F,100,6,0,6
2014,Ovie,M,100,0,6,6
2014,Owenn,M,100,0,6,6
2014,Oyinkansola,F,100,6,0,6
2014,Palak,F,100,6,0,6
2014,Pamella,F,100,6,0,6
2014,Paras,M,100,0,6,6
2014,Pareesa,F,100,6,0,6
2014,Paridhi,F,100,6,0,6
2014,Parina,F,100,6,0,6
2014,Parisha,F,100,6,0,6
2014,Parizoda,F,100,6,0,6
2014,Parmida,F,100,6,0,6
2014,Parnell,M,100,0,6,6
2014,Pasleigh,F,100,6,0,6
2014,Patrisha,F,100,6,0,6
2014,Pauleth,F,100,6,0,6
2014,Pavan,M,100,0,6,6
2014,Payeton,F,100,6,0,6
2014,Paylen,F,100,6,0,6
2014,Payshance,F,100,6,0,6
2014,Paysleigh,F,100,6,0,6
2014,Paytience,F,100,6,0,6
2014,Peighten,F,100,6,0,6
2014,Peneloperose,F,100,6,0,6
2014,Penrose,F,100,6,0,6
2014,Peregrin,M,100,0,6,6
2014,Perpetua,F,100,6,0,6
2014,Perrie,F,100,6,0,6
2014,Persaeus,F,100,6,0,6
2014,Persayus,F,100,6,0,6
2014,Pfeiffer,F,100,6,0,6
2014,Pharell,M,100,0,6,6
2014,Phenyx,F,100,6,0,6
2014,Philipe,M,100,0,6,6
2014,Phillipa,F,100,6,0,6
2014,Phinneas,M,100,0,6,6
2014,Phylicia,F,100,6,0,6
2014,Phynix,F,100,6,0,6
2014,Pier,M,100,0,6,6
2014,Piyush,M,100,0,6,6
2014,Polo,M,100,0,6,6
2014,Porscha,F,100,6,0,6
2014,Prabhjot,M,100,0,6,6
2014,Pradyun,M,100,0,6,6
2014,Pranisha,F,100,6,0,6
2014,Pranshi,F,100,6,0,6
2014,Prarthana,F,100,6,0,6
2014,Prayas,M,100,0,6,6
2014,Pride,M,100,0,6,6
2014,Princessa,F,100,6,0,6
2014,Priyana,F,100,6,0,6
2014,Priyansh,M,100,0,6,6
2014,Promyce,F,100,6,0,6
2014,Prue,F,100,6,0,6
2014,Prynceton,M,100,0,6,6
2014,Puneet,F,100,6,0,6
2014,Purav,M,100,0,6,6
2014,Purvi,F,100,6,0,6
2014,Qadira,F,100,6,0,6
2014,Quantavius,M,100,0,6,6
2014,Quantrell,M,100,0,6,6
2014,Quavion,M,100,0,6,6
2014,Quianna,F,100,6,0,6
2014,Quindarius,M,100,0,6,6
2014,Quinterius,M,100,0,6,6
2014,Quyen,F,100,6,0,6
2014,Raad,M,100,0,6,6
2014,Raahim,M,100,0,6,6
2014,Rachid,M,100,0,6,6
2014,Rada,F,100,6,0,6
2014,Radly,M,100,0,6,6
2014,Raeyah,F,100,6,0,6
2014,Rafiel,M,100,0,6,6
2014,Raidel,M,100,0,6,6
2014,Raksha,F,100,6,0,6
2014,Raliyah,F,100,6,0,6
2014,Rameir,M,100,0,6,6
2014,Ramelo,M,100,0,6,6
2014,Ramia,F,100,6,0,6
2014,Ramira,F,100,6,0,6
2014,Ranyiah,F,100,6,0,6
2014,Rashida,F,100,6,0,6
2014,Rashun,M,100,0,6,6
2014,Rauri,F,100,6,0,6
2014,Ravleen,F,100,6,0,6
2014,Raxton,M,100,0,6,6
2014,Rayella,F,100,6,0,6
2014,Rayona,F,100,6,0,6
2014,Rayshad,M,100,0,6,6
2014,Rayvin,F,100,6,0,6
2014,Raza,M,100,0,6,6
2014,Reagann,F,100,6,0,6
2014,Rebeckah,F,100,6,0,6
2014,Recardo,M,100,0,6,6
2014,Rece,M,100,0,6,6
2014,Rechy,F,100,6,0,6
2014,Reddington,M,100,0,6,6
2014,Reesa,F,100,6,0,6
2014,Reginna,F,100,6,0,6
2014,Regino,M,100,0,6,6
2014,Rehana,F,100,6,0,6
2014,Reiko,F,100,6,0,6
2014,Reiss,M,100,0,6,6
2014,Remee,F,100,6,0,6
2014,Remigio,M,100,0,6,6
2014,Remingtyn,F,100,6,0,6
2014,Remiyah,F,100,6,0,6
2014,Renat,M,100,0,6,6
2014,Renatha,F,100,6,0,6
2014,Renji,M,100,0,6,6
2014,Renleigh,F,100,6,0,6
2014,Rennie,F,100,6,0,6
2014,Reshaun,M,100,0,6,6
2014,Reyad,M,100,0,6,6
2014,Reylan,M,100,0,6,6
2014,Rhaelyn,F,100,6,0,6
2014,Rhiana,F,100,6,0,6
2014,Rhianne,F,100,6,0,6
2014,Rhonin,M,100,0,6,6
2014,Rhydian,M,100,0,6,6
2014,Ridhwan,M,100,0,6,6
2014,Rigg,M,100,0,6,6
2014,Rikardo,M,100,0,6,6
2014,Riland,M,100,0,6,6
2014,Rim,F,100,6,0,6
2014,Rinah,F,100,6,0,6
2014,Rinnah,F,100,6,0,6
2014,Rinyah,F,100,6,0,6
2014,Riott,M,100,0,6,6
2014,Rishard,M,100,0,6,6
2014,Ritage,F,100,6,0,6
2014,Ritesh,M,100,0,6,6
2014,Riylee,F,100,6,0,6
2014,Roane,M,100,0,6,6
2014,Rocsi,F,100,6,0,6
2014,Roe,F,100,6,0,6
2014,Rohn,M,100,0,6,6
2014,Rohnan,M,100,0,6,6
2014,Rokhaya,F,100,6,0,6
2014,Rokia,F,100,6,0,6
2014,Romain,M,100,0,6,6
2014,Romani,M,100,0,6,6
2014,Romari,M,100,0,6,6
2014,Romelle,M,100,0,6,6
2014,Ronaldinho,M,100,0,6,6
2014,Roniel,M,100,0,6,6
2014,Ronya,F,100,6,0,6
2014,Rorey,F,100,6,0,6
2014,Rorke,M,100,0,6,6
2014,Rosalio,M,100,0,6,6
2014,Roseleen,F,100,6,0,6
2014,Roselena,F,100,6,0,6
2014,Roselia,F,100,6,0,6
2014,Roselina,F,100,6,0,6
2014,Rosilee,F,100,6,0,6
2014,Roston,M,100,0,6,6
2014,Rownan,M,100,0,6,6
2014,Roxxi,F,100,6,0,6
2014,Rubens,M,100,0,6,6
2014,Rueger,M,100,0,6,6
2014,Rukaya,F,100,6,0,6
2014,Rumor,F,100,6,0,6
2014,Ruperto,M,100,0,6,6
2014,Ruqaiya,F,100,6,0,6
2014,Rushi,M,100,0,6,6
2014,Rushton,M,100,0,6,6
2014,Rutherford,M,100,0,6,6
2014,Ruwaida,F,100,6,0,6
2014,Ryasia,F,100,6,0,6
2014,Ryeland,M,100,0,6,6
2014,Ryelin,M,100,0,6,6
2014,Ryin,F,100,6,0,6
2014,Ryott,M,100,0,6,6
2014,Sabel,F,100,6,0,6
2014,Sabree,F,100,6,0,6
2014,Sabrine,F,100,6,0,6
2014,Sadeen,F,100,6,0,6
2014,Sadik,M,100,0,6,6
2014,Sadrac,M,100,0,6,6
2014,Safeer,M,100,0,6,6
2014,Safiatou,F,100,6,0,6
2014,Sahal,M,100,0,6,6
2014,Sahibjot,M,100,0,6,6
2014,Sahl,M,100,0,6,6
2014,Saidey,F,100,6,0,6
2014,Saidie,F,100,6,0,6
2014,Sairy,F,100,6,0,6
2014,Sajda,F,100,6,0,6
2014,Sakai,M,100,0,6,6
2014,Sakiya,F,100,6,0,6
2014,Sakiyah,F,100,6,0,6
2014,Sakshi,F,100,6,0,6
2014,Salar,M,100,0,6,6
2014,Samaia,F,100,6,0,6
2014,Samaiah,F,100,6,0,6
2014,Samanthanicole,F,100,6,0,6
2014,Samanvita,F,100,6,0,6
2014,Samanvitha,F,100,6,0,6
2014,Samayra,F,100,6,0,6
2014,Samit,M,100,0,6,6
2014,Sanaia,F,100,6,0,6
2014,Sandrine,F,100,6,0,6
2014,Sannidhi,F,100,6,0,6
2014,Sanoe,F,100,6,0,6
2014,Santa,F,100,6,0,6
2014,Saory,F,100,6,0,6
2014,Sapphyre,F,100,6,0,6
2014,Saran,F,100,6,0,6
2014,Saraye,F,100,6,0,6
2014,Sardor,M,100,0,6,6
2014,Sare,F,100,6,0,6
2014,Sariana,F,100,6,0,6
2014,Sarrah,F,100,6,0,6
2014,Sarynity,F,100,6,0,6
2014,Sathvika,F,100,6,0,6
2014,Satvika,F,100,6,0,6
2014,Saurav,M,100,0,6,6
2014,Sava,M,100,0,6,6
2014,Savar,M,100,0,6,6
2014,Saveer,M,100,0,6,6
2014,Saviour,M,100,0,6,6
2014,Savyon,M,100,0,6,6
2014,Sayeed,M,100,0,6,6
2014,Sayf,M,100,0,6,6
2014,Schaeffer,M,100,0,6,6
2014,Schylar,F,100,6,0,6
2014,Seanmichael,M,100,0,6,6
2014,Season,F,100,6,0,6
2014,Sedra,F,100,6,0,6
2014,Seerit,F,100,6,0,6
2014,Sejla,F,100,6,0,6
2014,Selam,F,100,6,0,6
2014,Sem,M,100,0,6,6
2014,Semaja,F,100,6,0,6
2014,Semaya,F,100,6,0,6
2014,Semhar,F,100,6,0,6
2014,Semya,F,100,6,0,6
2014,Semyon,M,100,0,6,6
2014,Senia,F,100,6,0,6
2014,Seniyah,F,100,6,0,6
2014,Senya,F,100,6,0,6
2014,Sequoyah,F,100,6,0,6
2014,Serai,F,100,6,0,6
2014,Seraiah,F,100,6,0,6
2014,Serayah,F,100,6,0,6
2014,Serenityrose,F,100,6,0,6
2014,Sergi,M,100,0,6,6
2014,Serigne,M,100,0,6,6
2014,Seriya,F,100,6,0,6
2014,Sevara,F,100,6,0,6
2014,Severiano,M,100,0,6,6
2014,Sevon,M,100,0,6,6
2014,Seyon,M,100,0,6,6
2014,Shadan,F,100,6,0,6
2014,Shagun,F,100,6,0,6
2014,Shahir,M,100,0,6,6
2014,Shaianne,F,100,6,0,6
2014,Shaily,F,100,6,0,6
2014,Shaivi,F,100,6,0,6
2014,Shakthi,F,100,6,0,6
2014,Shakti,F,100,6,0,6
2014,Shalayah,F,100,6,0,6
2014,Shalee,F,100,6,0,6
2014,Shamara,F,100,6,0,6
2014,Shamarr,M,100,0,6,6
2014,Shamiracle,F,100,6,0,6
2014,Shammah,M,100,0,6,6
2014,Shamyah,F,100,6,0,6
2014,Shanda,F,100,6,0,6
2014,Shanese,F,100,6,0,6
2014,Shanon,F,100,6,0,6
2014,Shanty,F,100,6,0,6
2014,Sharae,F,100,6,0,6
2014,Sharaya,F,100,6,0,6
2014,Sharvani,F,100,6,0,6
2014,Shashwat,M,100,0,6,6
2014,Shatavia,F,100,6,0,6
2014,Shawntez,M,100,0,6,6
2014,Shehab,M,100,0,6,6
2014,Shelbee,F,100,6,0,6
2014,Shelden,M,100,0,6,6
2014,Shelsy,F,100,6,0,6
2014,Shenaya,F,100,6,0,6
2014,Shenelle,F,100,6,0,6
2014,Sherod,M,100,0,6,6
2014,Sherrie,F,100,6,0,6
2014,Shianna,F,100,6,0,6
2014,Shihab,M,100,0,6,6
2014,Shimshon,M,100,0,6,6
2014,Shivanshi,F,100,6,0,6
2014,Shohjahon,M,100,0,6,6
2014,Shray,M,100,0,6,6
2014,Shreyaan,M,100,0,6,6
2014,Shreyash,M,100,0,6,6
2014,Shrika,F,100,6,0,6
2014,Shyana,F,100,6,0,6
2014,Shylin,F,100,6,0,6
2014,Shyna,F,100,6,0,6
2014,Sibella,F,100,6,0,6
2014,Sicilee,F,100,6,0,6
2014,Siddanth,M,100,0,6,6
2014,Siddh,M,100,0,6,6
2014,Siddiq,M,100,0,6,6
2014,Sigourney,F,100,6,0,6
2014,Sihaam,F,100,6,0,6
2014,Silah,F,100,6,0,6
2014,Silja,F,100,6,0,6
2014,Simonne,F,100,6,0,6
2014,Sinaya,F,100,6,0,6
2014,Sira,F,100,6,0,6
2014,Sirine,F,100,6,0,6
2014,Sissi,F,100,6,0,6
2014,Skie,F,100,6,0,6
2014,Skip,M,100,0,6,6
2014,Skyanna,F,100,6,0,6
2014,Skyylar,F,100,6,0,6
2014,Sniyah,F,100,6,0,6
2014,Soffia,F,100,6,0,6
2014,Sofhia,F,100,6,0,6
2014,Sofiarose,F,100,6,0,6
2014,Solae,F,100,6,0,6
2014,Solenne,F,100,6,0,6
2014,Soli,F,100,6,0,6
2014,Soliman,M,100,0,6,6
2014,Solina,F,100,6,0,6
2014,Solon,M,100,0,6,6
2014,Solstice,F,100,6,0,6
2014,Somi,F,100,6,0,6
2014,Sondos,F,100,6,0,6
2014,Sonni,F,100,6,0,6
2014,Sonoma,F,100,6,0,6
2014,Sookie,F,100,6,0,6
2014,Sophira,F,100,6,0,6
2014,Sophyia,F,100,6,0,6
2014,Sorcha,F,100,6,0,6
2014,Sorren,M,100,0,6,6
2014,Sota,M,100,0,6,6
2014,Soumya,F,100,6,0,6
2014,Spruha,F,100,6,0,6
2014,Srihaas,M,100,0,6,6
2014,Srijan,M,100,0,6,6
2014,Srikrishna,M,100,0,6,6
2014,Srilakshmi,F,100,6,0,6
2014,Srivatsa,M,100,0,6,6
2014,Srushti,F,100,6,0,6
2014,Stallone,M,100,0,6,6
2014,Starlee,F,100,6,0,6
2014,Starlene,F,100,6,0,6
2014,Starlit,F,100,6,0,6
2014,Steeler,M,100,0,6,6
2014,Stefanos,M,100,0,6,6
2014,Steffani,F,100,6,0,6
2014,Stellamae,F,100,6,0,6
2014,Stellina,F,100,6,0,6
2014,Storee,F,100,6,0,6
2014,Suah,F,100,6,0,6
2014,Sudays,M,100,0,6,6
2014,Sufia,F,100,6,0,6
2014,Suhaas,M,100,0,6,6
2014,Suhan,M,100,0,6,6
2014,Suhanth,M,100,0,6,6
2014,Sulamita,F,100,6,0,6
2014,Sundae,F,100,6,0,6
2014,Surafel,M,100,0,6,6
2014,Susej,F,100,6,0,6
2014,Sutten,F,100,6,0,6
2014,Suvan,M,100,0,6,6
2014,Suveer,M,100,0,6,6
2014,Suvir,M,100,0,6,6
2014,Suzan,F,100,6,0,6
2014,Svana,F,100,6,0,6
2014,Sweden,F,100,6,0,6
2014,Syia,F,100,6,0,6
2014,Syleena,F,100,6,0,6
2014,Sylias,M,100,0,6,6
2014,Sylvanna,F,100,6,0,6
2014,Sylvanus,M,100,0,6,6
2014,Sylys,M,100,0,6,6
2014,Symphanie,F,100,6,0,6
2014,Syna,F,100,6,0,6
2014,Synnove,F,100,6,0,6
2014,Syrah,F,100,6,0,6
2014,Syrina,F,100,6,0,6
2014,Taahir,M,100,0,6,6
2014,Tadarius,M,100,0,6,6
2014,Tagen,M,100,0,6,6
2014,Tahliyah,F,100,6,0,6
2014,Taivon,M,100,0,6,6
2014,Taiwan,M,100,0,6,6
2014,Taizlee,F,100,6,0,6
2014,Taksh,M,100,0,6,6
2014,Takuma,M,100,0,6,6
2014,Talaiya,F,100,6,0,6
2014,Talani,F,100,6,0,6
2014,Talayiah,F,100,6,0,6
2014,Taleia,F,100,6,0,6
2014,Taleiah,F,100,6,0,6
2014,Taleiyah,F,100,6,0,6
2014,Talicia,F,100,6,0,6
2014,Talis,M,100,0,6,6
2014,Talley,F,100,6,0,6
2014,Tallie,F,100,6,0,6
2014,Tallis,F,100,6,0,6
2014,Talus,M,100,0,6,6
2014,Talyia,F,100,6,0,6
2014,Tamanna,F,100,6,0,6
2014,Tamilore,F,100,6,0,6
2014,Tamirah,F,100,6,0,6
2014,Tammie,F,100,6,0,6
2014,Tamzyn,F,100,6,0,6
2014,Tanairy,F,100,6,0,6
2014,Tanijah,F,100,6,0,6
2014,Tank,M,100,0,6,6
2014,Taos,M,100,0,6,6
2014,Tareq,M,100,0,6,6
2014,Tashara,F,100,6,0,6
2014,Tashon,M,100,0,6,6
2014,Tashya,F,100,6,0,6
2014,Tavarion,M,100,0,6,6
2014,Tavarius,M,100,0,6,6
2014,Tavionna,F,100,6,0,6
2014,Taycee,F,100,6,0,6
2014,Taycen,M,100,0,6,6
2014,Taydem,F,100,6,0,6
2014,Tayley,F,100,6,0,6
2014,Taylorrae,F,100,6,0,6
2014,Tayma,F,100,6,0,6
2014,Tayseer,M,100,0,6,6
2014,Tayva,F,100,6,0,6
2014,Tayvien,M,100,0,6,6
2014,Teagin,F,100,6,0,6
2014,Teaira,F,100,6,0,6
2014,Tearra,F,100,6,0,6
2014,Teddie,M,100,0,6,6
2014,Teleah,F,100,6,0,6
2014,Teliyah,F,100,6,0,6
2014,Temujin,M,100,0,6,6
2014,Tenaj,F,100,6,0,6
2014,Tennison,M,100,0,6,6
2014,Tenor,M,100,0,6,6
2014,Tenuun,M,100,0,6,6
2014,Teoman,M,100,0,6,6
2014,Terianna,F,100,6,0,6
2014,Terrionna,F,100,6,0,6
2014,Terryion,M,100,0,6,6
2014,Tesa,F,100,6,0,6
2014,Teslyn,F,100,6,0,6
2014,Tessalyn,F,100,6,0,6
2014,Tessla,F,100,6,0,6
2014,Tesslynn,F,100,6,0,6
2014,Tevyn,M,100,0,6,6
2014,Teylor,F,100,6,0,6
2014,Teyo,M,100,0,6,6
2014,Thackery,M,100,0,6,6
2014,Thadius,M,100,0,6,6
2014,Thailyn,F,100,6,0,6
2014,Thales,M,100,0,6,6
2014,Thandiwe,F,100,6,0,6
2014,Thaxton,M,100,0,6,6
2014,Thiara,F,100,6,0,6
2014,Thinh,M,100,0,6,6
2014,Thorn,M,100,0,6,6
2014,Thyago,M,100,0,6,6
2014,Tiani,F,100,6,0,6
2014,Tiarrah,F,100,6,0,6
2014,Tice,M,100,0,6,6
2014,Tifeoluwa,M,100,0,6,6
2014,Till,M,100,0,6,6
2014,Tilman,M,100,0,6,6
2014,Tilton,M,100,0,6,6
2014,Timara,F,100,6,0,6
2014,Timaya,F,100,6,0,6
2014,Timberlyn,F,100,6,0,6
2014,Timea,F,100,6,0,6
2014,Timera,F,100,6,0,6
2014,Tinsleigh,F,100,6,0,6
2014,Tion,M,100,0,6,6
2014,Tira,F,100,6,0,6
2014,Tirenioluwa,F,100,6,0,6
2014,Tirrell,M,100,0,6,6
2014,Tiyon,M,100,0,6,6
2014,Tlalli,F,100,6,0,6
2014,Tobechukwu,M,100,0,6,6
2014,Toben,M,100,0,6,6
2014,Tobiloba,M,100,0,6,6
2014,Tod,M,100,0,6,6
2014,Toltu,F,100,6,0,6
2014,Toniya,F,100,6,0,6
2014,Toriann,F,100,6,0,6
2014,Torianna,F,100,6,0,6
2014,Toriano,M,100,0,6,6
2014,Toribio,M,100,0,6,6
2014,Torrion,M,100,0,6,6
2014,Torstein,M,100,0,6,6
2014,Torunn,F,100,6,0,6
2014,Toure,M,100,0,6,6
2014,Tracyn,M,100,0,6,6
2014,Tran,F,100,6,0,6
2014,Trask,M,100,0,6,6
2014,Trayon,M,100,0,6,6
2014,Tremell,M,100,0,6,6
2014,Trenden,M,100,0,6,6
2014,Treniya,F,100,6,0,6
2014,Trennen,M,100,0,6,6
2014,Tresean,M,100,0,6,6
2014,Tressie,F,100,6,0,6
2014,Tresten,M,100,0,6,6
2014,Trevaughn,M,100,0,6,6
2014,Trevelle,M,100,0,6,6
2014,Treysean,M,100,0,6,6
2014,Treyvin,M,100,0,6,6
2014,Tripper,M,100,0,6,6
2014,Troi,F,100,6,0,6
2014,Trulie,F,100,6,0,6
2014,Trypp,M,100,0,6,6
2014,Tukker,M,100,0,6,6
2014,Tulio,M,100,0,6,6
2014,Tullia,F,100,6,0,6
2014,Tyair,M,100,0,6,6
2014,Tyjon,M,100,0,6,6
2014,Tylea,F,100,6,0,6
2014,Tyleek,M,100,0,6,6
2014,Tylerjames,M,100,0,6,6
2014,Tymeir,M,100,0,6,6
2014,Tymira,F,100,6,0,6
2014,Tynsley,F,100,6,0,6
2014,Tyrael,M,100,0,6,6
2014,Tyriek,M,100,0,6,6
2014,Tyrik,M,100,0,6,6
2014,Tyronne,M,100,0,6,6
2014,Tywone,M,100,0,6,6
2014,Tzivi,F,100,6,0,6
2014,Ubah,F,100,6,0,6
2014,Umaira,F,100,6,0,6
2014,Umi,F,100,6,0,6
2014,Urbano,M,100,0,6,6
2014,Uvaldo,M,100,0,6,6
2014,Vahin,M,100,0,6,6
2014,Vaiden,M,100,0,6,6
2014,Vail,F,100,6,0,6
2014,Vaishali,F,100,6,0,6
2014,Valiyah,F,100,6,0,6
2014,Vallory,F,100,6,0,6
2014,Vanaya,F,100,6,0,6
2014,Vanelope,F,100,6,0,6
2014,Vaniya,F,100,6,0,6
2014,Vannesa,F,100,6,0,6
2014,Vannia,F,100,6,0,6
2014,Varad,M,100,0,6,6
2014,Varen,M,100,0,6,6
2014,Vasco,M,100,0,6,6
2014,Vasili,M,100,0,6,6
2014,Vassilios,M,100,0,6,6
2014,Vaya,F,100,6,0,6
2014,Vedat,M,100,0,6,6
2014,Venancio,M,100,0,6,6
2014,Venellope,F,100,6,0,6
2014,Venya,F,100,6,0,6
2014,Vernell,M,100,0,6,6
2014,Vesta,F,100,6,0,6
2014,Vianne,F,100,6,0,6
2014,Vick,M,100,0,6,6
2014,Victoire,F,100,6,0,6
2014,Victorino,M,100,0,6,6
2014,Vidyut,M,100,0,6,6
2014,Vidyuth,M,100,0,6,6
2014,Vihaa,F,100,6,0,6
2014,Vihaanreddy,M,100,0,6,6
2014,Vihas,M,100,0,6,6
2014,Viktorya,F,100,6,0,6
2014,Vinzent,M,100,0,6,6
2014,Virgilio,M,100,0,6,6
2014,Vitaliy,M,100,0,6,6
2014,Vivika,F,100,6,0,6
2014,Vlada,F,100,6,0,6
2014,Vontrell,M,100,0,6,6
2014,Vyaan,M,100,0,6,6
2014,Vyanna,F,100,6,0,6
2014,Vylet,F,100,6,0,6
2014,Vyolette,F,100,6,0,6
2014,Vyvian,F,100,6,0,6
2014,Wajiha,F,100,6,0,6
2014,Wake,M,100,0,6,6
2014,Wasif,M,100,0,6,6
2014,Weiland,M,100,0,6,6
2014,Wensley,M,100,0,6,6
2014,Williamson,M,100,0,6,6
2014,Willo,F,100,6,0,6
2014,Win,F,100,6,0,6
2014,Winchester,M,100,0,6,6
2014,Winfred,M,100,0,6,6
2014,Winslet,F,100,6,0,6
2014,Wrett,M,100,0,6,6
2014,Wryder,M,100,0,6,6
2014,Wulfric,M,100,0,6,6
2014,Wyllow,F,100,6,0,6
2014,Wyndsor,F,100,6,0,6
2014,Xadyn,M,100,0,6,6
2014,Xaniya,F,100,6,0,6
2014,Xaniyah,F,100,6,0,6
2014,Xavianna,F,100,6,0,6
2014,Xayne,M,100,0,6,6
2014,Xi,F,100,6,0,6
2014,Xinran,F,100,6,0,6
2014,Xzavyer,M,100,0,6,6
2014,Yacoub,M,100,0,6,6
2014,Yadel,M,100,0,6,6
2014,Yaeli,F,100,6,0,6
2014,Yahweh,M,100,0,6,6
2014,Yale,M,100,0,6,6
2014,Yaleiza,F,100,6,0,6
2014,Yali,F,100,6,0,6
2014,Yamari,F,100,6,0,6
2014,Yameli,F,100,6,0,6
2014,Yaminah,F,100,6,0,6
2014,Yamira,F,100,6,0,6
2014,Yandell,M,100,0,6,6
2014,Yanelys,F,100,6,0,6
2014,Yanick,M,100,0,6,6
2014,Yanky,M,100,0,6,6
2014,Yaphet,M,100,0,6,6
2014,Yaqoob,M,100,0,6,6
2014,Yarelie,F,100,6,0,6
2014,Yarelin,F,100,6,0,6
2014,Yaresly,F,100,6,0,6
2014,Yarethzy,F,100,6,0,6
2014,Yarianny,F,100,6,0,6
2014,Yarieli,F,100,6,0,6
2014,Yarithza,F,100,6,0,6
2014,Yasaira,F,100,6,0,6
2014,Yashasvi,F,100,6,0,6
2014,Yashi,F,100,6,0,6
2014,Yasina,F,100,6,0,6
2014,Yasira,F,100,6,0,6
2014,Yassiel,M,100,0,6,6
2014,Yassmine,F,100,6,0,6
2014,Yaya,M,100,0,6,6
2014,Yehya,M,100,0,6,6
2014,Yeiri,F,100,6,0,6
2014,Yejun,M,100,0,6,6
2014,Yekaterina,F,100,6,0,6
2014,Yen,F,100,6,0,6
2014,Yensy,F,100,6,0,6
2014,Yeraldine,F,100,6,0,6
2014,Yeremi,M,100,0,6,6
2014,Yessi,F,100,6,0,6
2014,Yexalen,F,100,6,0,6
2014,Yhael,M,100,0,6,6
2014,Yianna,F,100,6,0,6
2014,Yilia,F,100,6,0,6
2014,Yilin,F,100,6,0,6
2014,Yinuo,M,100,0,6,6
2014,Yireh,F,100,6,0,6
2014,Yishai,M,100,0,6,6
2014,Yissochor,M,100,0,6,6
2014,Yiyi,F,100,6,0,6
2014,Ynez,F,100,6,0,6
2014,Yohance,M,100,0,6,6
2014,Yohandry,M,100,0,6,6
2014,Yohann,M,100,0,6,6
2014,Yorick,M,100,0,6,6
2014,Yosif,M,100,0,6,6
2014,Yosselyn,F,100,6,0,6
2014,Youcef,M,100,0,6,6
2014,Younus,M,100,0,6,6
2014,Yuda,M,100,0,6,6
2014,Yuji,M,100,0,6,6
2014,Yukiko,F,100,6,0,6
2014,Yulitza,F,100,6,0,6
2014,Yunior,M,100,0,6,6
2014,Yuriah,M,100,0,6,6
2014,Yuriko,F,100,6,0,6
2014,Yusei,M,100,0,6,6
2014,Yuvansh,M,100,0,6,6
2014,Yvelisse,F,100,6,0,6
2014,Yvianna,F,100,6,0,6
2014,Zabdi,F,100,6,0,6
2014,Zacaria,F,100,6,0,6
2014,Zadan,M,100,0,6,6
2014,Zadien,M,100,0,6,6
2014,Zaeda,F,100,6,0,6
2014,Zaelen,M,100,0,6,6
2014,Zaen,M,100,0,6,6
2014,Zahia,F,100,6,0,6
2014,Zahyir,M,100,0,6,6
2014,Zaiah,F,100,6,0,6
2014,Zainaldeen,M,100,0,6,6
2014,Zakara,F,100,6,0,6
2014,Zakarias,M,100,0,6,6
2014,Zakhari,M,100,0,6,6
2014,Zakria,M,100,0,6,6
2014,Zakye,M,100,0,6,6
2014,Zakyla,F,100,6,0,6
2014,Zaleyah,F,100,6,0,6
2014,Zali,F,100,6,0,6
2014,Zam,M,100,0,6,6
2014,Zamyia,F,100,6,0,6
2014,Zanariah,F,100,6,0,6
2014,Zandaya,F,100,6,0,6
2014,Zandyr,M,100,0,6,6
2014,Zaneta,F,100,6,0,6
2014,Zani,F,100,6,0,6
2014,Zanilah,F,100,6,0,6
2014,Zaphira,F,100,6,0,6
2014,Zareth,F,100,6,0,6
2014,Zavanna,F,100,6,0,6
2014,Zaviyar,M,100,0,6,6
2014,Zaylaa,F,100,6,0,6
2014,Zaylor,M,100,0,6,6
2014,Zayshawn,M,100,0,6,6
2014,Zeanna,F,100,6,0,6
2014,Zed,M,100,0,6,6
2014,Zeeva,F,100,6,0,6
2014,Zeik,M,100,0,6,6
2014,Zelma,F,100,6,0,6
2014,Zema,F,100,6,0,6
2014,Zera,F,100,6,0,6
2014,Zetta,F,100,6,0,6
2014,Zevin,M,100,0,6,6
2014,Zeya,F,100,6,0,6
2014,Zhaire,M,100,0,6,6
2014,Zhamir,M,100,0,6,6
2014,Zhanna,F,100,6,0,6
2014,Zhari,F,100,6,0,6
2014,Zhen,M,100,0,6,6
2014,Zirel,F,100,6,0,6
2014,Ziza,F,100,6,0,6
2014,Zniya,F,100,6,0,6
2014,Zniyah,F,100,6,0,6
2014,Zoeh,F,100,6,0,6
2014,Zoeie,F,100,6,0,6
2014,Zoeii,F,100,6,0,6
2014,Zoel,M,100,0,6,6
2014,Zolah,F,100,6,0,6
2014,Zolton,M,100,0,6,6
2014,Zonnique,F,100,6,0,6
2014,Zowii,F,100,6,0,6
2014,Zriyah,F,100,6,0,6
2014,Zubeyr,M,100,0,6,6
2014,Zuhayr,M,100,0,6,6
2014,Zuleima,F,100,6,0,6
2014,Zuriana,F,100,6,0,6
2014,Zuriela,F,100,6,0,6
2014,Zurina,F,100,6,0,6
2014,Zuriya,F,100,6,0,6
2014,Zyann,F,100,6,0,6
2014,Zyanne,F,100,6,0,6
2014,Zyien,M,100,0,6,6
2014,Zyking,M,100,0,6,6
2014,Zylin,M,100,0,6,6
2014,Zylis,M,100,0,6,6
2014,Zynique,F,100,6,0,6
2014,Zynovia,F,100,6,0,6
2014,Zyshawn,M,100,0,6,6
2014,Zyyon,M,100,0,6,6
2014,Aabriella,F,100,5,0,5
2014,Aadhi,M,100,0,5,5
2014,Aadian,M,100,0,5,5
2014,Aadiv,M,100,0,5,5
2014,Aadrika,F,100,5,0,5
2014,Aaiza,F,100,5,0,5
2014,Aalimah,F,100,5,0,5
2014,Aamer,M,100,0,5,5
2014,Aamilah,F,100,5,0,5
2014,Aamyah,F,100,5,0,5
2014,Aania,F,100,5,0,5
2014,Aaniylah,F,100,5,0,5
2014,Aarabella,F,100,5,0,5
2014,Aari,M,100,0,5,5
2014,Aarielle,F,100,5,0,5
2014,Aarit,M,100,0,5,5
2014,Aariyan,M,100,0,5,5
2014,Aaroh,M,100,0,5,5
2014,Aarohan,M,100,0,5,5
2014,Aarshi,F,100,5,0,5
2014,Aarti,F,100,5,0,5
2014,Aarvin,M,100,0,5,5
2014,Aaryah,F,100,5,0,5
2014,Aaser,M,100,0,5,5
2014,Aashirya,F,100,5,0,5
2014,Aashni,F,100,5,0,5
2014,Aavi,M,100,0,5,5
2014,Aavya,F,100,5,0,5
2014,Aavyan,M,100,0,5,5
2014,Aayam,M,100,0,5,5
2014,Aayra,F,100,5,0,5
2014,Aayusha,F,100,5,0,5
2014,Abaan,M,100,0,5,5
2014,Abad,M,100,0,5,5
2014,Abagael,F,100,5,0,5
2014,Abass,M,100,0,5,5
2014,Abbagale,F,100,5,0,5
2014,Abbee,F,100,5,0,5
2014,Abbeygail,F,100,5,0,5
2014,Abbigal,F,100,5,0,5
2014,Abdirahim,M,100,0,5,5
2014,Abdisamad,M,100,0,5,5
2014,Abdon,M,100,0,5,5
2014,Abdulai,M,100,0,5,5
2014,Abdulmajeed,M,100,0,5,5
2014,Abdulmajid,M,100,0,5,5
2014,Abdulmohsen,M,100,0,5,5
2014,Abdulsalam,M,100,0,5,5
2014,Abdurraheem,M,100,0,5,5
2014,Abednego,M,100,0,5,5
2014,Abelino,M,100,0,5,5
2014,Aben,M,100,0,5,5
2014,Abhigna,F,100,5,0,5
2014,Abhijit,M,100,0,5,5
2014,Abhinaya,F,100,5,0,5
2014,Abiezer,M,100,0,5,5
2014,Abisha,F,100,5,0,5
2014,Abiyah,M,100,0,5,5
2014,Abreanna,F,100,5,0,5
2014,Abreonna,F,100,5,0,5
2014,Abrienne,F,100,5,0,5
2014,Abrihet,F,100,5,0,5
2014,Abryanna,F,100,5,0,5
2014,Abubakarr,M,100,0,5,5
2014,Acasia,F,100,5,0,5
2014,Acer,M,100,0,5,5
2014,Acey,F,100,5,0,5
2014,Adal,M,100,0,5,5
2014,Adalicia,F,100,5,0,5
2014,Adallyn,F,100,5,0,5
2014,Adalye,F,100,5,0,5
2014,Adamarys,F,100,5,0,5
2014,Adbiel,M,100,0,5,5
2014,Addiline,F,100,5,0,5
2014,Addisun,F,100,5,0,5
2014,Addix,M,100,0,5,5
2014,Adein,M,100,0,5,5
2014,Adelade,F,100,5,0,5
2014,Adelah,F,100,5,0,5
2014,Adelais,F,100,5,0,5
2014,Adelinne,F,100,5,0,5
2014,Adelya,F,100,5,0,5
2014,Aderyn,F,100,5,0,5
2014,Adesuwa,F,100,5,0,5
2014,Adewale,M,100,0,5,5
2014,Adhithi,F,100,5,0,5
2014,Adinah,F,100,5,0,5
2014,Adis,M,100,0,5,5
2014,Adithri,F,100,5,0,5
2014,Adlemi,F,100,5,0,5
2014,Adlin,F,100,5,0,5
2014,Adom,M,100,0,5,5
2014,Adoni,M,100,0,5,5
2014,Adreian,M,100,0,5,5
2014,Adren,M,100,0,5,5
2014,Adrena,F,100,5,0,5
2014,Adreonna,F,100,5,0,5
2014,Adrial,M,100,0,5,5
2014,Adrianny,F,100,5,0,5
2014,Adrita,F,100,5,0,5
2014,Advitha,F,100,5,0,5
2014,Adwaith,M,100,0,5,5
2014,Adwitiya,F,100,5,0,5
2014,Adysun,F,100,5,0,5
2014,Aeric,M,100,0,5,5
2014,Aerionna,F,100,5,0,5
2014,Aevah,F,100,5,0,5
2014,Aevin,M,100,0,5,5
2014,Afiyah,F,100,5,0,5
2014,Agamjot,M,100,0,5,5
2014,Agathe,F,100,5,0,5
2014,Agness,F,100,5,0,5
2014,Ahijah,M,100,0,5,5
2014,Ahlanna,F,100,5,0,5
2014,Ahlaysia,F,100,5,0,5
2014,Ahlina,F,100,5,0,5
2014,Ahmara,F,100,5,0,5
2014,Ahmare,M,100,0,5,5
2014,Ahmaud,M,100,0,5,5
2014,Ahmire,M,100,0,5,5
2014,Ahnah,F,100,5,0,5
2014,Ahnari,F,100,5,0,5
2014,Ahnesti,F,100,5,0,5
2014,Ahsoka,F,100,5,0,5
2014,Aidelyn,F,100,5,0,5
2014,Aidian,M,100,0,5,5
2014,Aija,F,100,5,0,5
2014,Aijalon,M,100,0,5,5
2014,Ailanie,F,100,5,0,5
2014,Ailea,F,100,5,0,5
2014,Ailena,F,100,5,0,5
2014,Aileth,F,100,5,0,5
2014,Ailiana,F,100,5,0,5
2014,Ailine,F,100,5,0,5
2014,Aimen,F,100,5,0,5
2014,Airel,F,100,5,0,5
2014,Aireona,F,100,5,0,5
2014,Aireonna,F,100,5,0,5
2014,Airess,F,100,5,0,5
2014,Airick,M,100,0,5,5
2014,Airin,M,100,0,5,5
2014,Airyn,F,100,5,0,5
2014,Aisea,M,100,0,5,5
2014,Aivley,F,100,5,0,5
2014,Aiyahna,F,100,5,0,5
2014,Aiylah,F,100,5,0,5
2014,Aizza,F,100,5,0,5
2014,Ajai,F,100,5,0,5
2014,Ajak,M,100,0,5,5
2014,Ajana,F,100,5,0,5
2014,Ajia,F,100,5,0,5
2014,Ajuni,F,100,5,0,5
2014,Akaash,M,100,0,5,5
2014,Akarsh,M,100,0,5,5
2014,Akeyla,F,100,5,0,5
2014,Akiko,F,100,5,0,5
2014,Akiles,M,100,0,5,5
2014,Akshadha,F,100,5,0,5
2014,Akshith,M,100,0,5,5
2014,Alainnah,F,100,5,0,5
2014,Alaisia,F,100,5,0,5
2014,Alalah,F,100,5,0,5
2014,Alandis,M,100,0,5,5
2014,Alaney,F,100,5,0,5
2014,Alaniz,F,100,5,0,5
2014,Alashia,F,100,5,0,5
2014,Alassandra,F,100,5,0,5
2014,Alaunah,F,100,5,0,5
2014,Alber,M,100,0,5,5
2014,Alchemy,F,100,5,0,5
2014,Aldana,F,100,5,0,5
2014,Aleaya,F,100,5,0,5
2014,Aleecya,F,100,5,0,5
2014,Aleezah,F,100,5,0,5
2014,Alegacy,F,100,5,0,5
2014,Alegna,F,100,5,0,5
2014,Aleighanna,F,100,5,0,5
2014,Aleijah,F,100,5,0,5
2014,Aleira,F,100,5,0,5
2014,Aleiza,F,100,5,0,5
2014,Alelia,F,100,5,0,5
2014,Alenka,F,100,5,0,5
2014,Alesi,F,100,5,0,5
2014,Alesiram,F,100,5,0,5
2014,Aletha,F,100,5,0,5
2014,Alexiel,F,100,5,0,5
2014,Alexsis,F,100,5,0,5
2014,Aleysia,F,100,5,0,5
2014,Alezandria,F,100,5,0,5
2014,Alezay,F,100,5,0,5
2014,Alfreda,F,100,5,0,5
2014,Alhaji,M,100,0,5,5
2014,Alhan,M,100,0,5,5
2014,Alhanouf,F,100,5,0,5
2014,Aliandra,F,100,5,0,5
2014,Alicemarie,F,100,5,0,5
2014,Aliceson,F,100,5,0,5
2014,Alieah,F,100,5,0,5
2014,Alienna,F,100,5,0,5
2014,Aliona,F,100,5,0,5
2014,Aliou,M,100,0,5,5
2014,Alivyah,F,100,5,0,5
2014,Alixzander,M,100,0,5,5
2014,Allah,M,100,0,5,5
2014,Allani,F,100,5,0,5
2014,Allaynah,F,100,5,0,5
2014,Allexa,F,100,5,0,5
2014,Allexis,F,100,5,0,5
2014,Alleyna,F,100,5,0,5
2014,Allice,F,100,5,0,5
2014,Allijah,M,100,0,5,5
2014,Allisa,F,100,5,0,5
2014,Allisen,F,100,5,0,5
2014,Allissa,F,100,5,0,5
2014,Allivia,F,100,5,0,5
2014,Allorah,F,100,5,0,5
2014,Allyce,F,100,5,0,5
2014,Allycia,F,100,5,0,5
2014,Almarie,F,100,5,0,5
2014,Almas,F,100,5,0,5
2014,Almendra,F,100,5,0,5
2014,Alohi,F,100,5,0,5
2014,Alonza,M,100,0,5,5
2014,Alshon,M,100,0,5,5
2014,Altin,M,100,0,5,5
2014,Alvar,M,100,0,5,5
2014,Alvino,M,100,0,5,5
2014,Alyciana,F,100,5,0,5
2014,Alyeska,F,100,5,0,5
2014,Alyk,M,100,0,5,5
2014,Alyne,F,100,5,0,5
2014,Alyssum,F,100,5,0,5
2014,Alyxzander,M,100,0,5,5
2014,Alyzae,F,100,5,0,5
2014,Alyzon,F,100,5,0,5
2014,Amaani,F,100,5,0,5
2014,Amabel,F,100,5,0,5
2014,Amahri,F,100,5,0,5
2014,Amai,F,100,5,0,5
2014,Amairah,F,100,5,0,5
2014,Amais,M,100,0,5,5
2014,Amaka,F,100,5,0,5
2014,Amaleah,F,100,5,0,5
2014,Amanat,F,100,5,0,5
2014,Amandine,F,100,5,0,5
2014,Amane,F,100,5,0,5
2014,Amarilys,F,100,5,0,5
2014,Amariyon,M,100,0,5,5
2014,Amarys,F,100,5,0,5
2014,Amaryss,F,100,5,0,5
2014,Amaud,M,100,0,5,5
2014,Amauria,F,100,5,0,5
2014,Amayia,F,100,5,0,5
2014,Amaylee,F,100,5,0,5
2014,Ambika,F,100,5,0,5
2014,Ambrie,F,100,5,0,5
2014,Amee,F,100,5,0,5
2014,Ameelia,F,100,5,0,5
2014,Ameeyah,F,100,5,0,5
2014,Amelah,F,100,5,0,5
2014,Ameliagrace,F,100,5,0,5
2014,Amelle,F,100,5,0,5
2014,Amerson,M,100,0,5,5
2014,Ameyaa,F,100,5,0,5
2014,Amiaya,F,100,5,0,5
2014,Amiela,F,100,5,0,5
2014,Amika,F,100,5,0,5
2014,Amilea,F,100,5,0,5
2014,Amiley,F,100,5,0,5
2014,Amita,F,100,5,0,5
2014,Amol,M,100,0,5,5
2014,Amriel,F,100,5,0,5
2014,Amsey,F,100,5,0,5
2014,Amsi,F,100,5,0,5
2014,Amun,M,100,0,5,5
2014,Amyria,F,100,5,0,5
2014,Amzee,F,100,5,0,5
2014,Amzi,F,100,5,0,5
2014,Anabelen,F,100,5,0,5
2014,Anaceli,F,100,5,0,5
2014,Anacristina,F,100,5,0,5
2014,Anadia,F,100,5,0,5
2014,Anahly,F,100,5,0,5
2014,Anaiis,F,100,5,0,5
2014,Anaisabella,F,100,5,0,5
2014,Analeese,F,100,5,0,5
2014,Analeyah,F,100,5,0,5
2014,Analice,F,100,5,0,5
2014,Analysse,F,100,5,0,5
2014,Anarely,F,100,5,0,5
2014,Anarose,F,100,5,0,5
2014,Anashe,F,100,5,0,5
2014,Anavaeh,F,100,5,0,5
2014,Anavay,F,100,5,0,5
2014,Anaveah,F,100,5,0,5
2014,Anayely,F,100,5,0,5
2014,Anayi,F,100,5,0,5
2014,Anda,F,100,5,0,5
2014,Andilynn,F,100,5,0,5
2014,Andoni,M,100,0,5,5
2014,Andressa,F,100,5,0,5
2014,Andrewjames,M,100,0,5,5
2014,Andric,M,100,0,5,5
2014,Andriea,F,100,5,0,5
2014,Andris,M,100,0,5,5
2014,Andrzej,M,100,0,5,5
2014,Anea,F,100,5,0,5
2014,Aneel,M,100,0,5,5
2014,Aneka,F,100,5,0,5
2014,Aneliese,F,100,5,0,5
2014,Aneres,F,100,5,0,5
2014,Aneta,F,100,5,0,5
2014,Anevaeh,F,100,5,0,5
2014,Anezka,F,100,5,0,5
2014,Angee,F,100,5,0,5
2014,Angeliah,F,100,5,0,5
2014,Angelissa,F,100,5,0,5
2014,Angellina,F,100,5,0,5
2014,Angelou,M,100,0,5,5
2014,Angeni,F,100,5,0,5
2014,Angler,M,100,0,5,5
2014,Aniaya,F,100,5,0,5
2014,Aniello,M,100,0,5,5
2014,Anikan,M,100,0,5,5
2014,Anil,M,100,0,5,5
2014,Anilya,F,100,5,0,5
2014,Anistasia,F,100,5,0,5
2014,Aniye,F,100,5,0,5
2014,Aniyiah,F,100,5,0,5
2014,Aniza,F,100,5,0,5
2014,Anjanette,F,100,5,0,5
2014,Anju,F,100,5,0,5
2014,Anlin,F,100,5,0,5
2014,Annabela,F,100,5,0,5
2014,Annabellah,F,100,5,0,5
2014,Annahbella,F,100,5,0,5
2014,Annajean,F,100,5,0,5
2014,Annajoy,F,100,5,0,5
2014,Annalaya,F,100,5,0,5
2014,Annaleya,F,100,5,0,5
2014,Annamay,F,100,5,0,5
2014,Annarae,F,100,5,0,5
2014,Annavictoria,F,100,5,0,5
2014,Anndee,F,100,5,0,5
2014,Anndy,M,100,0,5,5
2014,Annella,F,100,5,0,5
2014,Annelyn,F,100,5,0,5
2014,Annesley,F,100,5,0,5
2014,Annessa,F,100,5,0,5
2014,Annikah,F,100,5,0,5
2014,Annyka,F,100,5,0,5
2014,Anova,F,100,5,0,5
2014,Anri,M,100,0,5,5
2014,Ansa,F,100,5,0,5
2014,Anslei,F,100,5,0,5
2014,Antara,F,100,5,0,5
2014,Anterrio,M,100,0,5,5
2014,Anthem,M,100,0,5,5
2014,Antoin,M,100,0,5,5
2014,Antoria,F,100,5,0,5
2014,Anu,F,100,5,0,5
2014,Anuar,M,100,0,5,5
2014,Anuoluwa,F,100,5,0,5
2014,Anuva,F,100,5,0,5
2014,Anwyn,F,100,5,0,5
2014,Anyae,F,100,5,0,5
2014,Anyelo,M,100,0,5,5
2014,Anyila,F,100,5,0,5
2014,Anyra,F,100,5,0,5
2014,Anyssia,F,100,5,0,5
2014,Anzlie,F,100,5,0,5
2014,Aoibheann,F,100,5,0,5
2014,Aous,M,100,0,5,5
2014,Aprill,F,100,5,0,5
2014,Apurva,F,100,5,0,5
2014,Aqua,F,100,5,0,5
2014,Aquila,F,100,5,0,5
2014,Aquinas,M,100,0,5,5
2014,Aracelia,F,100,5,0,5
2014,Aracelli,F,100,5,0,5
2014,Araelynn,F,100,5,0,5
2014,Araiah,F,100,5,0,5
2014,Arainna,F,100,5,0,5
2014,Araly,F,100,5,0,5
2014,Aralynne,F,100,5,0,5
2014,Aranxa,F,100,5,0,5
2014,Arayia,F,100,5,0,5
2014,Arcangelo,M,100,0,5,5
2014,Ardi,M,100,0,5,5
2014,Aree,M,100,0,5,5
2014,Areeya,F,100,5,0,5
2014,Areonna,F,100,5,0,5
2014,Ariaan,M,100,0,5,5
2014,Ariadnne,F,100,5,0,5
2014,Arianamarie,F,100,5,0,5
2014,Arianis,F,100,5,0,5
2014,Aricela,F,100,5,0,5
2014,Ariee,F,100,5,0,5
2014,Arieh,M,100,0,5,5
2014,Arielyz,F,100,5,0,5
2014,Arieon,F,100,5,0,5
2014,Arii,F,100,5,0,5
2014,Ariiana,F,100,5,0,5
2014,Aristotelis,M,100,0,5,5
2014,Ariyahna,F,100,5,0,5
2014,Arka,M,100,0,5,5
2014,Arkangel,M,100,0,5,5
2014,Arkeem,M,100,0,5,5
2014,Arlenys,F,100,5,0,5
2014,Arles,M,100,0,5,5
2014,Arliana,F,100,5,0,5
2014,Armiah,F,100,5,0,5
2014,Arminda,F,100,5,0,5
2014,Armiyah,F,100,5,0,5
2014,Armonte,M,100,0,5,5
2014,Armya,F,100,5,0,5
2014,Arnel,M,100,0,5,5
2014,Arnell,M,100,0,5,5
2014,Aroura,F,100,5,0,5
2014,Arra,F,100,5,0,5
2014,Arrah,F,100,5,0,5
2014,Arrihanna,F,100,5,0,5
2014,Arrion,M,100,0,5,5
2014,Arsene,M,100,0,5,5
2014,Arshdeep,M,100,0,5,5
2014,Artavious,M,100,0,5,5
2014,Arvi,F,100,5,0,5
2014,Aryane,F,100,5,0,5
2014,Aryauna,F,100,5,0,5
2014,Aryela,F,100,5,0,5
2014,Aryian,F,100,5,0,5
2014,Aryk,M,100,0,5,5
2014,Aryss,F,100,5,0,5
2014,Asaya,M,100,0,5,5
2014,Aseda,M,100,0,5,5
2014,Aset,F,100,5,0,5
2014,Ashad,M,100,0,5,5
2014,Ashan,M,100,0,5,5
2014,Ashana,F,100,5,0,5
2014,Ashaun,M,100,0,5,5
2014,Ashayla,F,100,5,0,5
2014,Ashi,F,100,5,0,5
2014,Ashlye,F,100,5,0,5
2014,Ashlynd,F,100,5,0,5
2014,Ashni,F,100,5,0,5
2014,Ashritha,F,100,5,0,5
2014,Ashvath,M,100,0,5,5
2014,Ashwika,F,100,5,0,5
2014,Asialynn,F,100,5,0,5
2014,Asser,M,100,0,5,5
2014,Assia,F,100,5,0,5
2014,Asten,M,100,0,5,5
2014,Astryd,F,100,5,0,5
2014,Asuna,F,100,5,0,5
2014,Athanasius,M,100,0,5,5
2014,Athea,F,100,5,0,5
2014,Athenamarie,F,100,5,0,5
2014,Athenea,F,100,5,0,5
2014,Athens,M,100,0,5,5
2014,Atifa,F,100,5,0,5
2014,Aubrelle,F,100,5,0,5
2014,Aubreonna,F,100,5,0,5
2014,Aubreyelle,F,100,5,0,5
2014,Aubreyrose,F,100,5,0,5
2014,Aubrieanna,F,100,5,0,5
2014,Aubriona,F,100,5,0,5
2014,Audel,M,100,0,5,5
2014,Audelia,F,100,5,0,5
2014,Audreana,F,100,5,0,5
2014,Audrena,F,100,5,0,5
2014,Audrianne,F,100,5,0,5
2014,Audrii,F,100,5,0,5
2014,Audrinah,F,100,5,0,5
2014,Aulden,M,100,0,5,5
2014,Aurbree,F,100,5,0,5
2014,Auree,F,100,5,0,5
2014,Aurik,M,100,0,5,5
2014,Aurin,M,100,0,5,5
2014,Aurra,F,100,5,0,5
2014,Ausar,M,100,0,5,5
2014,Austan,M,100,0,5,5
2014,Austina,F,100,5,0,5
2014,Autrey,M,100,0,5,5
2014,Avaclaire,F,100,5,0,5
2014,Avae,F,100,5,0,5
2014,Avaelizabeth,F,100,5,0,5
2014,Avaiya,F,100,5,0,5
2014,Avalea,F,100,5,0,5
2014,Avali,F,100,5,0,5
2014,Avalie,F,100,5,0,5
2014,Avalyne,F,100,5,0,5
2014,Avanah,F,100,5,0,5
2014,Avanti,F,100,5,0,5
2014,Avariella,F,100,5,0,5
2014,Avasophia,F,100,5,0,5
2014,Avedis,M,100,0,5,5
2014,Aveigha,F,100,5,0,5
2014,Avelie,F,100,5,0,5
2014,Avelin,F,100,5,0,5
2014,Avellina,F,100,5,0,5
2014,Avenley,F,100,5,0,5
2014,Averill,M,100,0,5,5
2014,Averionna,F,100,5,0,5
2014,Averlee,F,100,5,0,5
2014,Averymarie,F,100,5,0,5
2014,Avona,F,100,5,0,5
2014,Avondre,M,100,0,5,5
2014,Avori,F,100,5,0,5
2014,Avraj,M,100,0,5,5
2014,Avrora,F,100,5,0,5
2014,Avynn,F,100,5,0,5
2014,Awbree,F,100,5,0,5
2014,Awna,F,100,5,0,5
2014,Axtin,M,100,0,5,5
2014,Axwell,M,100,0,5,5
2014,Ayano,F,100,5,0,5
2014,Ayasha,F,100,5,0,5
2014,Ayedin,M,100,0,5,5
2014,Ayen,F,100,5,0,5
2014,Ayin,F,100,5,0,5
2014,Aylamae,F,100,5,0,5
2014,Aylena,F,100,5,0,5
2014,Aylissa,F,100,5,0,5
2014,Ayn,F,100,5,0,5
2014,Aynslie,F,100,5,0,5
2014,Ayo,M,100,0,5,5
2014,Ayon,M,100,0,5,5
2014,Ayres,M,100,0,5,5
2014,Ayria,F,100,5,0,5
2014,Ayrian,F,100,5,0,5
2014,Ayshah,F,100,5,0,5
2014,Ayshia,F,100,5,0,5
2014,Ayslin,F,100,5,0,5
2014,Ayten,F,100,5,0,5
2014,Ayvree,F,100,5,0,5
2014,Ayvrie,F,100,5,0,5
2014,Ayzen,M,100,0,5,5
2014,Ayzlyn,F,100,5,0,5
2014,Azadeh,F,100,5,0,5
2014,Azailya,F,100,5,0,5
2014,Azarael,M,100,0,5,5
2014,Azarian,M,100,0,5,5
2014,Azayleah,F,100,5,0,5
2014,Azealia,F,100,5,0,5
2014,Azelea,F,100,5,0,5
2014,Azelle,F,100,5,0,5
2014,Azelya,F,100,5,0,5
2014,Azelynn,F,100,5,0,5
2014,Azhar,M,100,0,5,5
2014,Azilyn,F,100,5,0,5
2014,Azira,F,100,5,0,5
2014,Azlynne,F,100,5,0,5
2014,Azora,F,100,5,0,5
2014,Azumi,F,100,5,0,5
2014,Azurah,F,100,5,0,5
2014,Azyla,F,100,5,0,5
2014,Azzan,M,100,0,5,5
2014,Baela,F,100,5,0,5
2014,Baeley,F,100,5,0,5
2014,Baha,M,100,0,5,5
2014,Bailen,M,100,0,5,5
2014,Baisley,F,100,5,0,5
2014,Baiya,F,100,5,0,5
2014,Baja,F,100,5,0,5
2014,Bali,F,100,5,0,5
2014,Bambi,F,100,5,0,5
2014,Bangaly,M,100,0,5,5
2014,Bar,F,100,5,0,5
2014,Barbra,F,100,5,0,5
2014,Bareerah,F,100,5,0,5
2014,Barett,M,100,0,5,5
2014,Barton,M,100,0,5,5
2014,Bartu,M,100,0,5,5
2014,Bash,M,100,0,5,5
2014,Basheer,M,100,0,5,5
2014,Basit,M,100,0,5,5
2014,Bayard,M,100,0,5,5
2014,Beighley,F,100,5,0,5
2014,Bejamin,M,100,0,5,5
2014,Bekim,M,100,0,5,5
2014,Believe,F,100,5,0,5
2014,Belina,F,100,5,0,5
2014,Bellaann,F,100,5,0,5
2014,Bellamay,F,100,5,0,5
2014,Bellani,F,100,5,0,5
2014,Bellina,F,100,5,0,5
2014,Bena,F,100,5,0,5
2014,Benjimin,M,100,0,5,5
2014,Bennjamin,M,100,0,5,5
2014,Berat,M,100,0,5,5
2014,Bergan,F,100,5,0,5
2014,Berkay,M,100,0,5,5
2014,Bethaney,F,100,5,0,5
2014,Bethannie,F,100,5,0,5
2014,Betsey,F,100,5,0,5
2014,Betzayda,F,100,5,0,5
2014,Bevan,M,100,0,5,5
2014,Beverley,F,100,5,0,5
2014,Beyonca,F,100,5,0,5
2014,Bhavik,M,100,0,5,5
2014,Bhoomi,F,100,5,0,5
2014,Biana,F,100,5,0,5
2014,Bianey,F,100,5,0,5
2014,Bibek,M,100,0,5,5
2014,Bilen,F,100,5,0,5
2014,Billion,M,100,0,5,5
2014,Billyjoe,M,100,0,5,5
2014,Bitia,F,100,5,0,5
2014,Blace,M,100,0,5,5
2014,Blakelie,F,100,5,0,5
2014,Blakesley,F,100,5,0,5
2014,Blaydon,M,100,0,5,5
2014,Blaz,M,100,0,5,5
2014,Blessings,F,100,5,0,5
2014,Bohan,M,100,0,5,5
2014,Bohannon,M,100,0,5,5
2014,Bohen,M,100,0,5,5
2014,Bolden,M,100,0,5,5
2014,Bomani,M,100,0,5,5
2014,Bonifacio,M,100,0,5,5
2014,Bosten,M,100,0,5,5
2014,Bowan,M,100,0,5,5
2014,Bowin,M,100,0,5,5
2014,Bracey,F,100,5,0,5
2014,Bradi,F,100,5,0,5
2014,Bradlie,F,100,5,0,5
2014,Bradlyn,M,100,0,5,5
2014,Braely,F,100,5,0,5
2014,Brahim,M,100,0,5,5
2014,Brailin,M,100,0,5,5
2014,Bralon,M,100,0,5,5
2014,Bralynne,F,100,5,0,5
2014,Brana,F,100,5,0,5
2014,Brandalyn,F,100,5,0,5
2014,Brandalynn,F,100,5,0,5
2014,Brandii,F,100,5,0,5
2014,Branndon,M,100,0,5,5
2014,Braston,M,100,0,5,5
2014,Bravyn,M,100,0,5,5
2014,Braxdyn,M,100,0,5,5
2014,Braxtynn,M,100,0,5,5
2014,Brayam,M,100,0,5,5
2014,Braydee,F,100,5,0,5
2014,Brayen,M,100,0,5,5
2014,Braylinn,F,100,5,0,5
2014,Brayston,M,100,0,5,5
2014,Breeya,F,100,5,0,5
2014,Breiden,M,100,0,5,5
2014,Breigh,F,100,5,0,5
2014,Breilyn,F,100,5,0,5
2014,Breion,M,100,0,5,5
2014,Brenasia,F,100,5,0,5
2014,Brendaliz,F,100,5,0,5
2014,Brenn,F,100,5,0,5
2014,Brentleigh,F,100,5,0,5
2014,Brevon,M,100,0,5,5
2014,Brextyn,M,100,0,5,5
2014,Breylen,M,100,0,5,5
2014,Breyona,F,100,5,0,5
2014,Briani,F,100,5,0,5
2014,Briannie,F,100,5,0,5
2014,Bricelynn,F,100,5,0,5
2014,Bridie,F,100,5,0,5
2014,Brielee,F,100,5,0,5
2014,Brigett,F,100,5,0,5
2014,Brighid,F,100,5,0,5
2014,Brij,M,100,0,5,5
2014,Brinae,F,100,5,0,5
2014,Brinden,M,100,0,5,5
2014,Brinlea,F,100,5,0,5
2014,Bristin,M,100,0,5,5
2014,Brisyn,M,100,0,5,5
2014,Britian,F,100,5,0,5
2014,Britlyn,F,100,5,0,5
2014,Brittlynn,F,100,5,0,5
2014,Briyelle,F,100,5,0,5
2014,Briyonna,F,100,5,0,5
2014,Brizeida,F,100,5,0,5
2014,Brizza,F,100,5,0,5
2014,Brom,M,100,0,5,5
2014,Bronsyn,M,100,0,5,5
2014,Brooklan,F,100,5,0,5
2014,Brookleigh,F,100,5,0,5
2014,Brookley,F,100,5,0,5
2014,Brooklynrose,F,100,5,0,5
2014,Brya,F,100,5,0,5
2014,Bryanah,F,100,5,0,5
2014,Bryannah,F,100,5,0,5
2014,Bryell,F,100,5,0,5
2014,Bryken,M,100,0,5,5
2014,Brylyn,F,100,5,0,5
2014,Bryndon,M,100,0,5,5
2014,Brynnan,F,100,5,0,5
2014,Brysonn,M,100,0,5,5
2014,Burgundy,F,100,5,0,5
2014,Buruk,M,100,0,5,5
2014,Busra,F,100,5,0,5
2014,Byrdie,F,100,5,0,5
2014,Caci,F,100,5,0,5
2014,Cadia,F,100,5,0,5
2014,Caetano,M,100,0,5,5
2014,Caid,M,100,0,5,5
2014,Cailie,F,100,5,0,5
2014,Cailum,M,100,0,5,5
2014,Caiman,M,100,0,5,5
2014,Calab,M,100,0,5,5
2014,Calah,F,100,5,0,5
2014,Caleel,M,100,0,5,5
2014,Calev,M,100,0,5,5
2014,Calhoun,M,100,0,5,5
2014,Calimarie,F,100,5,0,5
2014,Callin,M,100,0,5,5
2014,Camar,M,100,0,5,5
2014,Camaria,F,100,5,0,5
2014,Camarie,F,100,5,0,5
2014,Camarri,M,100,0,5,5
2014,Cambrey,F,100,5,0,5
2014,Cambrielle,F,100,5,0,5
2014,Camdan,M,100,0,5,5
2014,Camiah,F,100,5,0,5
2014,Camielle,F,100,5,0,5
2014,Campion,M,100,0,5,5
2014,Canek,M,100,0,5,5
2014,Canyla,F,100,5,0,5
2014,Capriana,F,100,5,0,5
2014,Carabelle,F,100,5,0,5
2014,Cardale,M,100,0,5,5
2014,Cariel,F,100,5,0,5
2014,Carlaya,F,100,5,0,5
2014,Carlaysia,F,100,5,0,5
2014,Carlisa,F,100,5,0,5
2014,Carlita,F,100,5,0,5
2014,Carliyah,F,100,5,0,5
2014,Carlon,M,100,0,5,5
2014,Carmelle,F,100,5,0,5
2014,Carmilla,F,100,5,0,5
2014,Carmynn,F,100,5,0,5
2014,Carola,F,100,5,0,5
2014,Carr,M,100,0,5,5
2014,Carrera,F,100,5,0,5
2014,Carrieann,F,100,5,0,5
2014,Carterjames,M,100,0,5,5
2014,Carvell,M,100,0,5,5
2014,Carvin,M,100,0,5,5
2014,Casia,F,100,5,0,5
2014,Casidy,F,100,5,0,5
2014,Casiyah,F,100,5,0,5
2014,Cassidey,F,100,5,0,5
2014,Cassidie,F,100,5,0,5
2014,Casson,M,100,0,5,5
2014,Caster,M,100,0,5,5
2014,Castyn,M,100,0,5,5
2014,Cataleena,F,100,5,0,5
2014,Cataleia,F,100,5,0,5
2014,Cataliya,F,100,5,0,5
2014,Catch,M,100,0,5,5
2014,Cathalia,F,100,5,0,5
2014,Catherin,F,100,5,0,5
2014,Catheryn,F,100,5,0,5
2014,Catlyn,F,100,5,0,5
2014,Cavion,M,100,0,5,5
2014,Caydenn,M,100,0,5,5
2014,Caydince,F,100,5,0,5
2014,Caydn,M,100,0,5,5
2014,Cayetano,M,100,0,5,5
2014,Cayle,F,100,5,0,5
2014,Caylon,M,100,0,5,5
2014,Caynen,M,100,0,5,5
2014,Caysie,F,100,5,0,5
2014,Cayslee,F,100,5,0,5
2014,Caytlin,F,100,5,0,5
2014,Ceci,F,100,5,0,5
2014,Cecia,F,100,5,0,5
2014,Celesta,F,100,5,0,5
2014,Celiyah,F,100,5,0,5
2014,Cella,F,100,5,0,5
2014,Celton,M,100,0,5,5
2014,Ceniyah,F,100,5,0,5
2014,Cennedy,F,100,5,0,5
2014,Ceren,F,100,5,0,5
2014,Cevin,M,100,0,5,5
2014,Chaaya,F,100,5,0,5
2014,Chaddrick,M,100,0,5,5
2014,Chakong,M,100,0,5,5
2014,Chambers,M,100,0,5,5
2014,Chamille,F,100,5,0,5
2014,Chanden,M,100,0,5,5
2014,Channa,F,100,5,0,5
2014,Channen,M,100,0,5,5
2014,Channin,M,100,0,5,5
2014,Charitee,F,100,5,0,5
2014,Charizma,F,100,5,0,5
2014,Charlemagne,M,100,0,5,5
2014,Charliegh,F,100,5,0,5
2014,Charliemae,F,100,5,0,5
2014,Charlyne,F,100,5,0,5
2014,Charlynn,F,100,5,0,5
2014,Charvez,M,100,0,5,5
2014,Charvik,M,100,0,5,5
2014,Chasetin,M,100,0,5,5
2014,Chaslyn,F,100,5,0,5
2014,Chatham,M,100,0,5,5
2014,Chavah,F,100,5,0,5
2014,Chayim,M,100,0,5,5
2014,Cher,F,100,5,0,5
2014,Cherri,F,100,5,0,5
2014,Cherrie,F,100,5,0,5
2014,Chesni,F,100,5,0,5
2014,Chiana,F,100,5,0,5
2014,Chiedozie,M,100,0,5,5
2014,Chigozie,M,100,0,5,5
2014,Chihiro,F,100,5,0,5
2014,Chikaima,F,100,5,0,5
2014,Chinaza,F,100,5,0,5
2014,Chino,M,100,0,5,5
2014,Chirag,M,100,0,5,5
2014,Chisum,M,100,0,5,5
2014,Chloeanne,F,100,5,0,5
2014,Chloelynn,F,100,5,0,5
2014,Chozen,M,100,0,5,5
2014,Chrisalynn,F,100,5,0,5
2014,Chrisanne,F,100,5,0,5
2014,Christianjames,M,100,0,5,5
2014,Christopherjohn,M,100,0,5,5
2014,Chrystopher,M,100,0,5,5
2014,Chukwuka,M,100,0,5,5
2014,Cicilia,F,100,5,0,5
2014,Cin,M,100,0,5,5
2014,Clairity,F,100,5,0,5
2014,Claramae,F,100,5,0,5
2014,Clarie,F,100,5,0,5
2014,Clarise,F,100,5,0,5
2014,Claytin,M,100,0,5,5
2014,Cleona,F,100,5,0,5
2014,Clever,M,100,0,5,5
2014,Cline,M,100,0,5,5
2014,Cloee,F,100,5,0,5
2014,Cloris,F,100,5,0,5
2014,Coalson,M,100,0,5,5
2014,Coburn,M,100,0,5,5
2014,Cohl,M,100,0,5,5
2014,Cohutta,M,100,0,5,5
2014,Coletta,F,100,5,0,5
2014,Collis,M,100,0,5,5
2014,Colsyn,M,100,0,5,5
2014,Common,M,100,0,5,5
2014,Compton,M,100,0,5,5
2014,Conlon,M,100,0,5,5
2014,Copen,M,100,0,5,5
2014,Corabella,F,100,5,0,5
2014,Coralea,F,100,5,0,5
2014,Corderro,M,100,0,5,5
2014,Corena,F,100,5,0,5
2014,Coriana,F,100,5,0,5
2014,Corianne,F,100,5,0,5
2014,Corinn,F,100,5,0,5
2014,Cormack,M,100,0,5,5
2014,Cornelious,M,100,0,5,5
2014,Corniyah,F,100,5,0,5
2014,Corron,M,100,0,5,5
2014,Cosimo,M,100,0,5,5
2014,Cosmas,M,100,0,5,5
2014,Credence,F,100,5,0,5
2014,Creedan,M,100,0,5,5
2014,Cresencio,M,100,0,5,5
2014,Crews,M,100,0,5,5
2014,Crisanto,M,100,0,5,5
2014,Crissy,F,100,5,0,5
2014,Cristaly,F,100,5,0,5
2014,Cristela,F,100,5,0,5
2014,Cruse,M,100,0,5,5
2014,Crysta,F,100,5,0,5
2014,Crystalina,F,100,5,0,5
2014,Crystopher,M,100,0,5,5
2014,Cydni,F,100,5,0,5
2014,Dacen,M,100,0,5,5
2014,Daciana,F,100,5,0,5
2014,Dacion,M,100,0,5,5
2014,Dacoda,M,100,0,5,5
2014,Dacorian,M,100,0,5,5
2014,Dacota,F,100,5,0,5
2014,Dafny,F,100,5,0,5
2014,Dagem,M,100,0,5,5
2014,Dagger,M,100,0,5,5
2014,Dahani,M,100,0,5,5
2014,Dahna,F,100,5,0,5
2014,Daiceon,M,100,0,5,5
2014,Dailin,F,100,5,0,5
2014,Daison,M,100,0,5,5
2014,Dakobe,M,100,0,5,5
2014,Dala,F,100,5,0,5
2014,Dalaina,F,100,5,0,5
2014,Dalany,F,100,5,0,5
2014,Dalaylah,F,100,5,0,5
2014,Dalessandro,M,100,0,5,5
2014,Daleysi,F,100,5,0,5
2014,Dalin,M,100,0,5,5
2014,Daliyla,F,100,5,0,5
2014,Daliylah,F,100,5,0,5
2014,Dallyce,F,100,5,0,5
2014,Dallyn,M,100,0,5,5
2014,Damare,M,100,0,5,5
2014,Damarii,M,100,0,5,5
2014,Damarkis,M,100,0,5,5
2014,Damaso,M,100,0,5,5
2014,Dameria,F,100,5,0,5
2014,Damerius,M,100,0,5,5
2014,Damilare,M,100,0,5,5
2014,Damiracle,F,100,5,0,5
2014,Damire,M,100,0,5,5
2014,Damonee,M,100,0,5,5
2014,Damonii,M,100,0,5,5
2014,Damonni,M,100,0,5,5
2014,Danaiya,F,100,5,0,5
2014,Danee,F,100,5,0,5
2014,Daneen,F,100,5,0,5
2014,Danell,M,100,0,5,5
2014,Danicka,F,100,5,0,5
2014,Danieliz,F,100,5,0,5
2014,Daniely,F,100,5,0,5
2014,Danila,M,100,0,5,5
2014,Daniyel,M,100,0,5,5
2014,Daniylah,F,100,5,0,5
2014,Dannalyn,F,100,5,0,5
2014,Danney,F,100,5,0,5
2014,Dannyelle,F,100,5,0,5
2014,Danson,M,100,0,5,5
2014,Dantavious,M,100,0,5,5
2014,Danton,M,100,0,5,5
2014,Danuel,M,100,0,5,5
2014,Danylo,M,100,0,5,5
2014,Dar,M,100,0,5,5
2014,Daran,M,100,0,5,5
2014,Dardan,M,100,0,5,5
2014,Darel,M,100,0,5,5
2014,Dareli,F,100,5,0,5
2014,Dariella,F,100,5,0,5
2014,Darilyn,F,100,5,0,5
2014,Darolyn,F,100,5,0,5
2014,Darrah,F,100,5,0,5
2014,Darshi,F,100,5,0,5
2014,Darvens,M,100,0,5,5
2014,Dashawna,F,100,5,0,5
2014,Dasiah,F,100,5,0,5
2014,Daundre,M,100,0,5,5
2014,Daury,M,100,0,5,5
2014,Davaeh,F,100,5,0,5
2014,Davari,M,100,0,5,5
2014,Davarion,M,100,0,5,5
2014,Davarious,M,100,0,5,5
2014,Davaun,M,100,0,5,5
2014,Daveah,F,100,5,0,5
2014,Davee,F,100,5,0,5
2014,Davidjames,M,100,0,5,5
2014,Davionne,M,100,0,5,5
2014,Davison,M,100,0,5,5
2014,Davud,M,100,0,5,5
2014,Dawon,M,100,0,5,5
2014,Dayja,F,100,5,0,5
2014,Dayjah,F,100,5,0,5
2014,Daylanie,F,100,5,0,5
2014,Daymein,M,100,0,5,5
2014,Daymion,M,100,0,5,5
2014,Dayvanee,F,100,5,0,5
2014,Dayzi,F,100,5,0,5
2014,Dazaria,F,100,5,0,5
2014,Dazie,F,100,5,0,5
2014,Daziel,M,100,0,5,5
2014,Deair,M,100,0,5,5
2014,Deakyn,M,100,0,5,5
2014,Deantae,M,100,0,5,5
2014,Dearie,F,100,5,0,5
2014,Deason,M,100,0,5,5
2014,Deaton,M,100,0,5,5
2014,Decarlo,M,100,0,5,5
2014,Decimus,M,100,0,5,5
2014,Dee,M,100,0,5,5
2014,Deenah,F,100,5,0,5
2014,Deilani,F,100,5,0,5
2014,Deilany,F,100,5,0,5
2014,Deisha,F,100,5,0,5
2014,Dekendrick,M,100,0,5,5
2014,Delaine,F,100,5,0,5
2014,Delara,F,100,5,0,5
2014,Delaysha,F,100,5,0,5
2014,Delilahrose,F,100,5,0,5
2014,Delisa,F,100,5,0,5
2014,Deloni,M,100,0,5,5
2014,Delorean,M,100,0,5,5
2014,Delphia,F,100,5,0,5
2014,Delshawn,M,100,0,5,5
2014,Demare,M,100,0,5,5
2014,Demareo,M,100,0,5,5
2014,Demarquis,M,100,0,5,5
2014,Demier,M,100,0,5,5
2014,Demitrio,M,100,0,5,5
2014,Demitris,M,100,0,5,5
2014,Demone,M,100,0,5,5
2014,Demonei,M,100,0,5,5
2014,Demont,M,100,0,5,5
2014,Demontay,M,100,0,5,5
2014,Demyan,M,100,0,5,5
2014,Denaly,F,100,5,0,5
2014,Denard,M,100,0,5,5
2014,Denero,M,100,0,5,5
2014,Denham,M,100,0,5,5
2014,Denisa,F,100,5,0,5
2014,Dennisse,F,100,5,0,5
2014,Denylah,F,100,5,0,5
2014,Denys,M,100,0,5,5
2014,Deran,M,100,0,5,5
2014,Deriel,M,100,0,5,5
2014,Derringer,M,100,0,5,5
2014,Deryck,M,100,0,5,5
2014,Deryk,M,100,0,5,5
2014,Desai,M,100,0,5,5
2014,Deseray,F,100,5,0,5
2014,Deshan,M,100,0,5,5
2014,Desmen,M,100,0,5,5
2014,Dessie,F,100,5,0,5
2014,Destined,M,100,0,5,5
2014,Deuce,M,100,0,5,5
2014,Devanta,M,100,0,5,5
2014,Devayah,F,100,5,0,5
2014,Devona,F,100,5,0,5
2014,Devone,M,100,0,5,5
2014,Devraj,M,100,0,5,5
2014,Devyon,M,100,0,5,5
2014,Deyra,F,100,5,0,5
2014,Deyvi,M,100,0,5,5
2014,Deyvid,M,100,0,5,5
2014,Dhara,F,100,5,0,5
2014,Dheera,M,100,0,5,5
2014,Dhiago,M,100,0,5,5
2014,Dhiren,M,100,0,5,5
2014,Dhruthi,F,100,5,0,5
2014,Dhruvan,M,100,0,5,5
2014,Dhyana,F,100,5,0,5
2014,Diamonique,F,100,5,0,5
2014,Dianelly,F,100,5,0,5
2014,Dianelys,F,100,5,0,5
2014,Diann,F,100,5,0,5
2014,Dilann,M,100,0,5,5
2014,Dilen,M,100,0,5,5
2014,Dilia,F,100,5,0,5
2014,Dillard,M,100,0,5,5
2014,Dilon,M,100,0,5,5
2014,Dilraj,M,100,0,5,5
2014,Dimaggio,M,100,0,5,5
2014,Dimitra,F,100,5,0,5
2014,Dione,F,100,5,0,5
2014,Diore,F,100,5,0,5
2014,Diquan,M,100,0,5,5
2014,Dixi,F,100,5,0,5
2014,Diyaa,F,100,5,0,5
2014,Diyor,M,100,0,5,5
2014,Diyora,F,100,5,0,5
2014,Djene,F,100,5,0,5
2014,Dlila,F,100,5,0,5
2014,Dlilah,F,100,5,0,5
2014,Dniya,F,100,5,0,5
2014,Dnylah,F,100,5,0,5
2014,Dollie,F,100,5,0,5
2014,Domari,M,100,0,5,5
2014,Dominyck,M,100,0,5,5
2014,Donal,M,100,0,5,5
2014,Donathan,M,100,0,5,5
2014,Donjuan,M,100,0,5,5
2014,Donovon,M,100,0,5,5
2014,Dontarius,M,100,0,5,5
2014,Donterius,M,100,0,5,5
2014,Dontrae,M,100,0,5,5
2014,Dontrez,M,100,0,5,5
2014,Donyae,M,100,0,5,5
2014,Dor,F,100,5,0,5
2014,Doria,F,100,5,0,5
2014,Dorie,F,100,5,0,5
2014,Dovi,M,100,0,5,5
2014,Drae,M,100,0,5,5
2014,Dragan,M,100,0,5,5
2014,Drayvin,M,100,0,5,5
2014,Drazen,M,100,0,5,5
2014,Dreana,F,100,5,0,5
2014,Dredan,M,100,0,5,5
2014,Dreysen,M,100,0,5,5
2014,Drezden,M,100,0,5,5
2014,Drishya,F,100,5,0,5
2014,Duc,M,100,0,5,5
2014,Duha,F,100,5,0,5
2014,Durand,M,100,0,5,5
2014,Durga,F,100,5,0,5
2014,Dusti,F,100,5,0,5
2014,Duston,M,100,0,5,5
2014,Dut,M,100,0,5,5
2014,Duval,M,100,0,5,5
2014,Dwane,M,100,0,5,5
2014,Dwuan,M,100,0,5,5
2014,Dwyane,M,100,0,5,5
2014,Dylam,M,100,0,5,5
2014,Dyllin,M,100,0,5,5
2014,Dymir,M,100,0,5,5
2014,Dynesty,F,100,5,0,5
2014,Dyshon,M,100,0,5,5
2014,Dyuthi,F,100,5,0,5
2014,Dziyah,F,100,5,0,5
2014,Easter,F,100,5,0,5
2014,Ebany,F,100,5,0,5
2014,Ebbie,F,100,5,0,5
2014,Ebelin,F,100,5,0,5
2014,Ebelyn,F,100,5,0,5
2014,Eddyson,M,100,0,5,5
2014,Edelina,F,100,5,0,5
2014,Edem,M,100,0,5,5
2014,Edenilson,M,100,0,5,5
2014,Edsel,M,100,0,5,5
2014,Edwynn,M,100,0,5,5
2014,Eelijah,M,100,0,5,5
2014,Effy,F,100,5,0,5
2014,Efosa,M,100,0,5,5
2014,Ehvan,M,100,0,5,5
2014,Eileena,F,100,5,0,5
2014,Eiliana,F,100,5,0,5
2014,Eilish,F,100,5,0,5
2014,Eilonwy,F,100,5,0,5
2014,Eimi,F,100,5,0,5
2014,Eirian,F,100,5,0,5
2014,Eithen,M,100,0,5,5
2014,Eito,M,100,0,5,5
2014,Eizley,F,100,5,0,5
2014,Ejaz,M,100,0,5,5
2014,Ekambir,M,100,0,5,5
2014,Eker,M,100,0,5,5
2014,Elad,M,100,0,5,5
2014,Elaini,F,100,5,0,5
2014,Elanny,F,100,5,0,5
2014,Elesia,F,100,5,0,5
2014,Elex,M,100,0,5,5
2014,Eleyah,F,100,5,0,5
2014,Elhana,F,100,5,0,5
2014,Elianagrace,F,100,5,0,5
2014,Elianis,F,100,5,0,5
2014,Elianni,F,100,5,0,5
2014,Eliannie,F,100,5,0,5
2014,Eliejah,M,100,0,5,5
2014,Elieser,M,100,0,5,5
2014,Elikai,M,100,0,5,5
2014,Elisee,M,100,0,5,5
2014,Elison,F,100,5,0,5
2014,Elixander,M,100,0,5,5
2014,Elizabet,F,100,5,0,5
2014,Elizabethgrace,F,100,5,0,5
2014,Elizajane,F,100,5,0,5
2014,Elizander,M,100,0,5,5
2014,Elizebeth,F,100,5,0,5
2014,Elizeo,M,100,0,5,5
2014,Ellabelle,F,100,5,0,5
2014,Elleanora,F,100,5,0,5
2014,Elleson,F,100,5,0,5
2014,Elliekate,F,100,5,0,5
2014,Ellisa,F,100,5,0,5
2014,Ellissa,F,100,5,0,5
2014,Ellymae,F,100,5,0,5
2014,Ellyonna,F,100,5,0,5
2014,Elmina,F,100,5,0,5
2014,Elnatan,M,100,0,5,5
2014,Elyja,M,100,0,5,5
2014,Elyjiah,M,100,0,5,5
2014,Elysian,F,100,5,0,5
2014,Elysium,M,100,0,5,5
2014,Emalena,F,100,5,0,5
2014,Emalin,F,100,5,0,5
2014,Emanni,F,100,5,0,5
2014,Emar,M,100,0,5,5
2014,Emauri,M,100,0,5,5
2014,Emberlie,F,100,5,0,5
2014,Emee,F,100,5,0,5
2014,Emeilia,F,100,5,0,5
2014,Emeka,M,100,0,5,5
2014,Emelee,F,100,5,0,5
2014,Emelio,M,100,0,5,5
2014,Emerich,M,100,0,5,5
2014,Emeterio,M,100,0,5,5
2014,Emiel,M,100,0,5,5
2014,Emier,M,100,0,5,5
2014,Emika,F,100,5,0,5
2014,Emilliana,F,100,5,0,5
2014,Emmabeth,F,100,5,0,5
2014,Emmagene,F,100,5,0,5
2014,Emmakay,F,100,5,0,5
2014,Emmali,F,100,5,0,5
2014,Emmari,F,100,5,0,5
2014,Emmariah,F,100,5,0,5
2014,Emmelene,F,100,5,0,5
2014,Emmeric,M,100,0,5,5
2014,Emmilou,F,100,5,0,5
2014,Emmrie,F,100,5,0,5
2014,Emyah,F,100,5,0,5
2014,Emyri,F,100,5,0,5
2014,Emzley,F,100,5,0,5
2014,Enari,F,100,5,0,5
2014,Enas,F,100,5,0,5
2014,Enayah,F,100,5,0,5
2014,Eneida,F,100,5,0,5
2014,English,F,100,5,0,5
2014,Enrike,M,100,0,5,5
2014,Ephriam,M,100,0,5,5
2014,Equan,M,100,0,5,5
2014,Eraclio,M,100,0,5,5
2014,Erene,F,100,5,0,5
2014,Eriella,F,100,5,0,5
2014,Ermina,F,100,5,0,5
2014,Eryss,F,100,5,0,5
2014,Esam,M,100,0,5,5
2014,Escarleth,F,100,5,0,5
2014,Eshaun,M,100,0,5,5
2014,Eshawn,M,100,0,5,5
2014,Eshton,M,100,0,5,5
2014,Esias,M,100,0,5,5
2014,Esmael,M,100,0,5,5
2014,Esmarie,F,100,5,0,5
2014,Esmerie,F,100,5,0,5
2014,Essey,M,100,0,5,5
2014,Estefanie,F,100,5,0,5
2014,Estel,F,100,5,0,5
2014,Estevon,M,100,0,5,5
2014,Esthefany,F,100,5,0,5
2014,Esveidy,F,100,5,0,5
2014,Ethanael,M,100,0,5,5
2014,Ethelyn,F,100,5,0,5
2014,Ethin,M,100,0,5,5
2014,Ethon,M,100,0,5,5
2014,Etsub,F,100,5,0,5
2014,Ettie,F,100,5,0,5
2014,Eulogio,M,100,0,5,5
2014,Evamaria,F,100,5,0,5
2014,Evangelynn,F,100,5,0,5
2014,Evelene,F,100,5,0,5
2014,Evens,M,100,0,5,5
2014,Everlei,F,100,5,0,5
2014,Eversyn,F,100,5,0,5
2014,Evon,F,100,5,0,5
2014,Evvy,F,100,5,0,5
2014,Ewaoluwa,F,100,5,0,5
2014,Ewen,M,100,0,5,5
2014,Ewing,M,100,0,5,5
2014,Exander,M,100,0,5,5
2014,Eyani,F,100,5,0,5
2014,Ezabelle,F,100,5,0,5
2014,Ezariyah,F,100,5,0,5
2014,Ezayah,M,100,0,5,5
2014,Ezlynn,F,100,5,0,5
2014,Ezmariah,F,100,5,0,5
2014,Ezme,F,100,5,0,5
2014,Ezykiel,M,100,0,5,5
2014,Ezzah,F,100,5,0,5
2014,Faeryn,F,100,5,0,5
2014,Fahim,M,100,0,5,5
2014,Faige,F,100,5,0,5
2014,Faina,F,100,5,0,5
2014,Fajar,F,100,5,0,5
2014,Falen,F,100,5,0,5
2014,Fallan,F,100,5,0,5
2014,Fareeda,F,100,5,0,5
2014,Faruq,M,100,0,5,5
2014,Fatih,M,100,0,5,5
2014,Fatoumatta,F,100,5,0,5
2014,Fauna,F,100,5,0,5
2014,Fawzan,M,100,0,5,5
2014,Fayha,F,100,5,0,5
2014,Feather,F,100,5,0,5
2014,Felice,F,100,5,0,5
2014,Feliks,M,100,0,5,5
2014,Felina,F,100,5,0,5
2014,Felisa,F,100,5,0,5
2014,Fender,M,100,0,5,5
2014,Fenn,M,100,0,5,5
2014,Fiana,F,100,5,0,5
2014,Fields,M,100,0,5,5
2014,Filipa,F,100,5,0,5
2014,Fiorenza,F,100,5,0,5
2014,Firdous,F,100,5,0,5
2014,Fishel,M,100,0,5,5
2014,Fizza,F,100,5,0,5
2014,Florina,F,100,5,0,5
2014,Foday,M,100,0,5,5
2014,Forrester,M,100,0,5,5
2014,Fouzia,F,100,5,0,5
2014,Francely,F,100,5,0,5
2014,Frandy,M,100,0,5,5
2014,Franyelis,F,100,5,0,5
2014,Franziska,F,100,5,0,5
2014,Frasier,M,100,0,5,5
2014,Freeda,F,100,5,0,5
2014,Furious,M,100,0,5,5
2014,Fuzail,M,100,0,5,5
2014,Gabreilla,F,100,5,0,5
2014,Gad,M,100,0,5,5
2014,Gahel,M,100,0,5,5
2014,Galiyah,F,100,5,0,5
2014,Galya,F,100,5,0,5
2014,Gamble,M,100,0,5,5
2014,Gana,F,100,5,0,5
2014,Ganesh,M,100,0,5,5
2014,Gannicus,M,100,0,5,5
2014,Garran,M,100,0,5,5
2014,Garrette,M,100,0,5,5
2014,Garv,M,100,0,5,5
2014,Garvey,M,100,0,5,5
2014,Gatlen,M,100,0,5,5
2014,Gedalya,M,100,0,5,5
2014,Geetika,F,100,5,0,5
2014,Genaveve,F,100,5,0,5
2014,Genevive,F,100,5,0,5
2014,Genevy,F,100,5,0,5
2014,Genica,F,100,5,0,5
2014,Genie,F,100,5,0,5
2014,Gentrie,F,100,5,0,5
2014,Geon,M,100,0,5,5
2014,Georgiy,M,100,0,5,5
2014,Georgy,M,100,0,5,5
2014,Geraldy,F,100,5,0,5
2014,Gerhard,M,100,0,5,5
2014,Gerimiah,M,100,0,5,5
2014,Geselle,F,100,5,0,5
2014,Gevon,M,100,0,5,5
2014,Gewel,F,100,5,0,5
2014,Ghada,F,100,5,0,5
2014,Ghaith,M,100,0,5,5
2014,Giahan,F,100,5,0,5
2014,Giahna,F,100,5,0,5
2014,Giankarlo,M,100,0,5,5
2014,Gianmichael,M,100,0,5,5
2014,Giannarose,F,100,5,0,5
2014,Giannina,F,100,5,0,5
2014,Giara,F,100,5,0,5
2014,Giavannah,F,100,5,0,5
2014,Giddeon,M,100,0,5,5
2014,Gillianna,F,100,5,0,5
2014,Gionnie,M,100,0,5,5
2014,Girish,M,100,0,5,5
2014,Gita,F,100,5,0,5
2014,Gitanjali,F,100,5,0,5
2014,Giulliana,F,100,5,0,5
2014,Glover,M,100,0,5,5
2014,Gobind,M,100,0,5,5
2014,Godrick,M,100,0,5,5
2014,Gohar,F,100,5,0,5
2014,Goodness,F,100,5,0,5
2014,Goshen,M,100,0,5,5
2014,Gowtham,M,100,0,5,5
2014,Gracely,F,100,5,0,5
2014,Graciana,F,100,5,0,5
2014,Grantlee,M,100,0,5,5
2014,Grasen,M,100,0,5,5
2014,Graylynn,F,100,5,0,5
2014,Greylynn,F,100,5,0,5
2014,Griffey,M,100,0,5,5
2014,Grigory,M,100,0,5,5
2014,Griselle,F,100,5,0,5
2014,Grishma,F,100,5,0,5
2014,Guage,M,100,0,5,5
2014,Guinivere,F,100,5,0,5
2014,Guled,M,100,0,5,5
2014,Guneet,F,100,5,0,5
2014,Gurnaaz,F,100,5,0,5
2014,Gurseerat,F,100,5,0,5
2014,Gurshan,M,100,0,5,5
2014,Gurtaj,M,100,0,5,5
2014,Gweneviere,F,100,5,0,5
2014,Gwenyvere,F,100,5,0,5
2014,Haaken,M,100,0,5,5
2014,Haben,M,100,0,5,5
2014,Haby,F,100,5,0,5
2014,Hadara,F,100,5,0,5
2014,Hade,F,100,5,0,5
2014,Hadilyn,F,100,5,0,5
2014,Hadlei,F,100,5,0,5
2014,Hadleyann,F,100,5,0,5
2014,Hadya,F,100,5,0,5
2014,Hael,M,100,0,5,5
2014,Haevynn,F,100,5,0,5
2014,Hagar,F,100,5,0,5
2014,Haidy,F,100,5,0,5
2014,Hailen,F,100,5,0,5
2014,Haithem,M,100,0,5,5
2014,Haiti,F,100,5,0,5
2014,Haji,M,100,0,5,5
2014,Hajin,M,100,0,5,5
2014,Hajrah,F,100,5,0,5
2014,Haku,M,100,0,5,5
2014,Halayah,F,100,5,0,5
2014,Halil,M,100,0,5,5
2014,Halleli,F,100,5,0,5
2014,Halsey,F,100,5,0,5
2014,Hamidou,M,100,0,5,5
2014,Hammond,M,100,0,5,5
2014,Hamna,F,100,5,0,5
2014,Hamnah,F,100,5,0,5
2014,Hamsika,F,100,5,0,5
2014,Hamze,M,100,0,5,5
2014,Hanako,F,100,5,0,5
2014,Hanane,F,100,5,0,5
2014,Hanne,F,100,5,0,5
2014,Hannes,M,100,0,5,5
2014,Hanniel,M,100,0,5,5
2014,Hantz,M,100,0,5,5
2014,Hanya,F,100,5,0,5
2014,Harald,M,100,0,5,5
2014,Hardison,M,100,0,5,5
2014,Harjaap,M,100,0,5,5
2014,Harlequinn,F,100,5,0,5
2014,Harliee,F,100,5,0,5
2014,Harmany,F,100,5,0,5
2014,Harneet,F,100,5,0,5
2014,Harpyr,F,100,5,0,5
2014,Harseerat,F,100,5,0,5
2014,Harsimar,M,100,0,5,5
2014,Hartli,F,100,5,0,5
2014,Harut,M,100,0,5,5
2014,Harutyun,M,100,0,5,5
2014,Harvir,M,100,0,5,5
2014,Hasana,F,100,5,0,5
2014,Hasanat,F,100,5,0,5
2014,Hasib,M,100,0,5,5
2014,Hastiin,M,100,0,5,5
2014,Hastin,M,100,0,5,5
2014,Hastings,F,100,5,0,5
2014,Hatsumi,F,100,5,0,5
2014,Havanah,F,100,5,0,5
2014,Havier,M,100,0,5,5
2014,Havok,M,100,0,5,5
2014,Hawaii,F,100,5,0,5
2014,Hawraa,F,100,5,0,5
2014,Haydar,M,100,0,5,5
2014,Hayde,F,100,5,0,5
2014,Haylan,F,100,5,0,5
2014,Haylea,F,100,5,0,5
2014,Hayoon,F,100,5,0,5
2014,Hayston,M,100,0,5,5
2014,Hayward,M,100,0,5,5
2014,Hayzlie,F,100,5,0,5
2014,Hazelmarie,F,100,5,0,5
2014,Hazle,F,100,5,0,5
2014,Hazleigh,F,100,5,0,5
2014,Heart,F,100,5,0,5
2014,Heartly,F,100,5,0,5
2014,Heathcliff,M,100,0,5,5
2014,Heavan,F,100,5,0,5
2014,Heiden,M,100,0,5,5
2014,Hektor,M,100,0,5,5
2014,Hela,F,100,5,0,5
2014,Heleena,F,100,5,0,5
2014,Heleyna,F,100,5,0,5
2014,Helia,F,100,5,0,5
2014,Helin,F,100,5,0,5
2014,Hend,F,100,5,0,5
2014,Henon,M,100,0,5,5
2014,Henrie,M,100,0,5,5
2014,Heri,M,100,0,5,5
2014,Hermann,M,100,0,5,5
2014,Hernando,M,100,0,5,5
2014,Heyab,F,100,5,0,5
2014,Heylin,F,100,5,0,5
2014,Hezakiah,M,100,0,5,5
2014,Hibah,F,100,5,0,5
2014,Hidayah,F,100,5,0,5
2014,Hind,F,100,5,0,5
2014,Hinson,M,100,0,5,5
2014,Hinton,M,100,0,5,5
2014,Hiromi,F,100,5,0,5
2014,Hirsch,M,100,0,5,5
2014,Hitha,F,100,5,0,5
2014,Hiwot,F,100,5,0,5
2014,Holder,M,100,0,5,5
2014,Holsten,M,100,0,5,5
2014,Homar,M,100,0,5,5
2014,Honestie,F,100,5,0,5
2014,Hongyu,M,100,0,5,5
2014,Hosam,M,100,0,5,5
2014,Hriday,M,100,0,5,5
2014,Hridya,F,100,5,0,5
2014,Hrishikesh,M,100,0,5,5
2014,Hriyaan,M,100,0,5,5
2014,Hudeyfa,M,100,0,5,5
2014,Hudsynn,F,100,5,0,5
2014,Humayra,F,100,5,0,5
2014,Hussien,M,100,0,5,5
2014,Huzaifah,M,100,0,5,5
2014,Hy,M,100,0,5,5
2014,Hylan,M,100,0,5,5
2014,Iba,F,100,5,0,5
2014,Ibaad,M,100,0,5,5
2014,Ibeth,F,100,5,0,5
2014,Ibiza,F,100,5,0,5
2014,Ibtihal,F,100,5,0,5
2014,Icarus,M,100,0,5,5
2014,Iceis,F,100,5,0,5
2014,Icesis,F,100,5,0,5
2014,Idalynn,F,100,5,0,5
2014,Ieshia,F,100,5,0,5
2014,Ifra,F,100,5,0,5
2014,Iftu,F,100,5,0,5
2014,Ignacia,F,100,5,0,5
2014,Iiyana,F,100,5,0,5
2014,Ikechi,M,100,0,5,5
2014,Ikra,F,100,5,0,5
2014,Ikram,F,100,5,0,5
2014,Ilanna,F,100,5,0,5
2014,Iliani,F,100,5,0,5
2014,Iliany,F,100,5,0,5
2014,Iliyana,F,100,5,0,5
2014,Illana,F,100,5,0,5
2014,Illya,M,100,0,5,5
2014,Illyas,M,100,0,5,5
2014,Ilsy,F,100,5,0,5
2014,Imena,F,100,5,0,5
2014,Imiyah,F,100,5,0,5
2014,Imron,M,100,0,5,5
2014,Inayat,F,100,5,0,5
2014,Indyia,F,100,5,0,5
2014,Infiniti,F,100,5,0,5
2014,Iniko,M,100,0,5,5
2014,Inri,M,100,0,5,5
2014,Insiyah,F,100,5,0,5
2014,Iokepa,M,100,0,5,5
2014,Iolana,F,100,5,0,5
2014,Iqlas,F,100,5,0,5
2014,Iralynn,F,100,5,0,5
2014,Iriee,F,100,5,0,5
2014,Isaic,M,100,0,5,5
2014,Isalena,F,100,5,0,5
2014,Isana,F,100,5,0,5
2014,Isbella,F,100,5,0,5
2014,Iseah,M,100,0,5,5
2014,Isel,F,100,5,0,5
2014,Isen,M,100,0,5,5
2014,Ishak,M,100,0,5,5
2014,Ishta,F,100,5,0,5
2014,Isias,M,100,0,5,5
2014,Isobelle,F,100,5,0,5
2014,Israe,F,100,5,0,5
2014,Israela,F,100,5,0,5
2014,Issabela,F,100,5,0,5
2014,Issabell,F,100,5,0,5
2014,Issis,F,100,5,0,5
2014,Itali,F,100,5,0,5
2014,Italya,F,100,5,0,5
2014,Itayetzi,F,100,5,0,5
2014,Ithalia,F,100,5,0,5
2014,Ithiel,M,100,0,5,5
2014,Itiel,M,100,0,5,5
2014,Ivary,F,100,5,0,5
2014,Ivelise,F,100,5,0,5
2014,Ivymarie,F,100,5,0,5
2014,Iyona,F,100,5,0,5
2014,Izach,M,100,0,5,5
2014,Izah,M,100,0,5,5
2014,Izaia,M,100,0,5,5
2014,Izalea,F,100,5,0,5
2014,Izeiah,M,100,0,5,5
2014,Izella,F,100,5,0,5
2014,Izna,F,100,5,0,5
2014,Izora,F,100,5,0,5
2014,Izyk,M,100,0,5,5
2014,Izzaiah,M,100,0,5,5
2014,Izzybella,F,100,5,0,5
2014,Jaad,M,100,0,5,5
2014,Jaasia,F,100,5,0,5
2014,Jacaiden,M,100,0,5,5
2014,Jacarter,M,100,0,5,5
2014,Jacere,M,100,0,5,5
2014,Jaceton,M,100,0,5,5
2014,Jacione,M,100,0,5,5
2014,Jackelynn,F,100,5,0,5
2014,Jackhenry,M,100,0,5,5
2014,Jacksin,M,100,0,5,5
2014,Jaco,M,100,0,5,5
2014,Jacoba,F,100,5,0,5
2014,Jacobanthony,M,100,0,5,5
2014,Jacorion,M,100,0,5,5
2014,Jacoub,M,100,0,5,5
2014,Jacquelyne,F,100,5,0,5
2014,Jacquline,F,100,5,0,5
2014,Jadayah,F,100,5,0,5
2014,Jademarie,F,100,5,0,5
2014,Jadir,M,100,0,5,5
2014,Jadis,M,100,0,5,5
2014,Jaeceion,M,100,0,5,5
2014,Jaecia,F,100,5,0,5
2014,Jaell,M,100,0,5,5
2014,Jaelyne,F,100,5,0,5
2014,Jaesean,M,100,0,5,5
2014,Jaeshaun,M,100,0,5,5
2014,Jaguar,M,100,0,5,5
2014,Jah,M,100,0,5,5
2014,Jahanna,F,100,5,0,5
2014,Jaharie,M,100,0,5,5
2014,Jahbari,M,100,0,5,5
2014,Jahlon,M,100,0,5,5
2014,Jahmani,M,100,0,5,5
2014,Jahmil,M,100,0,5,5
2014,Jahnessa,F,100,5,0,5
2014,Jahniece,F,100,5,0,5
2014,Jahon,M,100,0,5,5
2014,Jahrell,M,100,0,5,5
2014,Jahshua,M,100,0,5,5
2014,Jahsi,M,100,0,5,5
2014,Jahya,F,100,5,0,5
2014,Jahzarra,F,100,5,0,5
2014,Jailei,F,100,5,0,5
2014,Jaimin,M,100,0,5,5
2014,Jainil,M,100,0,5,5
2014,Jaiquan,M,100,0,5,5
2014,Jaira,F,100,5,0,5
2014,Jaisean,M,100,0,5,5
2014,Jaiseon,M,100,0,5,5
2014,Jaishaun,M,100,0,5,5
2014,Jaishawn,M,100,0,5,5
2014,Jaishon,M,100,0,5,5
2014,Jaisley,F,100,5,0,5
2014,Jaivian,M,100,0,5,5
2014,Jaizen,M,100,0,5,5
2014,Jaizon,M,100,0,5,5
2014,Jakalyn,F,100,5,0,5
2014,Jakaree,M,100,0,5,5
2014,Jakaria,F,100,5,0,5
2014,Jakarie,M,100,0,5,5
2014,Jakavian,M,100,0,5,5
2014,Jakaya,F,100,5,0,5
2014,Jakeith,M,100,0,5,5
2014,Jakiyla,F,100,5,0,5
2014,Jakorey,M,100,0,5,5
2014,Jaks,M,100,0,5,5
2014,Jaksen,M,100,0,5,5
2014,Jakyia,F,100,5,0,5
2014,Jakylan,M,100,0,5,5
2014,Jakyle,M,100,0,5,5
2014,Jakylee,F,100,5,0,5
2014,Jakylen,M,100,0,5,5
2014,Jakyren,M,100,0,5,5
2014,Jalaiah,F,100,5,0,5
2014,Jalaila,F,100,5,0,5
2014,Jalaysha,F,100,5,0,5
2014,Jalayshia,F,100,5,0,5
2014,Jaleea,F,100,5,0,5
2014,Jaleil,M,100,0,5,5
2014,Jaleiyah,F,100,5,0,5
2014,Jalene,F,100,5,0,5
2014,Jalexia,F,100,5,0,5
2014,Jalexie,F,100,5,0,5
2014,Jalexy,F,100,5,0,5
2014,Jaleya,F,100,5,0,5
2014,Jalijah,M,100,0,5,5
2014,Jaliyha,F,100,5,0,5
2014,Jaloni,F,100,5,0,5
2014,Jalonni,M,100,0,5,5
2014,Jamail,M,100,0,5,5
2014,Jamarien,M,100,0,5,5
2014,Jamaris,M,100,0,5,5
2014,Jamarques,M,100,0,5,5
2014,Jameila,F,100,5,0,5
2014,Jamele,M,100,0,5,5
2014,Jamella,F,100,5,0,5
2014,Jamelle,M,100,0,5,5
2014,Jamesdean,M,100,0,5,5
2014,Jamese,F,100,5,0,5
2014,Jamesley,M,100,0,5,5
2014,Jamespatrick,M,100,0,5,5
2014,Jameya,F,100,5,0,5
2014,Jamias,M,100,0,5,5
2014,Jamielyn,F,100,5,0,5
2014,Jamilette,F,100,5,0,5
2014,Jamillah,F,100,5,0,5
2014,Jamonie,M,100,0,5,5
2014,Jamorris,M,100,0,5,5
2014,Jamus,M,100,0,5,5
2014,Janaki,F,100,5,0,5
2014,Janard,M,100,0,5,5
2014,Janari,F,100,5,0,5
2014,Janariah,F,100,5,0,5
2014,Janas,M,100,0,5,5
2014,Jance,M,100,0,5,5
2014,Jandre,M,100,0,5,5
2014,Jandriel,M,100,0,5,5
2014,Janellys,F,100,5,0,5
2014,Janelyz,F,100,5,0,5
2014,Janica,F,100,5,0,5
2014,Janick,M,100,0,5,5
2014,Janika,F,100,5,0,5
2014,Janitza,F,100,5,0,5
2014,Janko,M,100,0,5,5
2014,Jannae,F,100,5,0,5
2014,Jannalyn,F,100,5,0,5
2014,Janovia,F,100,5,0,5
2014,Janyce,F,100,5,0,5
2014,Janye,F,100,5,0,5
2014,Janzen,M,100,0,5,5
2014,Jaonna,F,100,5,0,5
2014,Japnoor,F,100,5,0,5
2014,Jaquae,M,100,0,5,5
2014,Jareli,F,100,5,0,5
2014,Jarelyn,F,100,5,0,5
2014,Jaretsy,F,100,5,0,5
2014,Jarianna,F,100,5,0,5
2014,Jariell,M,100,0,5,5
2014,Jarrius,M,100,0,5,5
2014,Jaryan,M,100,0,5,5
2014,Jasan,M,100,0,5,5
2014,Jash,M,100,0,5,5
2014,Jasibe,F,100,5,0,5
2014,Jasik,M,100,0,5,5
2014,Jasira,F,100,5,0,5
2014,Jasleene,F,100,5,0,5
2014,Jasly,F,100,5,0,5
2014,Jasmen,F,100,5,0,5
2014,Jassar,M,100,0,5,5
2014,Jastin,M,100,0,5,5
2014,Jasyiah,M,100,0,5,5
2014,Jasyn,M,100,0,5,5
2014,Jatin,M,100,0,5,5
2014,Jauan,M,100,0,5,5
2014,Javale,M,100,0,5,5
2014,Javani,M,100,0,5,5
2014,Javares,M,100,0,5,5
2014,Javaun,M,100,0,5,5
2014,Javayah,F,100,5,0,5
2014,Javed,M,100,0,5,5
2014,Javel,M,100,0,5,5
2014,Javeya,F,100,5,0,5
2014,Javione,M,100,0,5,5
2014,Javonne,M,100,0,5,5
2014,Jawaan,M,100,0,5,5
2014,Jawaher,F,100,5,0,5
2014,Jawuan,M,100,0,5,5
2014,Jaxel,M,100,0,5,5
2014,Jaxlyn,F,100,5,0,5
2014,Jaxs,M,100,0,5,5
2014,Jaxsten,M,100,0,5,5
2014,Jaxstin,M,100,0,5,5
2014,Jaybriel,M,100,0,5,5
2014,Jaycek,M,100,0,5,5
2014,Jayceonna,F,100,5,0,5
2014,Jaydiel,M,100,0,5,5
2014,Jaydynn,F,100,5,0,5
2014,Jayelynn,F,100,5,0,5
2014,Jayesh,M,100,0,5,5
2014,Jayin,M,100,0,5,5
2014,Jayion,M,100,0,5,5
2014,Jaykon,M,100,0,5,5
2014,Jaylaa,F,100,5,0,5
2014,Jaylex,M,100,0,5,5
2014,Jaylianiz,F,100,5,0,5
2014,Jayliannie,F,100,5,0,5
2014,Jayliany,F,100,5,0,5
2014,Jaymari,M,100,0,5,5
2014,Jaymez,M,100,0,5,5
2014,Jaymis,M,100,0,5,5
2014,Jayonni,F,100,5,0,5
2014,Jaysan,M,100,0,5,5
2014,Jaysie,F,100,5,0,5
2014,Jayten,M,100,0,5,5
2014,Jaytin,M,100,0,5,5
2014,Jayva,F,100,5,0,5
2014,Jayze,M,100,0,5,5
2014,Jazabella,F,100,5,0,5
2014,Jazaiya,F,100,5,0,5
2014,Jazer,M,100,0,5,5
2014,Jazib,M,100,0,5,5
2014,Jazirah,F,100,5,0,5
2014,Jazlee,F,100,5,0,5
2014,Jazly,F,100,5,0,5
2014,Jazzie,F,100,5,0,5
2014,Jeanetta,F,100,5,0,5
2014,Jebidiah,M,100,0,5,5
2014,Jecaryous,M,100,0,5,5
2014,Jediael,M,100,0,5,5
2014,Jeida,F,100,5,0,5
2014,Jeidan,M,100,0,5,5
2014,Jeila,F,100,5,0,5
2014,Jeilany,F,100,5,0,5
2014,Jeilene,F,100,5,0,5
2014,Jelanie,F,100,5,0,5
2014,Jeleah,F,100,5,0,5
2014,Jelynn,F,100,5,0,5
2014,Jemal,M,100,0,5,5
2014,Jemar,M,100,0,5,5
2014,Jemini,M,100,0,5,5
2014,Jemiyah,F,100,5,0,5
2014,Jenalee,F,100,5,0,5
2014,Jenalise,F,100,5,0,5
2014,Jenavy,F,100,5,0,5
2014,Jency,F,100,5,0,5
2014,Jenee,F,100,5,0,5
2014,Jenessis,F,100,5,0,5
2014,Jeniveve,F,100,5,0,5
2014,Jennesis,F,100,5,0,5
2014,Jenry,M,100,0,5,5
2014,Jenziel,M,100,0,5,5
2014,Jepson,M,100,0,5,5
2014,Jerad,M,100,0,5,5
2014,Jerami,M,100,0,5,5
2014,Jerian,M,100,0,5,5
2014,Jerilynn,F,100,5,0,5
2014,Jerimy,M,100,0,5,5
2014,Jerman,M,100,0,5,5
2014,Jermane,M,100,0,5,5
2014,Jermanie,F,100,5,0,5
2014,Jermar,M,100,0,5,5
2014,Jermone,M,100,0,5,5
2014,Jermya,F,100,5,0,5
2014,Jermyah,F,100,5,0,5
2014,Jermyra,F,100,5,0,5
2014,Jernei,F,100,5,0,5
2014,Jerra,F,100,5,0,5
2014,Jerri,F,100,5,0,5
2014,Jersiah,M,100,0,5,5
2014,Jeryiah,F,100,5,0,5
2014,Jessamyn,F,100,5,0,5
2014,Jessel,F,100,5,0,5
2014,Jessyca,F,100,5,0,5
2014,Jestina,F,100,5,0,5
2014,Jesy,F,100,5,0,5
2014,Jetlyn,F,100,5,0,5
2014,Jettie,F,100,5,0,5
2014,Jettsen,M,100,0,5,5
2014,Jeudy,M,100,0,5,5
2014,Jewelianna,F,100,5,0,5
2014,Jeyda,F,100,5,0,5
2014,Jeydi,F,100,5,0,5
2014,Jeylan,M,100,0,5,5
2014,Jeylianis,F,100,5,0,5
2014,Jhada,F,100,5,0,5
2014,Jhai,M,100,0,5,5
2014,Jhamar,M,100,0,5,5
2014,Jhan,M,100,0,5,5
2014,Jhaniya,F,100,5,0,5
2014,Jhayce,M,100,0,5,5
2014,Jhoseline,F,100,5,0,5
2014,Jiair,M,100,0,5,5
2014,Jiani,F,100,5,0,5
2014,Jiaqi,F,100,5,0,5
2014,Jiayi,F,100,5,0,5
2014,Jihoo,M,100,0,5,5
2014,Jillianne,F,100,5,0,5
2014,Jimari,M,100,0,5,5
2014,Jioni,M,100,0,5,5
2014,Jionna,F,100,5,0,5
2014,Jiovany,M,100,0,5,5
2014,Jisaiah,M,100,0,5,5
2014,Jisella,F,100,5,0,5
2014,Jisha,F,100,5,0,5
2014,Jiyan,M,100,0,5,5
2014,Jkai,M,100,0,5,5
2014,Jlaya,F,100,5,0,5
2014,Jlyn,M,100,0,5,5
2014,Jmichael,M,100,0,5,5
2014,Jnae,F,100,5,0,5
2014,Jniyah,F,100,5,0,5
2014,Joaly,F,100,5,0,5
2014,Joandy,M,100,0,5,5
2014,Joaopedro,M,100,0,5,5
2014,Jocilynn,F,100,5,0,5
2014,Jodiel,M,100,0,5,5
2014,Joeanna,F,100,5,0,5
2014,Joeli,F,100,5,0,5
2014,Joelys,F,100,5,0,5
2014,Joetta,F,100,5,0,5
2014,Johanne,F,100,5,0,5
2014,Johna,F,100,5,0,5
2014,Johnell,M,100,0,5,5
2014,Johngabriel,M,100,0,5,5
2014,Johnwesley,M,100,0,5,5
2014,Jolea,F,100,5,0,5
2014,Joleah,F,100,5,0,5
2014,Jolean,F,100,5,0,5
2014,Jolen,M,100,0,5,5
2014,Jolia,F,100,5,0,5
2014,Jolyon,M,100,0,5,5
2014,Jonavan,M,100,0,5,5
2014,Jonaven,M,100,0,5,5
2014,Jonaye,F,100,5,0,5
2014,Jondavid,M,100,0,5,5
2014,Joneer,F,100,5,0,5
2014,Jonh,M,100,0,5,5
2014,Jonita,F,100,5,0,5
2014,Jonnah,M,100,0,5,5
2014,Jonothan,M,100,0,5,5
2014,Jonovan,M,100,0,5,5
2014,Jony,M,100,0,5,5
2014,Joram,M,100,0,5,5
2014,Jordani,M,100,0,5,5
2014,Jordanny,M,100,0,5,5
2014,Jorrell,M,100,0,5,5
2014,Josaih,M,100,0,5,5
2014,Josedaniel,M,100,0,5,5
2014,Joselle,F,100,5,0,5
2014,Joselynne,F,100,5,0,5
2014,Josep,M,100,0,5,5
2014,Joshalyn,F,100,5,0,5
2014,Joshalynn,F,100,5,0,5
2014,Joshawn,M,100,0,5,5
2014,Josielynn,F,100,5,0,5
2014,Josniel,M,100,0,5,5
2014,Josselynn,F,100,5,0,5
2014,Josten,M,100,0,5,5
2014,Josua,M,100,0,5,5
2014,Josuel,M,100,0,5,5
2014,Journeigh,F,100,5,0,5
2014,Jovey,F,100,5,0,5
2014,Jovoni,M,100,0,5,5
2014,Joycee,F,100,5,0,5
2014,Jozalynn,F,100,5,0,5
2014,Jozyah,M,100,0,5,5
2014,Jp,M,100,0,5,5
2014,Jquan,M,100,0,5,5
2014,Jraya,F,100,5,0,5
2014,Jrayden,M,100,0,5,5
2014,Jshaun,M,100,0,5,5
2014,Jud,M,100,0,5,5
2014,Judie,F,100,5,0,5
2014,Julani,F,100,5,0,5
2014,Juleen,F,100,5,0,5
2014,Julep,F,100,5,0,5
2014,Juliannie,F,100,5,0,5
2014,Juliarose,F,100,5,0,5
2014,Jullianna,F,100,5,0,5
2014,Junah,M,100,0,5,5
2014,Junayd,M,100,0,5,5
2014,Junhao,M,100,0,5,5
2014,Junious,M,100,0,5,5
2014,Junius,M,100,0,5,5
2014,Junjie,M,100,0,5,5
2014,Junxi,M,100,0,5,5
2014,Jura,F,100,5,0,5
2014,Justise,F,100,5,0,5
2014,Justiss,F,100,5,0,5
2014,Justyna,F,100,5,0,5
2014,Justyne,F,100,5,0,5
2014,Jusuf,M,100,0,5,5
2014,Juvencio,M,100,0,5,5
2014,Juwon,M,100,0,5,5
2014,Jwan,F,100,5,0,5
2014,Jya,F,100,5,0,5
2014,Jymir,M,100,0,5,5
2014,Jyron,M,100,0,5,5
2014,Kabren,M,100,0,5,5
2014,Kaceson,M,100,0,5,5
2014,Kaceyon,M,100,0,5,5
2014,Kacia,F,100,5,0,5
2014,Kaddy,F,100,5,0,5
2014,Kadey,F,100,5,0,5
2014,Kadijah,F,100,5,0,5
2014,Kado,M,100,0,5,5
2014,Kaenon,M,100,0,5,5
2014,Kager,M,100,0,5,5
2014,Kahden,M,100,0,5,5
2014,Kahekili,M,100,0,5,5
2014,Kahleb,M,100,0,5,5
2014,Kahleil,M,100,0,5,5
2014,Kahlen,F,100,5,0,5
2014,Kahlin,M,100,0,5,5
2014,Kahlyn,F,100,5,0,5
2014,Kahner,M,100,0,5,5
2014,Kahtai,M,100,0,5,5
2014,Kaianna,F,100,5,0,5
2014,Kaido,M,100,0,5,5
2014,Kaii,M,100,0,5,5
2014,Kailanie,F,100,5,0,5
2014,Kailanni,F,100,5,0,5
2014,Kailo,M,100,0,5,5
2014,Kaimen,M,100,0,5,5
2014,Kaimi,F,100,5,0,5
2014,Kaina,F,100,5,0,5
2014,Kairah,F,100,5,0,5
2014,Kairen,M,100,0,5,5
2014,Kairy,F,100,5,0,5
2014,Kaisan,M,100,0,5,5
2014,Kaisin,M,100,0,5,5
2014,Kaitelyn,F,100,5,0,5
2014,Kaithleen,F,100,5,0,5
2014,Kaithlynn,F,100,5,0,5
2014,Kaiwen,M,100,0,5,5
2014,Kaiyana,F,100,5,0,5
2014,Kaiyla,F,100,5,0,5
2014,Kaizleigh,F,100,5,0,5
2014,Kajuan,M,100,0,5,5
2014,Kalah,F,100,5,0,5
2014,Kalaiah,F,100,5,0,5
2014,Kalana,F,100,5,0,5
2014,Kaleen,F,100,5,0,5
2014,Kalell,M,100,0,5,5
2014,Kalieb,M,100,0,5,5
2014,Kalim,M,100,0,5,5
2014,Kallea,F,100,5,0,5
2014,Kalonie,F,100,5,0,5
2014,Kamai,M,100,0,5,5
2014,Kamakana,M,100,0,5,5
2014,Kamali,M,100,0,5,5
2014,Kamare,M,100,0,5,5
2014,Kamareon,M,100,0,5,5
2014,Kamarious,M,100,0,5,5
2014,Kamarius,M,100,0,5,5
2014,Kambrea,F,100,5,0,5
2014,Kambrya,F,100,5,0,5
2014,Kamerion,M,100,0,5,5
2014,Kamijah,F,100,5,0,5
2014,Kamill,F,100,5,0,5
2014,Kamir,M,100,0,5,5
2014,Kamlyn,F,100,5,0,5
2014,Kamm,M,100,0,5,5
2014,Kamor,F,100,5,0,5
2014,Kamoria,F,100,5,0,5
2014,Kamrey,F,100,5,0,5
2014,Kamylla,F,100,5,0,5
2014,Kamyrah,F,100,5,0,5
2014,Kaname,F,100,5,0,5
2014,Kanari,F,100,5,0,5
2014,Kanta,M,100,0,5,5
2014,Kany,F,100,5,0,5
2014,Kaon,M,100,0,5,5
2014,Kapena,M,100,0,5,5
2014,Karabella,F,100,5,0,5
2014,Karaleigh,F,100,5,0,5
2014,Karar,M,100,0,5,5
2014,Karaya,F,100,5,0,5
2014,Karden,M,100,0,5,5
2014,Karel,M,100,0,5,5
2014,Karelyn,F,100,5,0,5
2014,Karidee,F,100,5,0,5
2014,Karieliz,F,100,5,0,5
2014,Karion,M,100,0,5,5
2014,Kariya,F,100,5,0,5
2014,Karleah,F,100,5,0,5
2014,Karloz,M,100,0,5,5
2014,Karm,M,100,0,5,5
2014,Karmani,F,100,5,0,5
2014,Karmyne,M,100,0,5,5
2014,Karrar,M,100,0,5,5
2014,Karrissa,F,100,5,0,5
2014,Karry,F,100,5,0,5
2014,Karynn,F,100,5,0,5
2014,Kaselyn,F,100,5,0,5
2014,Kasem,M,100,0,5,5
2014,Kashae,F,100,5,0,5
2014,Kashe,M,100,0,5,5
2014,Kashish,F,100,5,0,5
2014,Kasiah,F,100,5,0,5
2014,Kaspian,M,100,0,5,5
2014,Kass,M,100,0,5,5
2014,Kassondra,F,100,5,0,5
2014,Kassydi,F,100,5,0,5
2014,Kastyn,M,100,0,5,5
2014,Katee,F,100,5,0,5
2014,Kateryn,F,100,5,0,5
2014,Kathelyn,F,100,5,0,5
2014,Kathlynn,F,100,5,0,5
2014,Kathrynne,F,100,5,0,5
2014,Katrice,F,100,5,0,5
2014,Katrine,F,100,5,0,5
2014,Katryna,F,100,5,0,5
2014,Katsumi,F,100,5,0,5
2014,Kaushal,M,100,0,5,5
2014,Kavita,F,100,5,0,5
2014,Kawai,M,100,0,5,5
2014,Kaycey,F,100,5,0,5
2014,Kayd,M,100,0,5,5
2014,Kaydie,F,100,5,0,5
2014,Kaydra,F,100,5,0,5
2014,Kaydree,F,100,5,0,5
2014,Kayelle,F,100,5,0,5
2014,Kayhan,M,100,0,5,5
2014,Kayia,F,100,5,0,5
2014,Kaylamarie,F,100,5,0,5
2014,Kayleeh,F,100,5,0,5
2014,Kaylii,F,100,5,0,5
2014,Kaymon,M,100,0,5,5
2014,Kayna,F,100,5,0,5
2014,Kazden,M,100,0,5,5
2014,Kaziya,F,100,5,0,5
2014,Kealey,F,100,5,0,5
2014,Kealohilani,F,100,5,0,5
2014,Keanthony,M,100,0,5,5
2014,Kearra,F,100,5,0,5
2014,Kearsten,F,100,5,0,5
2014,Kearstin,F,100,5,0,5
2014,Kearston,F,100,5,0,5
2014,Keason,M,100,0,5,5
2014,Keatin,M,100,0,5,5
2014,Keaysia,F,100,5,0,5
2014,Kebin,M,100,0,5,5
2014,Kedrian,M,100,0,5,5
2014,Keeana,F,100,5,0,5
2014,Keedan,M,100,0,5,5
2014,Keeland,M,100,0,5,5
2014,Keelia,F,100,5,0,5
2014,Keevin,M,100,0,5,5
2014,Keigo,M,100,0,5,5
2014,Keilanie,F,100,5,0,5
2014,Keileb,M,100,0,5,5
2014,Keimarion,M,100,0,5,5
2014,Keimiyah,F,100,5,0,5
2014,Keimon,M,100,0,5,5
2014,Keimora,F,100,5,0,5
2014,Keiner,M,100,0,5,5
2014,Keionna,F,100,5,0,5
2014,Keiren,M,100,0,5,5
2014,Keirstin,F,100,5,0,5
2014,Keisuke,M,100,0,5,5
2014,Kelaia,F,100,5,0,5
2014,Keldrick,M,100,0,5,5
2014,Kelii,M,100,0,5,5
2014,Kelliann,F,100,5,0,5
2014,Kellise,F,100,5,0,5
2014,Kemaria,F,100,5,0,5
2014,Kemariah,F,100,5,0,5
2014,Kemarrion,M,100,0,5,5
2014,Kemi,F,100,5,0,5
2014,Kemia,F,100,5,0,5
2014,Kemonte,M,100,0,5,5
2014,Kemorah,F,100,5,0,5
2014,Kemyra,F,100,5,0,5
2014,Kenard,M,100,0,5,5
2014,Kenay,M,100,0,5,5
2014,Kenderick,M,100,0,5,5
2014,Kendraya,F,100,5,0,5
2014,Kendree,F,100,5,0,5
2014,Kenedee,F,100,5,0,5
2014,Kenenna,M,100,0,5,5
2014,Keniah,F,100,5,0,5
2014,Kenichi,M,100,0,5,5
2014,Kenil,M,100,0,5,5
2014,Kenndra,F,100,5,0,5
2014,Kennett,M,100,0,5,5
2014,Kennison,F,100,5,0,5
2014,Kennlee,F,100,5,0,5
2014,Kennydi,F,100,5,0,5
2014,Kenon,M,100,0,5,5
2014,Kensyn,M,100,0,5,5
2014,Kently,F,100,5,0,5
2014,Kenz,F,100,5,0,5
2014,Kenzlei,F,100,5,0,5
2014,Kenzye,F,100,5,0,5
2014,Kerissa,F,100,5,0,5
2014,Kerly,F,100,5,0,5
2014,Kerrie,F,100,5,0,5
2014,Kerron,M,100,0,5,5
2014,Kershaw,M,100,0,5,5
2014,Kesia,F,100,5,0,5
2014,Kesleigh,F,100,5,0,5
2014,Kessley,F,100,5,0,5
2014,Ketan,M,100,0,5,5
2014,Ketch,M,100,0,5,5
2014,Kethan,M,100,0,5,5
2014,Ketsia,F,100,5,0,5
2014,Keveon,M,100,0,5,5
2014,Key,M,100,0,5,5
2014,Keyarah,F,100,5,0,5
2014,Keydi,F,100,5,0,5
2014,Keyen,M,100,0,5,5
2014,Keymari,M,100,0,5,5
2014,Keymiah,F,100,5,0,5
2014,Keymonie,M,100,0,5,5
2014,Keymya,F,100,5,0,5
2014,Keyonta,M,100,0,5,5
2014,Keyshon,M,100,0,5,5
2014,Keyshun,M,100,0,5,5
2014,Keyth,M,100,0,5,5
2014,Kezion,M,100,0,5,5
2014,Khadar,M,100,0,5,5
2014,Khady,F,100,5,0,5
2014,Khaelynn,F,100,5,0,5
2014,Khaleem,M,100,0,5,5
2014,Khaleesy,F,100,5,0,5
2014,Khaleil,M,100,0,5,5
2014,Khaleya,F,100,5,0,5
2014,Khaleyah,F,100,5,0,5
2014,Khalli,F,100,5,0,5
2014,Khaloni,F,100,5,0,5
2014,Khamir,M,100,0,5,5
2014,Khaniyah,F,100,5,0,5
2014,Khaos,M,100,0,5,5
2014,Kharley,F,100,5,0,5
2014,Kharmen,F,100,5,0,5
2014,Khasir,M,100,0,5,5
2014,Khawlah,F,100,5,0,5
2014,Khaydin,M,100,0,5,5
2014,Khilan,M,100,0,5,5
2014,Khileigh,F,100,5,0,5
2014,Khing,M,100,0,5,5
2014,Khiyah,F,100,5,0,5
2014,Kholby,M,100,0,5,5
2014,Kholten,M,100,0,5,5
2014,Khristal,F,100,5,0,5
2014,Khristan,M,100,0,5,5
2014,Khristina,F,100,5,0,5
2014,Khyara,F,100,5,0,5
2014,Khylar,M,100,0,5,5
2014,Kiala,F,100,5,0,5
2014,Kiean,M,100,0,5,5
2014,Kiegan,M,100,0,5,5
2014,Kihana,F,100,5,0,5
2014,Kihara,F,100,5,0,5
2014,Kijon,M,100,0,5,5
2014,Kileah,F,100,5,0,5
2014,Kilen,M,100,0,5,5
2014,Kimara,F,100,5,0,5
2014,Kimberlly,F,100,5,0,5
2014,Kimmi,F,100,5,0,5
2014,Kimori,F,100,5,0,5
2014,Kindyl,F,100,5,0,5
2014,Kinganthony,M,100,0,5,5
2014,Kingdon,M,100,0,5,5
2014,Kingjoseph,M,100,0,5,5
2014,Kingstan,M,100,0,5,5
2014,Kinnidi,F,100,5,0,5
2014,Kinson,M,100,0,5,5
2014,Kiree,M,100,0,5,5
2014,Kiser,M,100,0,5,5
2014,Kiyani,F,100,5,0,5
2014,Kiylah,F,100,5,0,5
2014,Kjay,M,100,0,5,5
2014,Kla,F,100,5,0,5
2014,Klayten,M,100,0,5,5
2014,Kliyah,F,100,5,0,5
2014,Kmari,F,100,5,0,5
2014,Kniyah,F,100,5,0,5
2014,Knova,F,100,5,0,5
2014,Knoxville,M,100,0,5,5
2014,Koan,M,100,0,5,5
2014,Kodey,M,100,0,5,5
2014,Kohyn,M,100,0,5,5
2014,Kokomi,F,100,5,0,5
2014,Kolawole,M,100,0,5,5
2014,Kolbey,M,100,0,5,5
2014,Kollier,M,100,0,5,5
2014,Kolyn,M,100,0,5,5
2014,Konstance,F,100,5,0,5
2014,Koraleigh,F,100,5,0,5
2014,Koray,M,100,0,5,5
2014,Korea,F,100,5,0,5
2014,Koren,M,100,0,5,5
2014,Korianna,F,100,5,0,5
2014,Korilynn,F,100,5,0,5
2014,Kornelius,M,100,0,5,5
2014,Korrina,F,100,5,0,5
2014,Kortana,F,100,5,0,5
2014,Korynne,F,100,5,0,5
2014,Kosei,M,100,0,5,5
2014,Kostantinos,M,100,0,5,5
2014,Kostas,M,100,0,5,5
2014,Kourtland,M,100,0,5,5
2014,Kraig,M,100,0,5,5
2014,Krimsyn,F,100,5,0,5
2014,Krisean,M,100,0,5,5
2014,Krishal,M,100,0,5,5
2014,Krishil,M,100,0,5,5
2014,Krisley,F,100,5,0,5
2014,Kriss,M,100,0,5,5
2014,Krisstopher,M,100,0,5,5
2014,Kristabel,F,100,5,0,5
2014,Kristabella,F,100,5,0,5
2014,Kristain,M,100,0,5,5
2014,Kristalynn,F,100,5,0,5
2014,Krithika,F,100,5,0,5
2014,Kriyansh,M,100,0,5,5
2014,Krrish,M,100,0,5,5
2014,Kruize,M,100,0,5,5
2014,Krys,F,100,5,0,5
2014,Kryslynn,F,100,5,0,5
2014,Krystalyn,F,100,5,0,5
2014,Krystianna,F,100,5,0,5
2014,Krystine,F,100,5,0,5
2014,Krystyna,F,100,5,0,5
2014,Ku,M,100,0,5,5
2014,Kumari,F,100,5,0,5
2014,Kunga,F,100,5,0,5
2014,Kupono,M,100,0,5,5
2014,Kuzey,M,100,0,5,5
2014,Kwamane,M,100,0,5,5
2014,Kwinn,F,100,5,0,5
2014,Kyari,F,100,5,0,5
2014,Kydan,M,100,0,5,5
2014,Kyerra,F,100,5,0,5
2014,Kyhir,M,100,0,5,5
2014,Kyiren,M,100,0,5,5
2014,Kylenn,F,100,5,0,5
2014,Kylise,F,100,5,0,5
2014,Kylissa,F,100,5,0,5
2014,Kymberli,F,100,5,0,5
2014,Kymere,M,100,0,5,5
2014,Kyndahl,F,100,5,0,5
2014,Kyndyl,F,100,5,0,5
2014,Kynsie,F,100,5,0,5
2014,Kyoko,F,100,5,0,5
2014,Kyris,M,100,0,5,5
2014,Kystin,M,100,0,5,5
2014,Kyten,M,100,0,5,5
2014,Kyus,M,100,0,5,5
2014,Kyvan,M,100,0,5,5
2014,Kyven,M,100,0,5,5
2014,Labiba,F,100,5,0,5
2014,Lace,F,100,5,0,5
2014,Lacole,F,100,5,0,5
2014,Lada,F,100,5,0,5
2014,Ladale,M,100,0,5,5
2014,Ladarian,M,100,0,5,5
2014,Ladavion,M,100,0,5,5
2014,Ladawn,F,100,5,0,5
2014,Laderrick,M,100,0,5,5
2014,Laelyn,F,100,5,0,5
2014,Laif,M,100,0,5,5
2014,Laighla,F,100,5,0,5
2014,Laikin,F,100,5,0,5
2014,Lailanie,F,100,5,0,5
2014,Lainah,F,100,5,0,5
2014,Laisa,F,100,5,0,5
2014,Lajayceon,M,100,0,5,5
2014,Lajoy,F,100,5,0,5
2014,Lakayden,M,100,0,5,5
2014,Lakeisha,F,100,5,0,5
2014,Lakeith,M,100,0,5,5
2014,Lakeland,M,100,0,5,5
2014,Lakelee,F,100,5,0,5
2014,Lakeria,F,100,5,0,5
2014,Lakshmy,F,100,5,0,5
2014,Lale,F,100,5,0,5
2014,Lalo,M,100,0,5,5
2014,Lamareon,M,100,0,5,5
2014,Lamarius,M,100,0,5,5
2014,Lameir,M,100,0,5,5
2014,Lamira,F,100,5,0,5
2014,Lanaea,F,100,5,0,5
2014,Lanaeya,F,100,5,0,5
2014,Lanaysia,F,100,5,0,5
2014,Lancelot,M,100,0,5,5
2014,Landonn,M,100,0,5,5
2014,Laneisha,F,100,5,0,5
2014,Lanette,F,100,5,0,5
2014,Langstyn,F,100,5,0,5
2014,Laniaya,F,100,5,0,5
2014,Lanikai,F,100,5,0,5
2014,Lanny,M,100,0,5,5
2014,Lansana,M,100,0,5,5
2014,Lansing,M,100,0,5,5
2014,Lanson,M,100,0,5,5
2014,Lany,F,100,5,0,5
2014,Lanye,F,100,5,0,5
2014,Lanyia,F,100,5,0,5
2014,Lanylah,F,100,5,0,5
2014,Laquinton,M,100,0,5,5
2014,Larain,F,100,5,0,5
2014,Lareyna,F,100,5,0,5
2014,Lariel,F,100,5,0,5
2014,Larsyn,F,100,5,0,5
2014,Lashea,F,100,5,0,5
2014,Lathaniel,M,100,0,5,5
2014,Latika,F,100,5,0,5
2014,Laurali,F,100,5,0,5
2014,Lauralyn,F,100,5,0,5
2014,Lauralynn,F,100,5,0,5
2014,Laurana,F,100,5,0,5
2014,Laurelai,F,100,5,0,5
2014,Lavanya,F,100,5,0,5
2014,Lavera,F,100,5,0,5
2014,Lawerence,M,100,0,5,5
2014,Laxmi,F,100,5,0,5
2014,Layce,F,100,5,0,5
2014,Layiah,F,100,5,0,5
2014,Laylianna,F,100,5,0,5
2014,Laylon,M,100,0,5,5
2014,Laynah,F,100,5,0,5
2014,Laythen,M,100,0,5,5
2014,Lazarius,M,100,0,5,5
2014,Laziah,F,100,5,0,5
2014,Laziya,F,100,5,0,5
2014,Lc,M,100,0,5,5
2014,Leamsi,F,100,5,0,5
2014,Ledia,F,100,5,0,5
2014,Leea,F,100,5,0,5
2014,Leeandra,F,100,5,0,5
2014,Leeandrew,M,100,0,5,5
2014,Leelani,F,100,5,0,5
2014,Leelen,M,100,0,5,5
2014,Leelin,M,100,0,5,5
2014,Leeo,M,100,0,5,5
2014,Leeona,F,100,5,0,5
2014,Leesa,F,100,5,0,5
2014,Leeyana,F,100,5,0,5
2014,Legendary,M,100,0,5,5
2014,Lei,M,100,0,5,5
2014,Leighlynn,F,100,5,0,5
2014,Leihlani,F,100,5,0,5
2014,Leihum,M,100,0,5,5
2014,Leiny,F,100,5,0,5
2014,Leisa,F,100,5,0,5
2014,Leithan,M,100,0,5,5
2014,Leium,M,100,0,5,5
2014,Lekendrick,M,100,0,5,5
2014,Lemia,F,100,5,0,5
2014,Lenamarie,F,100,5,0,5
2014,Lenea,F,100,5,0,5
2014,Lenia,F,100,5,0,5
2014,Lennard,M,100,0,5,5
2014,Leno,M,100,0,5,5
2014,Lens,M,100,0,5,5
2014,Leny,M,100,0,5,5
2014,Lenya,F,100,5,0,5
2014,Leonore,F,100,5,0,5
2014,Leorah,F,100,5,0,5
2014,Leoul,M,100,0,5,5
2014,Leriyah,F,100,5,0,5
2014,Lesa,F,100,5,0,5
2014,Leshaun,M,100,0,5,5
2014,Leshawn,M,100,0,5,5
2014,Lesslie,F,100,5,0,5
2014,Leveon,M,100,0,5,5
2014,Levian,M,100,0,5,5
2014,Levion,M,100,0,5,5
2014,Levonte,M,100,0,5,5
2014,Lexandro,M,100,0,5,5
2014,Lexiann,F,100,5,0,5
2014,Lexiee,F,100,5,0,5
2014,Lexxy,F,100,5,0,5
2014,Leyan,F,100,5,0,5
2014,Leylanni,F,100,5,0,5
2014,Leyli,F,100,5,0,5
2014,Leyona,F,100,5,0,5
2014,Leyre,F,100,5,0,5
2014,Liamalexander,M,100,0,5,5
2014,Liandra,F,100,5,0,5
2014,Liann,F,100,5,0,5
2014,Liberti,F,100,5,0,5
2014,Libertie,F,100,5,0,5
2014,Licia,F,100,5,0,5
2014,Lilani,F,100,5,0,5
2014,Liley,F,100,5,0,5
2014,Lilica,F,100,5,0,5
2014,Lilika,F,100,5,0,5
2014,Lilium,F,100,5,0,5
2014,Lilliani,F,100,5,0,5
2014,Lilliannah,F,100,5,0,5
2014,Lilliaunna,F,100,5,0,5
2014,Lilliyan,F,100,5,0,5
2014,Lilliyn,F,100,5,0,5
2014,Lillyannah,F,100,5,0,5
2014,Lillyen,F,100,5,0,5
2014,Lilyani,F,100,5,0,5
2014,Lilyannah,F,100,5,0,5
2014,Lilyaunna,F,100,5,0,5
2014,Lilymarie,F,100,5,0,5
2014,Lincon,M,100,0,5,5
2014,Lindee,F,100,5,0,5
2014,Lindsi,F,100,5,0,5
2014,Linneah,F,100,5,0,5
2014,Linzey,F,100,5,0,5
2014,Liron,M,100,0,5,5
2014,Litia,F,100,5,0,5
2014,Livier,F,100,5,0,5
2014,Lizandra,F,100,5,0,5
2014,Lizbet,F,100,5,0,5
2014,Lizett,F,100,5,0,5
2014,Loana,F,100,5,0,5
2014,Lobsang,M,100,0,5,5
2014,Logahn,M,100,0,5,5
2014,Logynn,F,100,5,0,5
2014,Lolla,F,100,5,0,5
2014,Lon,M,100,0,5,5
2014,Lopaka,M,100,0,5,5
2014,Loralynn,F,100,5,0,5
2014,Lorde,F,100,5,0,5
2014,Lorilai,F,100,5,0,5
2014,Lorrie,F,100,5,0,5
2014,Lorynn,F,100,5,0,5
2014,Lotti,F,100,5,0,5
2014,Louiza,F,100,5,0,5
2014,Lovette,F,100,5,0,5
2014,Loyd,M,100,0,5,5
2014,Lucchese,F,100,5,0,5
2014,Lucey,F,100,5,0,5
2014,Luchiano,M,100,0,5,5
2014,Lucine,F,100,5,0,5
2014,Luckas,M,100,0,5,5
2014,Ludmila,F,100,5,0,5
2014,Ludovic,M,100,0,5,5
2014,Ludwin,M,100,0,5,5
2014,Lui,M,100,0,5,5
2014,Luiscarlos,M,100,0,5,5
2014,Luismanuel,M,100,0,5,5
2014,Lulabelle,F,100,5,0,5
2014,Lulah,F,100,5,0,5
2014,Lunamarie,F,100,5,0,5
2014,Luxanna,F,100,5,0,5
2014,Luxie,F,100,5,0,5
2014,Luzmary,F,100,5,0,5
2014,Lyani,F,100,5,0,5
2014,Lyann,F,100,5,0,5
2014,Lyiam,M,100,0,5,5
2014,Lylla,F,100,5,0,5
2014,Lyndley,F,100,5,0,5
2014,Lynea,F,100,5,0,5
2014,Lynett,F,100,5,0,5
2014,Lyniah,F,100,5,0,5
2014,Lynkon,M,100,0,5,5
2014,Lynli,F,100,5,0,5
2014,Lynwood,M,100,0,5,5
2014,Lyrics,F,100,5,0,5
2014,Lyrix,F,100,5,0,5
2014,Maadhav,M,100,0,5,5
2014,Maahira,F,100,5,0,5
2014,Maaseiah,M,100,0,5,5
2014,Macaela,F,100,5,0,5
2014,Macalister,M,100,0,5,5
2014,Macelynn,F,100,5,0,5
2014,Macenzie,F,100,5,0,5
2014,Maceon,M,100,0,5,5
2014,Macgregor,M,100,0,5,5
2014,Mach,M,100,0,5,5
2014,Maciee,F,100,5,0,5
2014,Macii,F,100,5,0,5
2014,Macilyn,F,100,5,0,5
2014,Mackinlee,F,100,5,0,5
2014,Maclaine,F,100,5,0,5
2014,Macynn,F,100,5,0,5
2014,Madalie,F,100,5,0,5
2014,Maddielyn,F,100,5,0,5
2014,Madee,F,100,5,0,5
2014,Madeliene,F,100,5,0,5
2014,Madelinne,F,100,5,0,5
2014,Madhavi,F,100,5,0,5
2014,Madiba,M,100,0,5,5
2014,Madisan,F,100,5,0,5
2014,Madisonrose,F,100,5,0,5
2014,Madoxx,M,100,0,5,5
2014,Madyx,M,100,0,5,5
2014,Maebrie,F,100,5,0,5
2014,Maeci,F,100,5,0,5
2014,Maelena,F,100,5,0,5
2014,Maelynne,F,100,5,0,5
2014,Maesen,F,100,5,0,5
2014,Maevry,F,100,5,0,5
2014,Maevyn,F,100,5,0,5
2014,Magdaline,F,100,5,0,5
2014,Mahasin,F,100,5,0,5
2014,Mahdia,F,100,5,0,5
2014,Mahith,M,100,0,5,5
2014,Mahiya,F,100,5,0,5
2014,Mahlaya,F,100,5,0,5
2014,Mahli,F,100,5,0,5
2014,Mahliyah,F,100,5,0,5
2014,Maho,F,100,5,0,5
2014,Mahveen,F,100,5,0,5
2014,Maiana,F,100,5,0,5
2014,Maiara,F,100,5,0,5
2014,Maicey,F,100,5,0,5
2014,Maimoona,F,100,5,0,5
2014,Mairen,F,100,5,0,5
2014,Maisa,F,100,5,0,5
2014,Majestie,F,100,5,0,5
2014,Makael,M,100,0,5,5
2014,Makalia,F,100,5,0,5
2014,Makamae,F,100,5,0,5
2014,Makaria,F,100,5,0,5
2014,Makaylen,F,100,5,0,5
2014,Makeena,F,100,5,0,5
2014,Makelle,F,100,5,0,5
2014,Makenzly,F,100,5,0,5
2014,Makhail,M,100,0,5,5
2014,Makhya,F,100,5,0,5
2014,Makilah,F,100,5,0,5
2014,Makinnley,F,100,5,0,5
2014,Makiylah,F,100,5,0,5
2014,Makston,M,100,0,5,5
2014,Makyle,M,100,0,5,5
2014,Malaisia,F,100,5,0,5
2014,Malanii,F,100,5,0,5
2014,Maleaha,F,100,5,0,5
2014,Maleak,M,100,0,5,5
2014,Malechi,M,100,0,5,5
2014,Maleyna,F,100,5,0,5
2014,Malikhai,M,100,0,5,5
2014,Mallary,F,100,5,0,5
2014,Mallina,F,100,5,0,5
2014,Malon,F,100,5,0,5
2014,Malonie,F,100,5,0,5
2014,Malyssa,F,100,5,0,5
2014,Mamadu,M,100,0,5,5
2014,Mamoun,M,100,0,5,5
2014,Manasvini,F,100,5,0,5
2014,Mandalyn,F,100,5,0,5
2014,Mandie,F,100,5,0,5
2014,Manfred,M,100,0,5,5
2014,Maniah,F,100,5,0,5
2014,Manika,F,100,5,0,5
2014,Manisha,F,100,5,0,5
2014,Manit,M,100,0,5,5
2014,Manna,F,100,5,0,5
2014,Mansi,F,100,5,0,5
2014,Manvik,M,100,0,5,5
2014,Maraiya,F,100,5,0,5
2014,Marajade,F,100,5,0,5
2014,Maralyn,F,100,5,0,5
2014,Marat,M,100,0,5,5
2014,Marcellino,M,100,0,5,5
2014,Marcellis,M,100,0,5,5
2014,Marcelus,M,100,0,5,5
2014,Marea,F,100,5,0,5
2014,Margareth,F,100,5,0,5
2014,Mariabelen,F,100,5,0,5
2014,Mariadelaluz,F,100,5,0,5
2014,Mariaemilia,F,100,5,0,5
2014,Marialis,F,100,5,0,5
2014,Mariany,F,100,5,0,5
2014,Mariapaula,F,100,5,0,5
2014,Marick,M,100,0,5,5
2014,Marieliz,F,100,5,0,5
2014,Marieme,F,100,5,0,5
2014,Mariha,F,100,5,0,5
2014,Marijayne,F,100,5,0,5
2014,Marili,F,100,5,0,5
2014,Mariluz,F,100,5,0,5
2014,Marinah,F,100,5,0,5
2014,Marisella,F,100,5,0,5
2014,Marisha,F,100,5,0,5
2014,Marishka,F,100,5,0,5
2014,Marium,F,100,5,0,5
2014,Marixa,F,100,5,0,5
2014,Mariyana,F,100,5,0,5
2014,Mariyani,F,100,5,0,5
2014,Mariyanna,F,100,5,0,5
2014,Marizol,F,100,5,0,5
2014,Markcus,M,100,0,5,5
2014,Markeem,M,100,0,5,5
2014,Markeis,M,100,0,5,5
2014,Markeise,M,100,0,5,5
2014,Markelle,M,100,0,5,5
2014,Marken,M,100,0,5,5
2014,Marki,F,100,5,0,5
2014,Marleyann,F,100,5,0,5
2014,Marliee,F,100,5,0,5
2014,Marlise,F,100,5,0,5
2014,Marnita,F,100,5,0,5
2014,Marquavious,M,100,0,5,5
2014,Marquavis,M,100,0,5,5
2014,Marquelle,M,100,0,5,5
2014,Marrell,M,100,0,5,5
2014,Marriana,F,100,5,0,5
2014,Marrion,M,100,0,5,5
2014,Marrissa,F,100,5,0,5
2014,Marshayla,F,100,5,0,5
2014,Martice,M,100,0,5,5
2014,Marva,F,100,5,0,5
2014,Marvelle,M,100,0,5,5
2014,Marvyn,M,100,0,5,5
2014,Marybel,F,100,5,0,5
2014,Maryhelen,F,100,5,0,5
2014,Maryjayne,F,100,5,0,5
2014,Maryjune,F,100,5,0,5
2014,Maryna,F,100,5,0,5
2014,Maryse,F,100,5,0,5
2014,Marytza,F,100,5,0,5
2014,Maryum,F,100,5,0,5
2014,Marzia,F,100,5,0,5
2014,Masahiro,M,100,0,5,5
2014,Masal,F,100,5,0,5
2014,Mascen,M,100,0,5,5
2014,Masion,M,100,0,5,5
2014,Masoud,M,100,0,5,5
2014,Mataio,M,100,0,5,5
2014,Matalynn,F,100,5,0,5
2014,Mathais,M,100,0,5,5
2014,Matheu,M,100,0,5,5
2014,Matisyahu,M,100,0,5,5
2014,Matthais,M,100,0,5,5
2014,Matthewjames,M,100,0,5,5
2014,Mattisen,F,100,5,0,5
2014,Matvei,M,100,0,5,5
2014,Maud,F,100,5,0,5
2014,Mauricia,F,100,5,0,5
2014,Maurie,F,100,5,0,5
2014,Maurielle,F,100,5,0,5
2014,Maurion,M,100,0,5,5
2014,Maurisa,F,100,5,0,5
2014,Maurya,M,100,0,5,5
2014,Mavie,F,100,5,0,5
2014,Mavin,M,100,0,5,5
2014,Maxamilian,M,100,0,5,5
2014,Maxene,F,100,5,0,5
2014,Maxin,M,100,0,5,5
2014,Maxxen,M,100,0,5,5
2014,Maxxim,M,100,0,5,5
2014,Mayara,F,100,5,0,5
2014,Maycon,M,100,0,5,5
2014,Mayely,F,100,5,0,5
2014,Mayerli,F,100,5,0,5
2014,Mayha,F,100,5,0,5
2014,Mayka,F,100,5,0,5
2014,Maykol,M,100,0,5,5
2014,Mayleah,F,100,5,0,5
2014,Mayline,F,100,5,0,5
2014,Maymunah,F,100,5,0,5
2014,Maysoon,F,100,5,0,5
2014,Maysun,F,100,5,0,5
2014,Mayu,F,100,5,0,5
2014,Mazarine,F,100,5,0,5
2014,Mazon,M,100,0,5,5
2014,Mcconnell,M,100,0,5,5
2014,Mccray,M,100,0,5,5
2014,Mckena,F,100,5,0,5
2014,Mckinlie,F,100,5,0,5
2014,Mckinze,F,100,5,0,5
2014,Mckinzey,F,100,5,0,5
2014,Mckynzi,F,100,5,0,5
2014,Mclaren,M,100,0,5,5
2014,Mclean,M,100,0,5,5
2014,Medhansh,M,100,0,5,5
2014,Meenah,F,100,5,0,5
2014,Meeyah,F,100,5,0,5
2014,Meggie,F,100,5,0,5
2014,Megh,M,100,0,5,5
2014,Mehana,F,100,5,0,5
2014,Mehek,F,100,5,0,5
2014,Mehtaab,M,100,0,5,5
2014,Mehwish,F,100,5,0,5
2014,Meilanie,F,100,5,0,5
2014,Meilynn,F,100,5,0,5
2014,Meiqi,F,100,5,0,5
2014,Meiya,F,100,5,0,5
2014,Mekael,M,100,0,5,5
2014,Mekah,F,100,5,0,5
2014,Mekaylah,F,100,5,0,5
2014,Meko,M,100,0,5,5
2014,Melakai,M,100,0,5,5
2014,Melaya,F,100,5,0,5
2014,Melba,F,100,5,0,5
2014,Meliana,F,100,5,0,5
2014,Melinah,F,100,5,0,5
2014,Meline,F,100,5,0,5
2014,Melisha,F,100,5,0,5
2014,Melita,F,100,5,0,5
2014,Melky,M,100,0,5,5
2014,Mellani,F,100,5,0,5
2014,Mellie,F,100,5,0,5
2014,Mellisa,F,100,5,0,5
2014,Melquisedec,M,100,0,5,5
2014,Melton,M,100,0,5,5
2014,Melva,F,100,5,0,5
2014,Melvina,F,100,5,0,5
2014,Menah,F,100,5,0,5
2014,Meradith,F,100,5,0,5
2014,Mercadies,F,100,5,0,5
2014,Mercede,F,100,5,0,5
2014,Merideth,F,100,5,0,5
2014,Merilee,F,100,5,0,5
2014,Merjem,F,100,5,0,5
2014,Merlina,F,100,5,0,5
2014,Mesha,F,100,5,0,5
2014,Meshal,M,100,0,5,5
2014,Mesiyah,M,100,0,5,5
2014,Messias,M,100,0,5,5
2014,Messyah,M,100,0,5,5
2014,Meyla,F,100,5,0,5
2014,Miamarie,F,100,5,0,5
2014,Miamour,F,100,5,0,5
2014,Mianicole,F,100,5,0,5
2014,Miara,F,100,5,0,5
2014,Micahya,F,100,5,0,5
2014,Michalina,F,100,5,0,5
2014,Michonne,F,100,5,0,5
2014,Mickell,M,100,0,5,5
2014,Mickinley,F,100,5,0,5
2014,Midhuna,F,100,5,0,5
2014,Mieke,F,100,5,0,5
2014,Mieko,F,100,5,0,5
2014,Mihaela,F,100,5,0,5
2014,Mihailo,M,100,0,5,5
2014,Mikaele,M,100,0,5,5
2014,Mikaylin,F,100,5,0,5
2014,Mikeria,F,100,5,0,5
2014,Mikhai,M,100,0,5,5
2014,Mikhale,M,100,0,5,5
2014,Mikiel,M,100,0,5,5
2014,Miku,F,100,5,0,5
2014,Milanni,F,100,5,0,5
2014,Milett,F,100,5,0,5
2014,Mileva,F,100,5,0,5
2014,Mileyshka,F,100,5,0,5
2014,Milian,F,100,5,0,5
2014,Miliany,F,100,5,0,5
2014,Milinda,F,100,5,0,5
2014,Millen,M,100,0,5,5
2014,Millian,F,100,5,0,5
2014,Mima,F,100,5,0,5
2014,Mindi,F,100,5,0,5
2014,Ming,M,100,0,5,5
2014,Minjoon,M,100,0,5,5
2014,Mirajane,F,100,5,0,5
2014,Mirasol,F,100,5,0,5
2014,Mirena,F,100,5,0,5
2014,Mishaal,F,100,5,0,5
2014,Mishon,M,100,0,5,5
2014,Miski,F,100,5,0,5
2014,Misri,F,100,5,0,5
2014,Missouri,F,100,5,0,5
2014,Mitsuki,F,100,5,0,5
2014,Miyani,F,100,5,0,5
2014,Miylah,F,100,5,0,5
2014,Moath,M,100,0,5,5
2014,Modesta,F,100,5,0,5
2014,Moesha,F,100,5,0,5
2014,Mofiyinfoluwa,F,100,5,0,5
2014,Mohamedamiin,M,100,0,5,5
2014,Mohanad,M,100,0,5,5
2014,Mojtaba,M,100,0,5,5
2014,Mokshith,M,100,0,5,5
2014,Mokshitha,F,100,5,0,5
2014,Molina,F,100,5,0,5
2014,Mollyann,F,100,5,0,5
2014,Momar,M,100,0,5,5
2014,Monira,F,100,5,0,5
2014,Monish,M,100,0,5,5
2014,Monisha,F,100,5,0,5
2014,Monreaux,F,100,5,0,5
2014,Monserrad,F,100,5,0,5
2014,Morah,F,100,5,0,5
2014,Mordekai,M,100,0,5,5
2014,Morganna,F,100,5,0,5
2014,Mori,M,100,0,5,5
2014,Moria,F,100,5,0,5
2014,Moris,M,100,0,5,5
2014,Morley,F,100,5,0,5
2014,Morolaoluwa,F,100,5,0,5
2014,Morticia,F,100,5,0,5
2014,Moss,M,100,0,5,5
2014,Motty,M,100,0,5,5
2014,Motunrayo,F,100,5,0,5
2014,Mourya,M,100,0,5,5
2014,Mozart,M,100,0,5,5
2014,Mridula,F,100,5,0,5
2014,Mubin,M,100,0,5,5
2014,Mugen,M,100,0,5,5
2014,Muhammadamin,M,100,0,5,5
2014,Muhanad,M,100,0,5,5
2014,Muizz,M,100,0,5,5
2014,Mukarram,M,100,0,5,5
2014,Munro,M,100,0,5,5
2014,Muntasir,M,100,0,5,5
2014,Murdock,M,100,0,5,5
2014,Muse,M,100,0,5,5
2014,Musiq,M,100,0,5,5
2014,Myaire,M,100,0,5,5
2014,Myalyn,F,100,5,0,5
2014,Mykaylah,F,100,5,0,5
2014,Mykelle,F,100,5,0,5
2014,Mykhi,M,100,0,5,5
2014,Myshawn,M,100,0,5,5
2014,Myunique,F,100,5,0,5
2014,Naamah,F,100,5,0,5
2014,Nabhan,M,100,0,5,5
2014,Nabhya,M,100,0,5,5
2014,Nadalia,F,100,5,0,5
2014,Nadina,F,100,5,0,5
2014,Nadyne,F,100,5,0,5
2014,Naela,F,100,5,0,5
2014,Naelle,F,100,5,0,5
2014,Naema,F,100,5,0,5
2014,Nahal,F,100,5,0,5
2014,Nahara,F,100,5,0,5
2014,Nahari,F,100,5,0,5
2014,Nahdia,F,100,5,0,5
2014,Nahiem,M,100,0,5,5
2014,Nahlah,F,100,5,0,5
2014,Nahya,F,100,5,0,5
2014,Naika,F,100,5,0,5
2014,Nairoby,F,100,5,0,5
2014,Naiylah,F,100,5,0,5
2014,Najae,M,100,0,5,5
2014,Najeeb,M,100,0,5,5
2014,Najmo,F,100,5,0,5
2014,Nakshatra,F,100,5,0,5
2014,Nakya,F,100,5,0,5
2014,Nalee,F,100,5,0,5
2014,Nalu,M,100,0,5,5
2014,Nalya,F,100,5,0,5
2014,Nanaakua,F,100,5,0,5
2014,Nanayaw,M,100,0,5,5
2014,Nandana,F,100,5,0,5
2014,Naraya,F,100,5,0,5
2014,Nargis,F,100,5,0,5
2014,Nashay,F,100,5,0,5
2014,Nashiyah,F,100,5,0,5
2014,Nashon,M,100,0,5,5
2014,Nashua,M,100,0,5,5
2014,Nasreen,F,100,5,0,5
2014,Nasteho,F,100,5,0,5
2014,Nasyr,M,100,0,5,5
2014,Natalyia,F,100,5,0,5
2014,Natascha,F,100,5,0,5
2014,Nathaneil,M,100,0,5,5
2014,Natily,F,100,5,0,5
2014,Natilynn,F,100,5,0,5
2014,Navdeep,M,100,0,5,5
2014,Navell,M,100,0,5,5
2014,Navika,F,100,5,0,5
2014,Navleen,F,100,5,0,5
2014,Navtej,M,100,0,5,5
2014,Nayali,F,100,5,0,5
2014,Nayani,F,100,5,0,5
2014,Nayanna,F,100,5,0,5
2014,Naydine,F,100,5,0,5
2014,Nayelly,F,100,5,0,5
2014,Nayib,M,100,0,5,5
2014,Naylene,F,100,5,0,5
2014,Nazarene,F,100,5,0,5
2014,Nazeef,M,100,0,5,5
2014,Nazih,M,100,0,5,5
2014,Nazire,M,100,0,5,5
2014,Nazyiah,F,100,5,0,5
2014,Neariah,F,100,5,0,5
2014,Necha,F,100,5,0,5
2014,Nechemia,M,100,0,5,5
2014,Neeka,F,100,5,0,5
2014,Neelan,M,100,0,5,5
2014,Neelesh,M,100,0,5,5
2014,Neemah,F,100,5,0,5
2014,Nefertiti,F,100,5,0,5
2014,Neida,F,100,5,0,5
2014,Neill,M,100,0,5,5
2014,Neira,F,100,5,0,5
2014,Neithen,M,100,0,5,5
2014,Nejla,F,100,5,0,5
2014,Nekhi,M,100,0,5,5
2014,Nelani,F,100,5,0,5
2014,Nelda,F,100,5,0,5
2014,Nelliel,F,100,5,0,5
2014,Nenah,F,100,5,0,5
2014,Nermeen,F,100,5,0,5
2014,Neron,M,100,0,5,5
2014,Nerys,F,100,5,0,5
2014,Ness,M,100,0,5,5
2014,Neta,F,100,5,0,5
2014,Nethan,M,100,0,5,5
2014,Nevea,F,100,5,0,5
2014,Neveya,F,100,5,0,5
2014,Newell,M,100,0,5,5
2014,Neysha,F,100,5,0,5
2014,Nezar,M,100,0,5,5
2014,Ngawang,M,100,0,5,5
2014,Nhan,M,100,0,5,5
2014,Nhyla,F,100,5,0,5
2014,Ni,F,100,5,0,5
2014,Nialani,F,100,5,0,5
2014,Niamiah,F,100,5,0,5
2014,Niani,F,100,5,0,5
2014,Niaya,F,100,5,0,5
2014,Nicci,F,100,5,0,5
2014,Nicholette,F,100,5,0,5
2014,Nicholle,F,100,5,0,5
2014,Nickolis,M,100,0,5,5
2014,Nickolus,M,100,0,5,5
2014,Nigella,F,100,5,0,5
2014,Nikali,M,100,0,5,5
2014,Nikiah,F,100,5,0,5
2014,Nikira,F,100,5,0,5
2014,Nikiya,F,100,5,0,5
2014,Nikiyah,F,100,5,0,5
2014,Nikkia,F,100,5,0,5
2014,Nikkolas,M,100,0,5,5
2014,Nikolus,M,100,0,5,5
2014,Nikyla,F,100,5,0,5
2014,Nilesh,M,100,0,5,5
2014,Niley,F,100,5,0,5
2014,Nilsa,F,100,5,0,5
2014,Ninette,F,100,5,0,5
2014,Niome,F,100,5,0,5
2014,Niraj,M,100,0,5,5
2014,Nirek,M,100,0,5,5
2014,Nishi,F,100,5,0,5
2014,Nishta,F,100,5,0,5
2014,Nisma,F,100,5,0,5
2014,Nisreen,F,100,5,0,5
2014,Nissan,M,100,0,5,5
2014,Nitara,F,100,5,0,5
2014,Nivayah,F,100,5,0,5
2014,Niveen,F,100,5,0,5
2014,Nivin,M,100,0,5,5
2014,Nixin,M,100,0,5,5
2014,Niyomi,F,100,5,0,5
2014,Niza,F,100,5,0,5
2014,Nkosi,M,100,0,5,5
2014,Nneka,F,100,5,0,5
2014,Noahgabriel,M,100,0,5,5
2014,Noan,M,100,0,5,5
2014,Noellie,F,100,5,0,5
2014,Noha,M,100,0,5,5
2014,Nohl,M,100,0,5,5
2014,Noli,F,100,5,0,5
2014,Noman,M,100,0,5,5
2014,Noomi,F,100,5,0,5
2014,Noon,F,100,5,0,5
2014,Noorjahan,F,100,5,0,5
2014,Noralie,F,100,5,0,5
2014,Noran,F,100,5,0,5
2014,Norene,F,100,5,0,5
2014,Noriana,F,100,5,0,5
2014,Noriel,M,100,0,5,5
2014,Nouran,F,100,5,0,5
2014,Novel,M,100,0,5,5
2014,Nowah,M,100,0,5,5
2014,Nubian,F,100,5,0,5
2014,Numair,M,100,0,5,5
2014,Nureen,F,100,5,0,5
2014,Nuriyah,F,100,5,0,5
2014,Nussen,M,100,0,5,5
2014,Nyalah,F,100,5,0,5
2014,Nyelah,F,100,5,0,5
2014,Nyemiah,F,100,5,0,5
2014,Nyesha,F,100,5,0,5
2014,Nyier,M,100,0,5,5
2014,Nykeria,F,100,5,0,5
2014,Nykolas,M,100,0,5,5
2014,Nylie,F,100,5,0,5
2014,Nyriah,F,100,5,0,5
2014,Nysha,F,100,5,0,5
2014,Nyziah,M,100,0,5,5
2014,Oaken,M,100,0,5,5
2014,Odis,M,100,0,5,5
2014,Ofir,M,100,0,5,5
2014,Ogechi,F,100,5,0,5
2014,Ohm,M,100,0,5,5
2014,Olachi,F,100,5,0,5
2014,Oladimeji,M,100,0,5,5
2014,Olanrewaju,M,100,0,5,5
2014,Oleksiy,M,100,0,5,5
2014,Olesya,F,100,5,0,5
2014,Olivet,F,100,5,0,5
2014,Oliviaann,F,100,5,0,5
2014,Oliviyah,F,100,5,0,5
2014,Olly,M,100,0,5,5
2014,Ololade,F,100,5,0,5
2014,Oluwabusola,F,100,5,0,5
2014,Oluwadabira,F,100,5,0,5
2014,Oluwadara,F,100,5,0,5
2014,Oluwaferanmi,M,100,0,5,5
2014,Oluwafolajimi,M,100,0,5,5
2014,Oluwafunmilola,F,100,5,0,5
2014,Oluwajoba,M,100,0,5,5
2014,Oluwakayode,M,100,0,5,5
2014,Oluwatise,F,100,5,0,5
2014,Oluwatomi,M,100,0,5,5
2014,Omani,M,100,0,5,5
2014,Omare,M,100,0,5,5
2014,Omarius,M,100,0,5,5
2014,Omi,M,100,0,5,5
2014,Onesti,F,100,5,0,5
2014,Onnaleigh,F,100,5,0,5
2014,Onyekachi,M,100,0,5,5
2014,Orest,M,100,0,5,5
2014,Orryn,M,100,0,5,5
2014,Oryn,M,100,0,5,5
2014,Osher,M,100,0,5,5
2014,Osinachi,M,100,0,5,5
2014,Osmani,M,100,0,5,5
2014,Osmany,M,100,0,5,5
2014,Osmel,M,100,0,5,5
2014,Ossie,M,100,0,5,5
2014,Otha,M,100,0,5,5
2014,Ottis,M,100,0,5,5
2014,Otylia,F,100,5,0,5
2014,Ourania,F,100,5,0,5
2014,Ovee,F,100,5,0,5
2014,Ovidio,M,100,0,5,5
2014,Oyindamola,F,100,5,0,5
2014,Ozara,F,100,5,0,5
2014,Paelynn,F,100,5,0,5
2014,Paitin,F,100,5,0,5
2014,Pal,M,100,0,5,5
2014,Palynn,F,100,5,0,5
2014,Panagiota,F,100,5,0,5
2014,Par,F,100,5,0,5
2014,Parmeet,M,100,0,5,5
2014,Parv,M,100,0,5,5
2014,Pashance,F,100,5,0,5
2014,Pason,M,100,0,5,5
2014,Pat,M,100,0,5,5
2014,Patriot,M,100,0,5,5
2014,Paulanthony,M,100,0,5,5
2014,Paulett,F,100,5,0,5
2014,Pavle,M,100,0,5,5
2014,Pele,M,100,0,5,5
2014,Penelopea,F,100,5,0,5
2014,Peretz,M,100,0,5,5
2014,Perrine,F,100,5,0,5
2014,Persephany,F,100,5,0,5
2014,Petrona,F,100,5,0,5
2014,Petunia,F,100,5,0,5
2014,Peydon,M,100,0,5,5
2014,Peytonn,F,100,5,0,5
2014,Phaith,F,100,5,0,5
2014,Phanuel,M,100,0,5,5
2014,Pharez,M,100,0,5,5
2014,Pharyn,F,100,5,0,5
2014,Phelps,M,100,0,5,5
2014,Pheng,M,100,0,5,5
2014,Phinn,M,100,0,5,5
2014,Phoebee,F,100,5,0,5
2014,Phoebie,F,100,5,0,5
2014,Phoenixx,F,100,5,0,5
2014,Pierina,F,100,5,0,5
2014,Pierston,M,100,0,5,5
2014,Pieter,M,100,0,5,5
2014,Poe,F,100,5,0,5
2014,Prabhas,M,100,0,5,5
2014,Prabin,M,100,0,5,5
2014,Prahlad,M,100,0,5,5
2014,Prajin,M,100,0,5,5
2014,Prajit,M,100,0,5,5
2014,Prakrit,M,100,0,5,5
2014,Pranati,F,100,5,0,5
2014,Pranesh,M,100,0,5,5
2014,Pranil,M,100,0,5,5
2014,Pranjal,M,100,0,5,5
2014,Prayag,M,100,0,5,5
2014,Prayan,M,100,0,5,5
2014,Prayash,M,100,0,5,5
2014,Preesha,F,100,5,0,5
2014,Pretty,F,100,5,0,5
2014,Princecharles,M,100,0,5,5
2014,Princesa,F,100,5,0,5
2014,Princetin,M,100,0,5,5
2014,Prisca,F,100,5,0,5
2014,Priscella,F,100,5,0,5
2014,Priscylla,F,100,5,0,5
2014,Prisma,F,100,5,0,5
2014,Priti,F,100,5,0,5
2014,Priyal,F,100,5,0,5
2014,Prynn,F,100,5,0,5
2014,Purab,M,100,0,5,5
2014,Qaiden,M,100,0,5,5
2014,Quamaine,M,100,0,5,5
2014,Quamar,M,100,0,5,5
2014,Quandarius,M,100,0,5,5
2014,Quantae,M,100,0,5,5
2014,Quartez,M,100,0,5,5
2014,Quatavious,M,100,0,5,5
2014,Quenten,M,100,0,5,5
2014,Quentyn,M,100,0,5,5
2014,Quetzally,F,100,5,0,5
2014,Quiara,F,100,5,0,5
2014,Quill,M,100,0,5,5
2014,Quiniyah,F,100,5,0,5
2014,Quinleigh,F,100,5,0,5
2014,Quinlin,M,100,0,5,5
2014,Quinna,F,100,5,0,5
2014,Quinnten,M,100,0,5,5
2014,Quintel,M,100,0,5,5
2014,Quron,M,100,0,5,5
2014,Raaid,M,100,0,5,5
2014,Rabecca,F,100,5,0,5
2014,Racen,M,100,0,5,5
2014,Rachit,M,100,0,5,5
2014,Racin,M,100,0,5,5
2014,Radames,M,100,0,5,5
2014,Radeen,M,100,0,5,5
2014,Radford,M,100,0,5,5
2014,Radia,F,100,5,0,5
2014,Radiya,F,100,5,0,5
2014,Raeah,F,100,5,0,5
2014,Raegin,F,100,5,0,5
2014,Raelean,F,100,5,0,5
2014,Raevynn,F,100,5,0,5
2014,Rafat,M,100,0,5,5
2014,Raffael,M,100,0,5,5
2014,Rafiq,M,100,0,5,5
2014,Rage,M,100,0,5,5
2014,Rahab,F,100,5,0,5
2014,Raheen,M,100,0,5,5
2014,Rahmeek,M,100,0,5,5
2014,Rahmel,M,100,0,5,5
2014,Rahmere,M,100,0,5,5
2014,Raiah,F,100,5,0,5
2014,Raighan,F,100,5,0,5
2014,Raihana,F,100,5,0,5
2014,Raika,F,100,5,0,5
2014,Railynne,F,100,5,0,5
2014,Rainelle,F,100,5,0,5
2014,Raji,M,100,0,5,5
2014,Rakiya,F,100,5,0,5
2014,Rakye,M,100,0,5,5
2014,Ralpheal,M,100,0,5,5
2014,Ramari,M,100,0,5,5
2014,Rambo,M,100,0,5,5
2014,Ran,F,100,5,0,5
2014,Ranferi,M,100,0,5,5
2014,Rangel,M,100,0,5,5
2014,Raniel,M,100,0,5,5
2014,Ranna,F,100,5,0,5
2014,Ranson,M,100,0,5,5
2014,Ranylah,F,100,5,0,5
2014,Raoul,M,100,0,5,5
2014,Ras,M,100,0,5,5
2014,Rashiya,F,100,5,0,5
2014,Rasool,M,100,0,5,5
2014,Ravya,F,100,5,0,5
2014,Rayburn,M,100,0,5,5
2014,Raye,F,100,5,0,5
2014,Rayelyn,F,100,5,0,5
2014,Rayfe,M,100,0,5,5
2014,Raylend,M,100,0,5,5
2014,Raylenn,F,100,5,0,5
2014,Rayli,F,100,5,0,5
2014,Raymar,M,100,0,5,5
2014,Raynah,F,100,5,0,5
2014,Rayni,F,100,5,0,5
2014,Rayshon,M,100,0,5,5
2014,Rayssa,F,100,5,0,5
2014,Rayvion,M,100,0,5,5
2014,Rayyaan,M,100,0,5,5
2014,Raz,M,100,0,5,5
2014,Realynn,F,100,5,0,5
2014,Reann,F,100,5,0,5
2014,Rebella,F,100,5,0,5
2014,Reddick,M,100,0,5,5
2014,Reeyan,M,100,0,5,5
2014,Rehanna,F,100,5,0,5
2014,Reicher,M,100,0,5,5
2014,Reighan,F,100,5,0,5
2014,Reilley,M,100,0,5,5
2014,Reiter,M,100,0,5,5
2014,Remey,F,100,5,0,5
2014,Remick,M,100,0,5,5
2014,Remus,M,100,0,5,5
2014,Rendon,M,100,0,5,5
2014,Renegade,M,100,0,5,5
2014,Renell,F,100,5,0,5
2014,Renezmay,F,100,5,0,5
2014,Renezme,F,100,5,0,5
2014,Retha,F,100,5,0,5
2014,Retta,F,100,5,0,5
2014,Reus,M,100,0,5,5
2014,Rev,M,100,0,5,5
2014,Reyanna,F,100,5,0,5
2014,Reyelle,F,100,5,0,5
2014,Reyhan,M,100,0,5,5
2014,Reymi,M,100,0,5,5
2014,Reyn,M,100,0,5,5
2014,Rhaegan,F,100,5,0,5
2014,Rhaniya,F,100,5,0,5
2014,Rheanna,F,100,5,0,5
2014,Rhemy,F,100,5,0,5
2014,Rhet,M,100,0,5,5
2014,Rhoads,M,100,0,5,5
2014,Rhoan,M,100,0,5,5
2014,Rhoen,M,100,0,5,5
2014,Rhye,M,100,0,5,5
2014,Rhyin,F,100,5,0,5
2014,Rhyla,F,100,5,0,5
2014,Rhyley,M,100,0,5,5
2014,Rianshi,F,100,5,0,5
2014,Rickell,F,100,5,0,5
2014,Riddik,M,100,0,5,5
2014,Ridger,M,100,0,5,5
2014,Ridha,M,100,0,5,5
2014,Ridlee,F,100,5,0,5
2014,Riella,F,100,5,0,5
2014,Riggen,M,100,0,5,5
2014,Rigsby,M,100,0,5,5
2014,Riha,F,100,5,0,5
2014,Rihab,F,100,5,0,5
2014,Rihansh,M,100,0,5,5
2014,Riis,M,100,0,5,5
2014,Riko,F,100,5,0,5
2014,Rilah,F,100,5,0,5
2014,Rilan,M,100,0,5,5
2014,Rilie,F,100,5,0,5
2014,Rily,F,100,5,0,5
2014,Rinad,F,100,5,0,5
2014,Riniyah,F,100,5,0,5
2014,Rinka,F,100,5,0,5
2014,Rise,M,100,0,5,5
2014,Rishawn,M,100,0,5,5
2014,Riston,M,100,0,5,5
2014,Riti,F,100,5,0,5
2014,Rittal,F,100,5,0,5
2014,Riyanna,F,100,5,0,5
2014,Riyanshi,F,100,5,0,5
2014,Riyaq,F,100,5,0,5
2014,Riyaz,M,100,0,5,5
2014,Riyon,M,100,0,5,5
2014,Rjay,M,100,0,5,5
2014,Roary,M,100,0,5,5
2014,Robbi,F,100,5,0,5
2014,Roberth,M,100,0,5,5
2014,Robson,M,100,0,5,5
2014,Rocker,M,100,0,5,5
2014,Rockson,M,100,0,5,5
2014,Rod,M,100,0,5,5
2014,Rodas,F,100,5,0,5
2014,Rodel,M,100,0,5,5
2014,Rodie,M,100,0,5,5
2014,Roey,M,100,0,5,5
2014,Rohail,M,100,0,5,5
2014,Rolen,M,100,0,5,5
2014,Rolf,M,100,0,5,5
2014,Rom,M,100,0,5,5
2014,Romaine,M,100,0,5,5
2014,Romere,M,100,0,5,5
2014,Romey,F,100,5,0,5
2014,Romia,F,100,5,0,5
2014,Romilly,F,100,5,0,5
2014,Romiyah,F,100,5,0,5
2014,Romon,M,100,0,5,5
2014,Roniah,F,100,5,0,5
2014,Ronica,F,100,5,0,5
2014,Ronney,M,100,0,5,5
2014,Rooks,M,100,0,5,5
2014,Roqaya,F,100,5,0,5
2014,Rorick,M,100,0,5,5
2014,Rorry,M,100,0,5,5
2014,Rosalei,F,100,5,0,5
2014,Rosaliyah,F,100,5,0,5
2014,Rosco,M,100,0,5,5
2014,Rosealyn,F,100,5,0,5
2014,Roselani,F,100,5,0,5
2014,Rosellen,F,100,5,0,5
2014,Roshad,M,100,0,5,5
2014,Roshika,F,100,5,0,5
2014,Rosilyn,F,100,5,0,5
2014,Rosilynn,F,100,5,0,5
2014,Rossie,F,100,5,0,5
2014,Rosslynn,F,100,5,0,5
2014,Rowann,F,100,5,0,5
2014,Rowe,M,100,0,5,5
2014,Roxen,M,100,0,5,5
2014,Royaltee,F,100,5,0,5
2014,Rozalee,F,100,5,0,5
2014,Rozalin,F,100,5,0,5
2014,Rozaria,F,100,5,0,5
2014,Rozay,M,100,0,5,5
2014,Rozella,F,100,5,0,5
2014,Rozie,F,100,5,0,5
2014,Rozilyn,F,100,5,0,5
2014,Roziya,F,100,5,0,5
2014,Rozzlyn,F,100,5,0,5
2014,Ruah,F,100,5,0,5
2014,Rubye,F,100,5,0,5
2014,Rula,F,100,5,0,5
2014,Ruman,F,100,5,0,5
2014,Rumer,F,100,5,0,5
2014,Ruqayah,F,100,5,0,5
2014,Rus,F,100,5,0,5
2014,Rusbel,M,100,0,5,5
2014,Rushank,M,100,0,5,5
2014,Russ,M,100,0,5,5
2014,Ruthi,F,100,5,0,5
2014,Rutvik,M,100,0,5,5
2014,Ruxton,M,100,0,5,5
2014,Ruzanna,F,100,5,0,5
2014,Ryanpaul,M,100,0,5,5
2014,Ryat,M,100,0,5,5
2014,Ryel,M,100,0,5,5
2014,Ryerson,M,100,0,5,5
2014,Ryiah,F,100,5,0,5
2014,Rykan,M,100,0,5,5
2014,Rylund,M,100,0,5,5
2014,Ryniah,F,100,5,0,5
2014,Rynleigh,F,100,5,0,5
2014,Saanjh,F,100,5,0,5
2014,Saanvika,F,100,5,0,5
2014,Saarim,M,100,0,5,5
2014,Saavan,M,100,0,5,5
2014,Saben,M,100,0,5,5
2014,Sabre,M,100,0,5,5
2014,Sacora,F,100,5,0,5
2014,Sadan,F,100,5,0,5
2014,Sadeel,F,100,5,0,5
2014,Sadeem,F,100,5,0,5
2014,Sadiee,F,100,5,0,5
2014,Sadira,F,100,5,0,5
2014,Sadler,M,100,0,5,5
2014,Sadman,M,100,0,5,5
2014,Sady,F,100,5,0,5
2014,Saedi,F,100,5,0,5
2014,Saelah,F,100,5,0,5
2014,Safeerah,F,100,5,0,5
2014,Saffiya,F,100,5,0,5
2014,Saffiyah,F,100,5,0,5
2014,Safiye,F,100,5,0,5
2014,Sahaan,M,100,0,5,5
2014,Sahaana,F,100,5,0,5
2014,Sahan,M,100,0,5,5
2014,Saharah,F,100,5,0,5
2014,Saher,F,100,5,0,5
2014,Sahvanna,F,100,5,0,5
2014,Saidah,F,100,5,0,5
2014,Saidou,M,100,0,5,5
2014,Saifaldeen,M,100,0,5,5
2014,Saija,F,100,5,0,5
2014,Saivon,M,100,0,5,5
2014,Saiyan,M,100,0,5,5
2014,Saji,M,100,0,5,5
2014,Sajidah,F,100,5,0,5
2014,Sakara,F,100,5,0,5
2014,Sakariye,M,100,0,5,5
2014,Saleema,F,100,5,0,5
2014,Salimatou,F,100,5,0,5
2014,Salsabeel,F,100,5,0,5
2014,Samaad,M,100,0,5,5
2014,Samaara,F,100,5,0,5
2014,Samael,M,100,0,5,5
2014,Samarpreet,M,100,0,5,5
2014,Sambhav,M,100,0,5,5
2014,Sameerah,F,100,5,0,5
2014,Samere,M,100,0,5,5
2014,Sameyah,F,100,5,0,5
2014,Samier,M,100,0,5,5
2014,Samiria,F,100,5,0,5
2014,Samisoni,M,100,0,5,5
2014,Samiullah,M,100,0,5,5
2014,Samrawit,F,100,5,0,5
2014,Samridh,M,100,0,5,5
2014,Samrudh,M,100,0,5,5
2014,Samuele,M,100,0,5,5
2014,Samuil,M,100,0,5,5
2014,Samvel,M,100,0,5,5
2014,Samvit,M,100,0,5,5
2014,Samyla,F,100,5,0,5
2014,Sanaiya,F,100,5,0,5
2014,Sanaiyah,F,100,5,0,5
2014,Sanchi,F,100,5,0,5
2014,Sandor,M,100,0,5,5
2014,Sandrea,F,100,5,0,5
2014,Saniyaa,F,100,5,0,5
2014,Sanjuana,F,100,5,0,5
2014,Saphirah,F,100,5,0,5
2014,Saqqara,F,100,5,0,5
2014,Saragrace,F,100,5,0,5
2014,Sarahlynn,F,100,5,0,5
2014,Saraia,F,100,5,0,5
2014,Sarang,F,100,5,0,5
2014,Saree,F,100,5,0,5
2014,Sarely,F,100,5,0,5
2014,Sarem,F,100,5,0,5
2014,Saren,F,100,5,0,5
2014,Sarianna,F,100,5,0,5
2014,Sarie,F,100,5,0,5
2014,Sarii,F,100,5,0,5
2014,Sarin,M,100,0,5,5
2014,Sarmad,M,100,0,5,5
2014,Sashank,M,100,0,5,5
2014,Satchel,M,100,0,5,5
2014,Satsuki,F,100,5,0,5
2014,Saundra,F,100,5,0,5
2014,Savannahgrace,F,100,5,0,5
2014,Savannahjo,F,100,5,0,5
2014,Savannahlynn,F,100,5,0,5
2014,Saveion,M,100,0,5,5
2014,Saveon,M,100,0,5,5
2014,Savy,F,100,5,0,5
2014,Savya,F,100,5,0,5
2014,Sayaka,F,100,5,0,5
2014,Sayani,F,100,5,0,5
2014,Saylem,F,100,5,0,5
2014,Sayumi,F,100,5,0,5
2014,Sayyid,M,100,0,5,5
2014,Scarlytt,F,100,5,0,5
2014,Scottland,M,100,0,5,5
2014,Seattle,F,100,5,0,5
2014,Sebastiana,F,100,5,0,5
2014,Sebatian,M,100,0,5,5
2014,Seela,F,100,5,0,5
2014,Seham,F,100,5,0,5
2014,Sehar,F,100,5,0,5
2014,Seirra,F,100,5,0,5
2014,Seiya,M,100,0,5,5
2014,Selassie,M,100,0,5,5
2014,Selwyn,M,100,0,5,5
2014,Semhal,F,100,5,0,5
2014,Semia,F,100,5,0,5
2014,Semirah,F,100,5,0,5
2014,Sen,M,100,0,5,5
2014,Senaya,F,100,5,0,5
2014,Sephira,F,100,5,0,5
2014,Seras,F,100,5,0,5
2014,Seraya,F,100,5,0,5
2014,Serine,F,100,5,0,5
2014,Serriah,F,100,5,0,5
2014,Sevan,F,100,5,0,5
2014,Sevana,F,100,5,0,5
2014,Seve,M,100,0,5,5
2014,Severo,M,100,0,5,5
2014,Severus,M,100,0,5,5
2014,Sevilla,F,100,5,0,5
2014,Sevryn,M,100,0,5,5
2014,Sevynn,F,100,5,0,5
2014,Seydina,M,100,0,5,5
2014,Seymour,M,100,0,5,5
2014,Shabsi,M,100,0,5,5
2014,Shadai,F,100,5,0,5
2014,Shaddix,M,100,0,5,5
2014,Shadin,F,100,5,0,5
2014,Shaeleigh,F,100,5,0,5
2014,Shaeley,F,100,5,0,5
2014,Shahaan,M,100,0,5,5
2014,Shahed,F,100,5,0,5
2014,Shahzoda,F,100,5,0,5
2014,Shaia,F,100,5,0,5
2014,Shaiann,F,100,5,0,5
2014,Shaley,F,100,5,0,5
2014,Shalimar,F,100,5,0,5
2014,Shalyn,F,100,5,0,5
2014,Shamsa,F,100,5,0,5
2014,Shamyra,F,100,5,0,5
2014,Shanard,M,100,0,5,5
2014,Shanea,F,100,5,0,5
2014,Shannell,F,100,5,0,5
2014,Shannia,F,100,5,0,5
2014,Shanta,F,100,5,0,5
2014,Shante,F,100,5,0,5
2014,Shanylah,F,100,5,0,5
2014,Sharan,M,100,0,5,5
2014,Sharlet,F,100,5,0,5
2014,Sharlett,F,100,5,0,5
2014,Sharvi,F,100,5,0,5
2014,Shaunt,M,100,0,5,5
2014,Shavelle,F,100,5,0,5
2014,Shavonne,F,100,5,0,5
2014,Shavy,F,100,5,0,5
2014,Shawnie,F,100,5,0,5
2014,Shawnna,F,100,5,0,5
2014,Shaylan,M,100,0,5,5
2014,Shaylea,F,100,5,0,5
2014,Shayli,F,100,5,0,5
2014,Shazia,F,100,5,0,5
2014,Sheikha,F,100,5,0,5
2014,Sheku,M,100,0,5,5
2014,Shellby,F,100,5,0,5
2014,Shemaiah,F,100,5,0,5
2014,Shenia,F,100,5,0,5
2014,Shep,M,100,0,5,5
2014,Sherard,M,100,0,5,5
2014,Sherley,F,100,5,0,5
2014,Sherline,F,100,5,0,5
2014,Sherlyne,F,100,5,0,5
2014,Sheya,M,100,0,5,5
2014,Shiah,M,100,0,5,5
2014,Shiho,F,100,5,0,5
2014,Shilynn,F,100,5,0,5
2014,Shiny,F,100,5,0,5
2014,Shir,F,100,5,0,5
2014,Shivaansh,M,100,0,5,5
2014,Shivank,M,100,0,5,5
2014,Shmeil,M,100,0,5,5
2014,Shonn,M,100,0,5,5
2014,Shreehan,M,100,0,5,5
2014,Shrinidhi,F,100,5,0,5
2014,Shriyaan,M,100,0,5,5
2014,Shyah,F,100,5,0,5
2014,Shyera,F,100,5,0,5
2014,Shylan,F,100,5,0,5
2014,Shyler,F,100,5,0,5
2014,Shymir,M,100,0,5,5
2014,Si,M,100,0,5,5
2014,Sianni,F,100,5,0,5
2014,Siarra,F,100,5,0,5
2014,Sidahmed,M,100,0,5,5
2014,Sidh,M,100,0,5,5
2014,Sidhant,M,100,0,5,5
2014,Sidonia,F,100,5,0,5
2014,Sigal,F,100,5,0,5
2014,Sigurd,M,100,0,5,5
2014,Silvan,M,100,0,5,5
2014,Simao,M,100,0,5,5
2014,Simba,M,100,0,5,5
2014,Simisola,F,100,5,0,5
2014,Siniya,F,100,5,0,5
2014,Sinjin,M,100,0,5,5
2014,Sionna,F,100,5,0,5
2014,Siriyah,F,100,5,0,5
2014,Sirwilliam,M,100,0,5,5
2014,Siryah,F,100,5,0,5
2014,Siyam,F,100,5,0,5
2014,Siyanna,F,100,5,0,5
2014,Siyon,M,100,0,5,5
2014,Sj,M,100,0,5,5
2014,Skya,F,100,5,0,5
2014,Skyah,F,100,5,0,5
2014,Skyana,F,100,5,0,5
2014,Skyelee,F,100,5,0,5
2014,Skyeler,F,100,5,0,5
2014,Skylaar,F,100,5,0,5
2014,Skyller,M,100,0,5,5
2014,Skylon,M,100,0,5,5
2014,Slayter,M,100,0,5,5
2014,Smrithi,F,100,5,0,5
2014,Smyan,M,100,0,5,5
2014,Snayder,M,100,0,5,5
2014,Soffie,F,100,5,0,5
2014,Sofiana,F,100,5,0,5
2014,Sofiyah,F,100,5,0,5
2014,Solea,F,100,5,0,5
2014,Solia,F,100,5,0,5
2014,Somaiya,F,100,5,0,5
2014,Somiah,F,100,5,0,5
2014,Sonakshi,F,100,5,0,5
2014,Sophieann,F,100,5,0,5
2014,Sopia,F,100,5,0,5
2014,Soran,M,100,0,5,5
2014,Sorelle,F,100,5,0,5
2014,Soteria,F,100,5,0,5
2014,Sotirios,M,100,0,5,5
2014,Southern,F,100,5,0,5
2014,Spartacus,M,100,0,5,5
2014,Special,F,100,5,0,5
2014,Spyridon,M,100,0,5,5
2014,Sri,F,100,5,0,5
2014,Srihaan,M,100,0,5,5
2014,Srihita,F,100,5,0,5
2014,Srithan,M,100,0,5,5
2014,Sriyansh,M,100,0,5,5
2014,Staley,F,100,5,0,5
2014,Stanly,M,100,0,5,5
2014,Starleigh,F,100,5,0,5
2014,Statham,M,100,0,5,5
2014,Steely,M,100,0,5,5
2014,Stefanny,F,100,5,0,5
2014,Steicy,F,100,5,0,5
2014,Stephaine,F,100,5,0,5
2014,Stephane,M,100,0,5,5
2014,Stephanny,F,100,5,0,5
2014,Stephenson,M,100,0,5,5
2014,Stetsen,M,100,0,5,5
2014,Stevin,M,100,0,5,5
2014,Stig,M,100,0,5,5
2014,Stina,F,100,5,0,5
2014,Stokely,M,100,0,5,5
2014,Stokes,M,100,0,5,5
2014,Stonie,F,100,5,0,5
2014,Striker,M,100,0,5,5
2014,Sudeys,M,100,0,5,5
2014,Suhavi,F,100,5,0,5
2014,Sui,F,100,5,0,5
2014,Sujood,F,100,5,0,5
2014,Sukayna,F,100,5,0,5
2014,Sukhman,F,100,5,0,5
2014,Suliana,F,100,5,0,5
2014,Sumi,F,100,5,0,5
2014,Sumire,F,100,5,0,5
2014,Sunita,F,100,5,0,5
2014,Suniya,F,100,5,0,5
2014,Surayah,F,100,5,0,5
2014,Suyash,M,100,0,5,5
2014,Swan,M,100,0,5,5
2014,Swathi,F,100,5,0,5
2014,Sya,F,100,5,0,5
2014,Syann,F,100,5,0,5
2014,Sybastian,M,100,0,5,5
2014,Syer,M,100,0,5,5
2014,Syere,M,100,0,5,5
2014,Syerra,F,100,5,0,5
2014,Syheem,M,100,0,5,5
2014,Sylena,F,100,5,0,5
2014,Sylva,F,100,5,0,5
2014,Symara,F,100,5,0,5
2014,Symira,F,100,5,0,5
2014,Syrai,F,100,5,0,5
2014,Szofia,F,100,5,0,5
2014,Tabbitha,F,100,5,0,5
2014,Tabetha,F,100,5,0,5
2014,Tabria,F,100,5,0,5
2014,Tacori,F,100,5,0,5
2014,Taela,F,100,5,0,5
2014,Taelyr,F,100,5,0,5
2014,Taeson,M,100,0,5,5
2014,Taetum,F,100,5,0,5
2014,Taeveon,M,100,0,5,5
2014,Tahel,F,100,5,0,5
2014,Tahiya,F,100,5,0,5
2014,Tahja,F,100,5,0,5
2014,Tahji,M,100,0,5,5
2014,Tahlaya,F,100,5,0,5
2014,Tahleah,F,100,5,0,5
2014,Tahmina,F,100,5,0,5
2014,Tahreem,F,100,5,0,5
2014,Taichi,M,100,0,5,5
2014,Taijah,F,100,5,0,5
2014,Tailah,F,100,5,0,5
2014,Taitlyn,F,100,5,0,5
2014,Taizley,F,100,5,0,5
2014,Tajon,M,100,0,5,5
2014,Tajveer,M,100,0,5,5
2014,Takeira,F,100,5,0,5
2014,Takylah,F,100,5,0,5
2014,Taleigh,F,100,5,0,5
2014,Talianna,F,100,5,0,5
2014,Talita,F,100,5,0,5
2014,Tallin,M,100,0,5,5
2014,Tally,F,100,5,0,5
2014,Taly,F,100,5,0,5
2014,Tameyah,F,100,5,0,5
2014,Tamika,F,100,5,0,5
2014,Tamirra,F,100,5,0,5
2014,Tamlyn,F,100,5,0,5
2014,Tamon,M,100,0,5,5
2014,Taneah,F,100,5,0,5
2014,Taneesh,M,100,0,5,5
2014,Taneil,F,100,5,0,5
2014,Tannar,M,100,0,5,5
2014,Tanvir,M,100,0,5,5
2014,Tanyiah,F,100,5,0,5
2014,Tarajii,F,100,5,0,5
2014,Tari,F,100,5,0,5
2014,Taro,M,100,0,5,5
2014,Tarquin,M,100,0,5,5
2014,Tarrah,F,100,5,0,5
2014,Tarrel,M,100,0,5,5
2014,Tarren,M,100,0,5,5
2014,Tarvis,M,100,0,5,5
2014,Tashawna,F,100,5,0,5
2014,Tashia,F,100,5,0,5
2014,Tatumn,F,100,5,0,5
2014,Tavari,M,100,0,5,5
2014,Tawan,M,100,0,5,5
2014,Tawsif,M,100,0,5,5
2014,Tayelor,F,100,5,0,5
2014,Tayhlor,F,100,5,0,5
2014,Taylani,F,100,5,0,5
2014,Tayli,F,100,5,0,5
2014,Taylia,F,100,5,0,5
2014,Taymour,M,100,0,5,5
2014,Tayviona,F,100,5,0,5
2014,Tazaria,F,100,5,0,5
2014,Taze,M,100,0,5,5
2014,Teejay,M,100,0,5,5
2014,Teghveer,M,100,0,5,5
2014,Tel,M,100,0,5,5
2014,Tell,M,100,0,5,5
2014,Tema,F,100,5,0,5
2014,Tempie,F,100,5,0,5
2014,Teniyah,F,100,5,0,5
2014,Tennasyn,F,100,5,0,5
2014,Tenoch,M,100,0,5,5
2014,Tenzing,M,100,0,5,5
2014,Teofilo,M,100,0,5,5
2014,Terek,M,100,0,5,5
2014,Terilynn,F,100,5,0,5
2014,Terin,F,100,5,0,5
2014,Terion,M,100,0,5,5
2014,Teriona,F,100,5,0,5
2014,Terrin,M,100,0,5,5
2014,Terrius,M,100,0,5,5
2014,Teshaun,M,100,0,5,5
2014,Tesher,M,100,0,5,5
2014,Tesslyn,F,100,5,0,5
2014,Tevan,M,100,0,5,5
2014,Tevion,M,100,0,5,5
2014,Thadeo,M,100,0,5,5
2014,Thailen,M,100,0,5,5
2014,Thamar,F,100,5,0,5
2014,Thanos,M,100,0,5,5
2014,Thanya,F,100,5,0,5
2014,Theodis,M,100,0,5,5
2014,Theona,F,100,5,0,5
2014,Theophilia,F,100,5,0,5
2014,Theoren,M,100,0,5,5
2014,Thera,F,100,5,0,5
2014,Theran,M,100,0,5,5
2014,Theryn,M,100,0,5,5
2014,Thienkim,F,100,5,0,5
2014,Thorsen,M,100,0,5,5
2014,Tiah,F,100,5,0,5
2014,Tiam,M,100,0,5,5
2014,Tijuan,M,100,0,5,5
2014,Tikvah,F,100,5,0,5
2014,Tila,F,100,5,0,5
2014,Tilak,M,100,0,5,5
2014,Tildon,M,100,0,5,5
2014,Timiah,F,100,5,0,5
2014,Timiya,F,100,5,0,5
2014,Timote,M,100,0,5,5
2014,Tishawn,M,100,0,5,5
2014,Tiyanna,F,100,5,0,5
2014,Tjay,M,100,0,5,5
2014,Tobyas,M,100,0,5,5
2014,Toluwani,F,100,5,0,5
2014,Toprak,M,100,0,5,5
2014,Toree,F,100,5,0,5
2014,Torilynn,F,100,5,0,5
2014,Torionna,F,100,5,0,5
2014,Torris,M,100,0,5,5
2014,Torriyah,F,100,5,0,5
2014,Tou,M,100,0,5,5
2014,Tovia,M,100,0,5,5
2014,Traeger,M,100,0,5,5
2014,Tragen,M,100,0,5,5
2014,Traiden,M,100,0,5,5
2014,Traivon,M,100,0,5,5
2014,Tramain,M,100,0,5,5
2014,Tramayne,M,100,0,5,5
2014,Tramell,M,100,0,5,5
2014,Tranise,F,100,5,0,5
2014,Trapp,M,100,0,5,5
2014,Trasean,M,100,0,5,5
2014,Trashaun,M,100,0,5,5
2014,Trashawn,M,100,0,5,5
2014,Travin,M,100,0,5,5
2014,Trayshawn,M,100,0,5,5
2014,Treavor,M,100,0,5,5
2014,Treble,M,100,0,5,5
2014,Tredyn,M,100,0,5,5
2014,Trejon,M,100,0,5,5
2014,Trelynn,F,100,5,0,5
2014,Trendan,M,100,0,5,5
2014,Trentan,M,100,0,5,5
2014,Treson,M,100,0,5,5
2014,Trestan,M,100,0,5,5
2014,Trestyn,M,100,0,5,5
2014,Treycen,M,100,0,5,5
2014,Treydon,M,100,0,5,5
2014,Treymon,M,100,0,5,5
2014,Trianna,F,100,5,0,5
2014,Trinitty,F,100,5,0,5
2014,Trinnity,F,100,5,0,5
2014,Tripton,M,100,0,5,5
2014,Trishan,M,100,0,5,5
2014,Trishna,F,100,5,0,5
2014,Trison,M,100,0,5,5
2014,Tristynn,F,100,5,0,5
2014,Troyce,M,100,0,5,5
2014,Truely,F,100,5,0,5
2014,Trung,M,100,0,5,5
2014,Trustyn,M,100,0,5,5
2014,Tryson,M,100,0,5,5
2014,Trystyn,M,100,0,5,5
2014,Tsering,F,100,5,0,5
2014,Tsubaki,F,100,5,0,5
2014,Tsunade,F,100,5,0,5
2014,Turi,M,100,0,5,5
2014,Tushar,M,100,0,5,5
2014,Tyberious,M,100,0,5,5
2014,Tycere,M,100,0,5,5
2014,Tykeem,M,100,0,5,5
2014,Tylaya,F,100,5,0,5
2014,Tylyn,M,100,0,5,5
2014,Tymar,M,100,0,5,5
2014,Tyme,M,100,0,5,5
2014,Tyndall,F,100,5,0,5
2014,Tyner,M,100,0,5,5
2014,Tynia,F,100,5,0,5
2014,Tynlie,F,100,5,0,5
2014,Tyresse,M,100,0,5,5
2014,Tyrez,M,100,0,5,5
2014,Tyric,M,100,0,5,5
2014,Tyrielle,F,100,5,0,5
2014,Tyrome,M,100,0,5,5
2014,Tyshawna,F,100,5,0,5
2014,Tyshun,M,100,0,5,5
2014,Tysin,M,100,0,5,5
2014,Tywaun,M,100,0,5,5
2014,Tywin,M,100,0,5,5
2014,Tzion,M,100,0,5,5
2014,Tzippy,F,100,5,0,5
2014,Tzivy,F,100,5,0,5
2014,Ugonna,M,100,0,5,5
2014,Umberto,M,100,0,5,5
2014,Ume,F,100,5,0,5
2014,Umut,M,100,0,5,5
2014,Upton,M,100,0,5,5
2014,Urenna,F,100,5,0,5
2014,Usiel,M,100,0,5,5
2014,Uyen,F,100,5,0,5
2014,Uzay,M,100,0,5,5
2014,Uzayr,M,100,0,5,5
2014,Vaanya,F,100,5,0,5
2014,Vaibhavi,F,100,5,0,5
2014,Vaimoana,F,100,5,0,5
2014,Vainavi,F,100,5,0,5
2014,Vaishvi,F,100,5,0,5
2014,Valaysia,F,100,5,0,5
2014,Valdemar,M,100,0,5,5
2014,Valentyna,F,100,5,0,5
2014,Valetina,F,100,5,0,5
2014,Vali,M,100,0,5,5
2014,Valiant,M,100,0,5,5
2014,Vanae,F,100,5,0,5
2014,Vardan,M,100,0,5,5
2014,Varenya,F,100,5,0,5
2014,Varna,F,100,5,0,5
2014,Varshika,F,100,5,0,5
2014,Vashaun,M,100,0,5,5
2014,Vashon,M,100,0,5,5
2014,Vasily,M,100,0,5,5
2014,Vasudha,F,100,5,0,5
2014,Vayah,F,100,5,0,5
2014,Vaylen,M,100,0,5,5
2014,Vedder,M,100,0,5,5
2014,Vedhika,F,100,5,0,5
2014,Velinda,F,100,5,0,5
2014,Velouria,F,100,5,0,5
2014,Venicio,M,100,0,5,5
2014,Ventura,M,100,0,5,5
2014,Veralyn,F,100,5,0,5
2014,Versavia,F,100,5,0,5
2014,Veyah,F,100,5,0,5
2014,Veyron,M,100,0,5,5
2014,Viany,F,100,5,0,5
2014,Vicktor,M,100,0,5,5
2014,Victorhugo,M,100,0,5,5
2014,Victormanuel,M,100,0,5,5
2014,Viena,F,100,5,0,5
2014,Vignesh,M,100,0,5,5
2014,Vihaas,M,100,0,5,5
2014,Vinessa,F,100,5,0,5
2014,Vinisha,F,100,5,0,5
2014,Vinn,M,100,0,5,5
2014,Violeth,F,100,5,0,5
2014,Violetrose,F,100,5,0,5
2014,Vitalina,F,100,5,0,5
2014,Viviette,F,100,5,0,5
2014,Vontez,M,100,0,5,5
2014,Wacey,M,100,0,5,5
2014,Wafaa,F,100,5,0,5
2014,Wahid,M,100,0,5,5
2014,Wailyn,M,100,0,5,5
2014,Wajd,F,100,5,0,5
2014,Waldemar,M,100,0,5,5
2014,Waldo,M,100,0,5,5
2014,Wareesha,F,100,5,0,5
2014,Wellsley,F,100,5,0,5
2014,Wenceslao,M,100,0,5,5
2014,Wilberth,M,100,0,5,5
2014,Wildan,M,100,0,5,5
2014,Wilkinson,M,100,0,5,5
2014,Willaim,M,100,0,5,5
2014,Willam,M,100,0,5,5
2014,Willliam,M,100,0,5,5
2014,Wimberley,F,100,5,0,5
2014,Windham,M,100,0,5,5
2014,Winni,F,100,5,0,5
2014,Winta,F,100,5,0,5
2014,Winterrose,F,100,5,0,5
2014,Wizdom,M,100,0,5,5
2014,Wolfram,M,100,0,5,5
2014,Wraith,M,100,0,5,5
2014,Wylde,M,100,0,5,5
2014,Wyleigh,F,100,5,0,5
2014,Wyman,M,100,0,5,5
2014,Wynnston,M,100,0,5,5
2014,Xaeden,M,100,0,5,5
2014,Xain,M,100,0,5,5
2014,Xandrea,F,100,5,0,5
2014,Xaniel,M,100,0,5,5
2014,Xanthe,F,100,5,0,5
2014,Xareny,F,100,5,0,5
2014,Xaver,M,100,0,5,5
2014,Xavious,M,100,0,5,5
2014,Xavy,M,100,0,5,5
2014,Xaylie,F,100,5,0,5
2014,Xea,F,100,5,0,5
2014,Xeniyah,F,100,5,0,5
2014,Xiamara,F,100,5,0,5
2014,Xiang,M,100,0,5,5
2014,Xiara,F,100,5,0,5
2014,Xiclali,F,100,5,0,5
2014,Xinrui,F,100,5,0,5
2014,Xinyan,F,100,5,0,5
2014,Xitllali,F,100,5,0,5
2014,Xyliana,F,100,5,0,5
2014,Xzaiden,M,100,0,5,5
2014,Yacine,M,100,0,5,5
2014,Yacqub,M,100,0,5,5
2014,Yaelle,F,100,5,0,5
2014,Yaely,F,100,5,0,5
2014,Yahmir,M,100,0,5,5
2014,Yahna,F,100,5,0,5
2014,Yahvi,F,100,5,0,5
2014,Yailen,F,100,5,0,5
2014,Yajahira,F,100,5,0,5
2014,Yakob,M,100,0,5,5
2014,Yalani,F,100,5,0,5
2014,Yalexi,F,100,5,0,5
2014,Yami,F,100,5,0,5
2014,Yancarlo,M,100,0,5,5
2014,Yaneiry,F,100,5,0,5
2014,Yanelie,F,100,5,0,5
2014,Yaniah,F,100,5,0,5
2014,Yanieliz,F,100,5,0,5
2014,Yanitzia,F,100,5,0,5
2014,Yaniv,M,100,0,5,5
2014,Yar,F,100,5,0,5
2014,Yarell,M,100,0,5,5
2014,Yarielys,F,100,5,0,5
2014,Yarisbeth,F,100,5,0,5
2014,Yarismar,F,100,5,0,5
2014,Yarissa,F,100,5,0,5
2014,Yariza,F,100,5,0,5
2014,Yarlin,F,100,5,0,5
2014,Yasamin,F,100,5,0,5
2014,Yaviel,M,100,0,5,5
2014,Yaw,M,100,0,5,5
2014,Yazayra,F,100,5,0,5
2014,Yazlee,F,100,5,0,5
2014,Yazmeen,F,100,5,0,5
2014,Yazziel,M,100,0,5,5
2014,Yeabsera,F,100,5,0,5
2014,Yeidan,M,100,0,5,5
2014,Yeilen,F,100,5,0,5
2014,Yeilyn,F,100,5,0,5
2014,Yelaina,F,100,5,0,5
2014,Yemaya,F,100,5,0,5
2014,Yerlin,F,100,5,0,5
2014,Yexiel,M,100,0,5,5
2014,Yigit,M,100,0,5,5
2014,Yiru,F,100,5,0,5
2014,Yiselle,F,100,5,0,5
2014,Yitzel,F,100,5,0,5
2014,Yixin,F,100,5,0,5
2014,Yoali,F,100,5,0,5
2014,Yoann,M,100,0,5,5
2014,Yogi,M,100,0,5,5
2014,Yoko,F,100,5,0,5
2014,Yoona,F,100,5,0,5
2014,Yoscar,M,100,0,5,5
2014,Yosniel,M,100,0,5,5
2014,Ysidro,M,100,0,5,5
2014,Yufei,F,100,5,0,5
2014,Yugo,M,100,0,5,5
2014,Yuhan,F,100,5,0,5
2014,Yukta,F,100,5,0,5
2014,Yuktha,F,100,5,0,5
2014,Yule,M,100,0,5,5
2014,Yuleidy,F,100,5,0,5
2014,Yulemi,F,100,5,0,5
2014,Yuniel,M,100,0,5,5
2014,Yunique,F,100,5,0,5
2014,Yunxi,F,100,5,0,5
2014,Yura,F,100,5,0,5
2014,Yuriy,M,100,0,5,5
2014,Yushin,M,100,0,5,5
2014,Yuven,M,100,0,5,5
2014,Yuyang,M,100,0,5,5
2014,Yvonna,F,100,5,0,5
2014,Zaaliyah,F,100,5,0,5
2014,Zaaron,M,100,0,5,5
2014,Zabian,M,100,0,5,5
2014,Zabria,F,100,5,0,5
2014,Zabriel,M,100,0,5,5
2014,Zacai,M,100,0,5,5
2014,Zacara,F,100,5,0,5
2014,Zacharee,M,100,0,5,5
2014,Zachariyah,M,100,0,5,5
2014,Zachry,M,100,0,5,5
2014,Zackarie,M,100,0,5,5
2014,Zacory,M,100,0,5,5
2014,Zadiel,M,100,0,5,5
2014,Zaelah,F,100,5,0,5
2014,Zaevian,M,100,0,5,5
2014,Zaeya,F,100,5,0,5
2014,Zafira,F,100,5,0,5
2014,Zaheem,M,100,0,5,5
2014,Zahran,M,100,0,5,5
2014,Zahriah,F,100,5,0,5
2014,Zahro,F,100,5,0,5
2014,Zaidah,F,100,5,0,5
2014,Zaileigh,F,100,5,0,5
2014,Zaimar,M,100,0,5,5
2014,Zaineb,F,100,5,0,5
2014,Zaion,M,100,0,5,5
2014,Zaionna,F,100,5,0,5
2014,Zaiyah,F,100,5,0,5
2014,Zaiyan,M,100,0,5,5
2014,Zaiyden,M,100,0,5,5
2014,Zakaiya,F,100,5,0,5
2014,Zakarian,M,100,0,5,5
2014,Zakkai,M,100,0,5,5
2014,Zakylah,F,100,5,0,5
2014,Zaliya,F,100,5,0,5
2014,Zamauria,F,100,5,0,5
2014,Zamayah,F,100,5,0,5
2014,Zamayra,F,100,5,0,5
2014,Zameria,F,100,5,0,5
2014,Zamoni,F,100,5,0,5
2014,Zamyrah,F,100,5,0,5
2014,Zanari,F,100,5,0,5
2014,Zandrea,F,100,5,0,5
2014,Zannah,F,100,5,0,5
2014,Zanovia,F,100,5,0,5
2014,Zarae,F,100,5,0,5
2014,Zarahy,F,100,5,0,5
2014,Zarak,M,100,0,5,5
2014,Zareyah,F,100,5,0,5
2014,Zariha,F,100,5,0,5
2014,Zarinah,F,100,5,0,5
2014,Zavannah,F,100,5,0,5
2014,Zaveion,M,100,0,5,5
2014,Zayanah,F,100,5,0,5
2014,Zaybree,F,100,5,0,5
2014,Zaydah,F,100,5,0,5
2014,Zaydren,M,100,0,5,5
2014,Zayid,M,100,0,5,5
2014,Zaymere,M,100,0,5,5
2014,Zayquan,M,100,0,5,5
2014,Zaysean,M,100,0,5,5
2014,Zayvon,M,100,0,5,5
2014,Zazil,F,100,5,0,5
2014,Zedan,M,100,0,5,5
2014,Zedek,M,100,0,5,5
2014,Zedrick,M,100,0,5,5
2014,Zeenah,F,100,5,0,5
2014,Zeid,M,100,0,5,5
2014,Zeidan,M,100,0,5,5
2014,Zeila,F,100,5,0,5
2014,Zeilah,F,100,5,0,5
2014,Zeily,F,100,5,0,5
2014,Zekeriah,M,100,0,5,5
2014,Zelina,F,100,5,0,5
2014,Zellah,F,100,5,0,5
2014,Zenas,M,100,0,5,5
2014,Zenayda,F,100,5,0,5
2014,Zendaiya,F,100,5,0,5
2014,Zendiya,F,100,5,0,5
2014,Zeni,F,100,5,0,5
2014,Zephen,M,100,0,5,5
2014,Zeplynn,F,100,5,0,5
2014,Zerah,F,100,5,0,5
2014,Zerick,M,100,0,5,5
2014,Zeriyah,F,100,5,0,5
2014,Zeyah,F,100,5,0,5
2014,Zeylah,F,100,5,0,5
2014,Zhaiden,M,100,0,5,5
2014,Zhalen,M,100,0,5,5
2014,Zhariah,F,100,5,0,5
2014,Zhariyah,F,100,5,0,5
2014,Zhayden,M,100,0,5,5
2014,Zhia,F,100,5,0,5
2014,Ziar,M,100,0,5,5
2014,Ziarah,F,100,5,0,5
2014,Zichen,M,100,0,5,5
2014,Ziden,M,100,0,5,5
2014,Zierre,M,100,0,5,5
2014,Ziion,M,100,0,5,5
2014,Zijun,M,100,0,5,5
2014,Zikeria,F,100,5,0,5
2014,Zila,F,100,5,0,5
2014,Zilas,M,100,0,5,5
2014,Zilynn,F,100,5,0,5
2014,Zinaya,F,100,5,0,5
2014,Ziporah,F,100,5,0,5
2014,Zirui,M,100,0,5,5
2014,Zitlali,F,100,5,0,5
2014,Zivon,M,100,0,5,5
2014,Ziyang,M,100,0,5,5
2014,Ziyona,F,100,5,0,5
2014,Zmarion,M,100,0,5,5
2014,Zoeann,F,100,5,0,5
2014,Zoeymarie,F,100,5,0,5
2014,Zoja,F,100,5,0,5
2014,Zoree,F,100,5,0,5
2014,Zsazsa,F,100,5,0,5
2014,Zubaida,F,100,5,0,5
2014,Zuhra,F,100,5,0,5
2014,Zulie,F,100,5,0,5
2014,Zyauna,F,100,5,0,5
2014,Zyeir,M,100,0,5,5
2014,Zyel,M,100,0,5,5
2014,Zyelle,F,100,5,0,5
2014,Zyiona,F,100,5,0,5
2014,Zykeem,M,100,0,5,5
2014,Zykeriah,F,100,5,0,5
2014,Zylynn,F,100,5,0,5
2014,Zymeer,M,100,0,5,5
2014,Zymiere,M,100,0,5,5
2014,Zyran,M,100,0,5,5
2014,Zyrihanna,F,100,5,0,5
2014,Zyrin,M,100,0,5,5
2014,Zyriyah,F,100,5,0,5
